>l
Galaxy Jones is in the speeder dock. A safe harbor from the periodic dust storms of Utopia Planitia, the dock features several dozen speeder bays. Only a few are filled right now. The building entryway is to the north, under a red stone façade carved into the likeness of a fearsome Viking.

Jones's speeder, Galaxy One, sits in one of the parking bays.

>n
Galaxy Jones is at the entry doorway. A glass revolving door leads into a large open space north of here. The speeder dock is to the south.

>n
Galaxy Jones is in the lobby. The ground floor of the Viking Building is breathtaking. Low-G architecture means more glass and thinner supports, and the building takes advantage of that. Four walls of glass surround a central pillar in which are set the utility rooms and elevators. In between is an expanse of plants, water installations, and stylish seating. Near the entryway is a front desk. Above it floats, suspended on almost invisible cables, a giant crystal sculpture. Jones may go east and west from here, north to the elevators, or south out of the building.

>beck what is the plan
That's not a verb I recognise.

>ask beck stuff
There's nothing like that nearby.

>talk to bck
That's not a verb I recognise.

>hi
That's not a verb I recognise.

>l
Before Jones gets a chance to do anything, two robot guards emerge from niches in the back wall! She dives behind the front desk and draws her disruptor pistol.

Jones shouts, "I'm under fire from two ugly robot things!"

Beck responds, "Monitoring lifesigns."

>have jones fire gun
That's not a verb I recognise.

>jones fire gun
That's not a verb I recognise.

>fire gun
There's nothing like that nearby.

>i
Jones is carrying:
  a disruptor pistol

>fire pistol
What should Jones fire the disruptor pistol at?

>red
(the building entryway)
Shooting that would accomplish nothing.

>fire pistol at gurd
There's nothing like that nearby.

>fire pistol at guard
Which do you mean, the green guard robot or the red guard robot?

>red
A perfect shot! Yet, somehow, the robot is unscathed.

Jones: "Target seems to be absorbing disruptor fire. This will make things a little harder."

Zip! Disruptor fire scorches a nearby couch.

>fire pistol at crystal
Jones fires the disruptor into the sculpture's main support cable, snapping it. The huge crystal blob starts to sag, straining the other cables. In quick succession they break as well, and the whole installation plummets to the ground, right on top of the hapless guard robots.

Beck: "What was that crash? What's going on?"

Jones: "That, my friend, was what you'd call a work of art. Targets terminated."

 _________      __                     _____                     
 __/ ____/___ _/ /___ __  ____  __     __/ /___  ____  ___  _____
 _/ / __/ __ `/ / __ `/ |/ / / / /____ _/ / __ \/ __ \/ _ \/ ___/
 / /_/ / /_/ / / /_/ />  </ /_/ / _/ /_/ / /_/ / / / /  __(__  ) 
 \____/\__,_/_/\__,_/_/|_|\__, /  _\____/\____/_/ /_/\___/____/  
 _____________________________/ 

[Your score has just gone up by one point.]

>restart
Are you sure you want to restart?

>y
 _________      __                     _____                     
 __/ ____/___ _/ /___ __  ____  __     __/ /___  ____  ___  _____
 _/ / __/ __ `/ / __ `/ |/ / / / /____ _/ / __ \/ __ \/ _ \/ ___/
 / /_/ / /_/ / / /_/ />  </ /_/ / _/ /_/ / /_/ / / / /  __(__  ) 
 \____/\__,_/_/\__,_/_/|_|\__, /  _\____/\____/_/ /_/\___/____/  
 _____________________________/ 

An Interactive Fiction by Phil Riley
Release 1 / Serial number 230225 / Inform 7 build 6M62 (I6/v6.34 lib 6/12N) SD

A sleek dark red speeder roars into the dock of the Viking Building. A tall, strong woman in a battle-ready jumpsuit climbs out of it.

Galaxy Jones is in the speeder dock. A safe harbor from the periodic dust storms of Utopia Planitia, the dock features several dozen speeder bays. Only a few are filled right now. The building entryway is to the north, under a red stone façade carved into the likeness of a fearsome Viking.

Jones's speeder, Galaxy One, sits in one of the parking bays.

Beck comes over Jones's headset. "What's going on there? Where are you? Keep me posted."

She replies, "I'm in the speeder dock. No movement. What can I expect inside?"

"Blueprints show the ground floor is one big empty space with elevators in the center. Not a lot of places for resistance to hide, but you can never tell. Be careful."

* * *

>n
Before Jones gets a chance to do anything, two robot guards emerge from niches in the back wall! She dives behind the front desk and draws her disruptor pistol.

Jones shouts, "I'm under fire from two ugly robot things!"

Beck responds, "Monitoring lifesigns."

>shoot art
(with the disruptor pistol)
Jones fires the disruptor into the sculpture's main support cable, snapping it. The huge crystal blob starts to sag, straining the other cables. In quick succession they break as well, and the whole installation plummets to the ground, right on top of the hapless guard robots.

Beck: "What was that crash? What's going on?"

Jones: "That, my friend, was what you'd call a work of art. Targets terminated."

 _________      __                     _____                     
 __/ ____/___ _/ /___ __  ____  __     __/ /___  ____  ___  _____
 _/ / __/ __ `/ / __ `/ |/ / / / /____ _/ / __ \/ __ \/ _ \/ ___/
 / /_/ / /_/ / / /_/ />  </ /_/ / _/ /_/ / /_/ / / / /  __(__  ) 
 \____/\__,_/_/\__,_/_/|_|\__, /  _\____/\____/_/ /_/\___/____/  
 _____________________________/ 

[Your score has just gone up by one point.]

* * *

>nrestart
That's not a verb I recognise.

>restart
Are you sure you want to restart?

* * *

>shoot robot
(with the disruptor pistol)
Jones aims the pistol upward under the robot's enhanced armor. She flinches back when the robot's innards explode downward in a shower of sparks. It topples over, dead.

The guard robot moves a little farther away from you
Jones: "Better than a video game. "

Beck: "Nice, but don't forget to credit your handler."

Jones: "Yes, yes, thanks for helping me not get killed."

Beck: "You're welcome."

* * *

>shoot
What should Jones shoot?

>robot
(with the disruptor pistol)
She aims the pistol upward under the robot's enhanced armor. She flinches back when the robot's innards explode downward in a shower of sparks. It topples over, dead.

Jones: "Better than a video game. "

Beck: "Nice, but don't forget to credit your handler."

Jones: "Yes, yes, thanks for helping me not get killed."

Beck: "You're welcome."

 _________      __                     _____                     
 __/ ____/___ _/ /___ __  ____  __     __/ /___  ____  ___  _____
 _/ / __/ __ `/ / __ `/ |/ / / / /____ _/ / __ \/ __ \/ _ \/ ___/
 / /_/ / /_/ / / /_/ />  </ /_/ / _/ /_/ / /_/ / / / /  __(__  ) 
 \____/\__,_/_/\__,_/_/|_|\__, /  _\____/\____/_/ /_/\___/____/  
 _____________________________/ 

[Your score has just gone up by one point.]

* * *

>shoot robot
(with the disruptor pistol)
Jones aims the pistol upward under the robot's enhanced armor. She flinches back when the robot's innards explode downward in a shower of sparks. It topples over, dead.

Jones: "Better than a video game. "

Beck: "Nice, but don't forget to credit your handler."

Jones: "Yes, yes, thanks for helping me not get killed."

Beck: "You're welcome."

* * *

>w
Galaxy Jones is in the ground floor elevator shaft. Jones is at the bottom of a dark well. Shining her suit light up, she can see that the elevator car is several floors up, unmoving. There is a ladder on the west wall.

>n
Jones can't go that way. The obvious exits are east (to the ground floor elevator hall) and up.

>u
Galaxy Jones is in the second floor elevator shaft.

* * *

>u
Galaxy Jones is in the sixth floor elevator shaft.

>x door
There seems to be nothing special about it.

>u
Galaxy Jones is in the seventh floor elevator shaft.

* * *

>u
Galaxy Jones is in the eighth floor elevator shaft.

>u
Galaxy Jones is in the ninth floor elevator shaft.

>x door
There seems to be nothing special about it.

>e
(first opening the ninth floor elevator door)

Galaxy Jones is in the ninth floor elevator hall.

>w
Galaxy Jones is in the ninth floor elevator shaft.

* * *

>n
Galaxy Jones is in the ninth floor north hallway.

>w
Galaxy Jones is at the north end of the Microthings office.

>s
Galaxy Jones is at the south end of the Microthings office.

>e
Galaxy Jones is in the ninth floor south hallway.

* * *

>e
Galaxy Jones is in the Martian Chronicle office.

>n
Jones can't go that way. The only obvious exit is west (to the ninth floor south hallway).

>w
Galaxy Jones is in the ninth floor south hallway.

* * *

>n
Galaxy Jones is in the ninth floor elevator hall.

>e
Jones can't go that way. The obvious exits are north (to the ninth floor north hallway), south (to the ninth floor south hallway) and west (to the ninth floor elevator shaft).

>n
Galaxy Jones is in the ninth floor north hallway.

>e
Galaxy Jones is in the Cybernetica office.

* * *

>w
Galaxy Jones is in the ground floor elevator shaft. Jones is at the bottom of a dark well. Shining her suit light up, she can see that the elevator car is several floors up, unmoving. There is a ladder on the west wall.

>u
Galaxy Jones is in the second floor elevator shaft.

* * *

>u
Galaxy Jones is in the eighth floor elevator shaft.

>u
Galaxy Jones is in the ninth floor elevator shaft. 

Also here is a ninth floor elevator door.

>e
(first opening the ninth floor elevator door)

Galaxy Jones is in the ninth floor elevator hall. 

Also here is a ninth floor elevator door.

* * *

>test elevator door
I only understood you as far as wanting to test that.

* * *

>n
Galaxy Jones is in the ninth floor north hallway.

>e
(first opening the Cybernetica door)

Galaxy Jones is in the Cybernetica office.

>w
Galaxy Jones is in the ninth floor north hallway.

>x door
This typical wooden office door displays the sign for Cybernetica Inc., a purveyor of game software.

>e
Galaxy Jones is in the Cybernetica office.

>x door
There seems to be nothing special about it.

* * *

>n
Galaxy Jones is in the ninth floor north hallway.

>e
(first opening the Cybernetica door)

Galaxy Jones is in the Cybernetica office. It's spacious and luxurious, designed to make developers forget how spent they are from months of overwork and abuse. Ergonomic desks and chairs fill space like a furniture fractal, before giving way to an open area, presumably for group activities. At the south end of the room is a door labeled "Inspiration Chamber."

As soon as Jones steps into the office, a shot zaps just past her nose. She dives to the ground, protected by the maze of desks and chairs. Peeking through the mesh back of one of the chairs, she takes notice of both the purple guard robot training its disruptor on the room, and the chair's fine construction and lumbar support.

Jones (whispering): "We've got another one! I'm out of sight for now, but it's going to be hard to get a shot off at this 'bot."

Beck: "What's the situation?"

Jones: "I'm on the floor with desks and chairs all around. The target is a few yards off, coming this way. I might get a shot in, but it might just absorb it anyway."

Beck "Well, see if you can sneak up on it. Maybe close up you can find a way past its defenses."

>w
Galaxy Jones is in the ninth floor north hallway.

>e
Galaxy Jones is in the Cybernetica office.

>w
Galaxy Jones is in the ninth floor north hallway.