>n
Jones approaches the Viking Building entryway, the dramatic façade towering over her.

Galaxy Jones is at the entry doorway. A glass revolving door leads into a large open space north of here. The speeder dock is to the south.

Jones looks up at the 100 stories of glass and steel. "What do you want to bet Thallium's got Europa all the way at the top?"

Beck: "Oh, no doubt."

>n
Jones takes a deep breath. "I'm going in."

Beck replies, "You got this, Galaxy."

Jones passes through the revolving door and into the lobby, alert to any defenses.

Galaxy Jones is in the lobby. The ground floor of the Viking Building is breathtaking. Low-G architecture means more glass and thinner supports, and the building takes advantage of that. Four walls of glass surround a central pillar in which are set the utility rooms and elevators. In between is an expanse of plants, water features, and stylish seating. Near the entryway is a front desk. A giant crystal sculpture floats above the center of the area, suspended on almost invisible cables. She may go east and west from here, north to the elevators, or south out of the building.

>drop pistol
bar.

Suddenly two robot guards, green and red, emerge from niches in the back wall! Jones dives behind the front desk and draws her disruptor pistol.

Jones shouts, "I'm under fire from two ugly robot things!"

Beck responds, "Monitoring your suit radar."

>undo
Galaxy Jones is in the lobby.
[Previous turn undone.]

>jump
foo.

Suddenly two robot guards, green and red, emerge from niches in the back wall! Jones dives behind the front desk and draws her disruptor pistol.

Jones shouts, "I'm under fire from two ugly robot things!"

Beck responds, "Monitoring your suit radar."

>undo
Galaxy Jones is in the lobby.
[Previous turn undone.]

>ask beck about beck
Jones: "How're you doing, Beck?"

bar.

Suddenly two robot guards, green and red, emerge from niches in the back wall! Jones dives behind the front desk and draws her disruptor pistol.

Jones shouts, "I'm under fire from two ugly robot things!"

Beck responds, "Monitoring your suit radar."

* * *

>drop speeder
(the speeder)
Jones hasn't got that.

>showme
speeder dock - room
    building entryway - backdrop
    outside - backdrop
    Jones - person
        black jumpsuit (worn)
            suit light (part of black jumpsuit)
        disruptor pistol
    speeder
        tinted speeder windows (part of speeder)
        turbines (part of speeder)
        wings (part of speeder)
    parking bays

>x wing
Not technically necessary as the speeder works via anti-gravity, the blade-like wings nonetheless give the vehicle a certain flair unobtainable by other means.

>x vehicle
Galaxy One is a Dust Runner, a top-of-the-line model from Olympus Speedworks. It's deep crimson with tinted windows. Powerful turbines adorn vestigial wings that sweep back in severe rearward arcs.

>x dust tunner
There's nothing like that nearby.

>x dust runner
There's nothing like that nearby.

>x galaxy one
Galaxy One is a Dust Runner, a top-of-the-line model from Olympus Speedworks. It's deep crimson with tinted windows. Powerful turbines adorn vestigial wings that sweep back in severe rearward arcs.

* * *

>gonear 100t
There seems to be no such object anywhere in the model world.

>gonear 100th
Galaxy Jones is in the 100th floor elevator hall. The luxury is staggering.  The walls are made of polished black marble, and the floors are covered in plush black carpeting that muffles the sound of footsteps. The ceiling is high and adorned with a crystal chandelier. The elevator doors to the west are gold-plated. Sumptuous living quarters are visible to the north and south.

>x ceilig
There's nothing like that nearby.

>x ceiligg
There's nothing like that nearby.

>x ceiling
An enormously extravagant display of crystal.

>x doors
It's not clear why everything has to be so excessive.

>x carpet
Dark black, almost threatening, rounding out the storm cloud atmosphere of the room.

>n
Galaxy Jones is in the northern corner of the penthouse. This is Thallium's bedroom. Apart from the expansive round bed in the center of the room, notable features include the line of dummies displaying his various suits of clothes, a large vanity table, and the complete lack of mirrors on the ceiling, thankfully. One may leave the room to the southwest, south, and southeast.

* * *

>gonear 100th
Galaxy Jones is in the 100th floor elevator hall. The luxury is staggering.  The walls are made of polished black marble, and the floors are covered in plush black carpeting that muffles the sound of footsteps. The ceiling is high and adorned with a crystal chandelier. The elevator doors to the west are gold-plated. Sumptuous living quarters are visible to the north and south.

>purloin real diamond
[Purloined.]

>n
Galaxy Jones is in the northern corner of the penthouse. This is Thallium's bedroom. Apart from the expansive round bed in the center of the room, notable features include the line of dummies displaying his various suits of clothes, a large vanity table, and the complete lack of mirrors on the ceiling, thankfully. One may leave the room to the southwest, south, and southeast.

* * *

>put diamond in claw
As soon as insert the diamond into the claw, laser beams spring from five emitters on the walls. They hit the diamond and join into a single more powerful beam that strikes the electronic eye on the wall. A sound like a sliding door comes from behind Jones, and she spins around to see the red wall slide down into the floor. It exposes a control panel of sorts, featuring a large red button labeled "Press Me".

* * *

>x panel
Jones discovers a secret panel, which when opened exposes a small black button.

>press black button
Somewhere beyond this room comes the sound of something heavy being moved.

Beck: "Why didn't you press the button that said 'Press Me'? Maybe we should press it anyway. Please?"

>ne
Galaxy Jones is in the northern corner of the penthouse. This is Thallium's bedroom. Apart from the expansive round bed in the center of the room, notable features include the line of dummies displaying his various suits of clothes, a large vanity table, and the complete lack of mirrors on the ceiling, thankfully. One may leave the room to the southwest, south, and southeast.

>s
Galaxy Jones is in the 100th floor elevator hall. The luxury is staggering.  The walls are made of polished black marble, and the floors are covered in plush black carpeting that muffles the sound of footsteps. The ceiling is high and adorned with a crystal chandelier. The elevator doors to the west are gold-plated. Sumptuous living quarters are visible to the north and south.

A portion of the eastern wall has slid away to reveal a stunning white marble staircase.

Jones: "Must be the way up to the roof. Beck, you there?"

Beck: "Yep, I'm here, just a bit busy is all. I'll meet you on that roof."

>l
Galaxy Jones is in the 100th floor elevator hall. The luxury is staggering.  The walls are made of polished black marble, and the floors are covered in plush black carpeting that muffles the sound of footsteps. The ceiling is high and adorned with a crystal chandelier. The elevator doors to the west are gold-plated. Sumptuous living quarters are visible to the north and south.

A portion of the eastern wall has slid away to reveal a stunning white marble staircase.

>e
Galaxy Jones is on the roof stairs. Thick slabs of marble lead from the hall to the west to the rooftop door above.

>gonear cage
(the cage)
Galaxy Jones is next to the cage. The closely-set silnium bars seem to dash all hope of a rescue. The flyer pad is to the southwest and the rest of the rooftop to the south.

Europa Callisto is lying at the center of the cage, out of Jones's reach.

Jones tries the strength of the bars just in case. They don't budge.

South of the cage, Thallium crosses the roof to the flyer pad, where he boards the waiting flyer. The flyer lifts off and moves towards Jones.

>showme
cage - room
    Admiral Thallium's flyer - backdrop
    electrostatic field - backdrop
    outside - backdrop
    Jones - person
        black jumpsuit (worn)
            suit light (part of black jumpsuit)
        disruptor pistol
    Europa Callisto - woman
    cage - supporter
    cage-container - transparent open container

>x pad
There's nothing like that nearby.

>l
Galaxy Jones is next to the cage. The closely-set silnium bars seem to dash all hope of a rescue. The flyer pad is to the southwest and the rest of the rooftop to the south.

Europa Callisto is lying at the center of the cage, out of Jones's reach.

Admiral Thallium's flyer is hovering above you.

Thallium's flyer hovers over the rooftop. "Jones!"  he bellows. "Play time is over. I grow weary of your intransigence. In a moment this roof will be swarmed by guard robots -- of many different colors -- so many robots you couldn't possibly vandalize them all.  Say your prayers, Jones, or whatever you do when you're about to die."

Jones rolls her eyes.

A little ways off, a small red flyer aims for the rooftop and accelerates.

>x cage
(the cage)
The cage is huge for holding just one prisoner. The silnium bars are grey and iridescent. They run both horizontally and vertically, creating a lattice. The floor is hard and cold.

* * *

>gonear 100th
Galaxy Jones is in the 100th floor elevator hall. The luxury is staggering.  The walls are made of polished black marble, and the floors are covered in plush black carpeting that muffles the sound of footsteps. The ceiling is high and adorned with a crystal chandelier. The elevator doors to the west are gold-plated. Sumptuous living quarters are visible to the north and south.

>showme
100th floor elevator hall - room
    Jones - person
        black jumpsuit (worn)
            suit light (part of black jumpsuit)
        disruptor pistol
    walls
    carpet
    chandelier
    elevator door
    living quarters

>x walls
Black marble. Wow. It's beautiful.

>x carpet
Dark black, almost threatening, rounding out the storm cloud atmosphere of the room.

>x chandelier
An enormously extravagant display of crystal.

>x elevator door
It's not clear why everything has to be so excessive.

>x living
They look just as over-the-top as the hall here.

>x hall
Galaxy Jones is in the 100th floor elevator hall. The luxury is staggering.  The walls are made of polished black marble, and the floors are covered in plush black carpeting that muffles the sound of footsteps. The ceiling is high and adorned with a crystal chandelier. The elevator doors to the west are gold-plated. Sumptuous living quarters are visible to the north and south.

>n
Galaxy Jones is in the northern corner of the penthouse. This is Thallium's bedroom. Apart from the expansive round bed in the center of the room, notable features include the line of dummies displaying his various suits of clothes, a large vanity table, and the complete lack of mirrors on the ceiling, thankfully. One may leave the room to the southwest, south, and southeast.

* * *

>showme
western corner of the penthouse - room
    Jones - person
        black jumpsuit (worn)
            suit light (part of black jumpsuit)
        disruptor pistol
    metal pillar
        claw (part of metal pillar) - open container
    granite floor
    walls
    insignia
    electronic eye

>x insignia
"Planetas Vincam", incidentally, means "I will conquer the planets."

>x walls
The outer wall is all of red wood inlaid with ebony, while the inner wall, made of brushed stainless steel, is inset with an electronic eye.

>x eye
Looks like it might be a sensor of some sort.

>purloin diamond
Which do you mean, the array of diamonds, the diamond, or the diamond?

>real
[Purloined.]

>put it in claw
As soon as insert the diamond into the claw, laser beams spring from five emitters on the walls. They hit the diamond and join into a single more powerful beam that strikes the electronic eye on the wall. A sound like a sliding door comes from behind Jones, and she spins around to see the red wall slide down into the floor. It exposes a control panel of sorts, featuring a large red button labeled "Press Me".

>showme
western corner of the penthouse - room
    penthouse control panel
        large red button (part of penthouse control panel)
    Jones - person
        black jumpsuit (worn)
            suit light (part of black jumpsuit)
        disruptor pistol
    metal pillar
        claw (part of metal pillar) - open container
            diamond - gem
    granite floor
    walls
    insignia
    electronic eye

>x walls
The outer wall is all of red wood inlaid with ebony, while the inner wall, made of brushed stainless steel, is inset with an electronic eye.

>x button
It's labeled "Press Me".

>x pillar
It's actually wrought iron, and it holds up the claw.

>x claw
It looks like it could grip a small object.

In the claw is a diamond.

>x diamond
Maybe 2.5 carats, it's a beautiful gem, if you're into diamonds.

>x floor
On Mars, sometimes one gets tired of red.

>showme control panel
(the penthouse control panel)
penthouse control panel - thing
    large red button (part of penthouse control panel)
location: in the western corner of the penthouse
singular-named, improper-named, unused; unlit, inedible, fixed in place, scenery, neuter, unseen, unfamiliar, non-pourable, dull; list grouping key: none
printed name: "penthouse control panel"
printed plural name: none
indefinite article: none
most recent reference: nominal
third singular pronoun: It-pronoun
conversation: none
description: "The panel features two buttons, one a large red button labeled "Press Me", and the other a small black button without a label.""
initial appearance: none
third-plural-pronoun: They-pronoun

* * *

>gonear array of diamonds
Galaxy Jones is in the southern corner of the penthouse. This must be Thallium's "treasure room", to go by the obscene display of wealth. The most notable feature is the array of diamonds lining the walls. Everything else here pales in comparison. The penthouse continues to the northwest, north, and northeast.

Thallium seems to speak from all around Jones. "You like diamonds, Jones? Of course you do -- they're a girl's best friend, after all."

Jones snorts, "Sure, Thallium."

>purloin real
[Purloined.]

>nw
Galaxy Jones is in the western corner of the penthouse. The purpose of this room is unclear. Instead of the black carpet that plagues the rest of the penthouse, the floor is fashioned from a striking polished red granite. Instead of windows, there are walls. Thallium's personal insignia, the ten planets in order overlaid with the motto "Planetas Vincam", is carved into the deep red wood outer wall, and inlaid with ebony. In the center of the room is a thin metal pillar ending in a claw, which looks like it's meant to hold something. Finally, there is something that looks like an electronic eye set into the inner wall. One may leave to the northeast or southeast.

* * *

>put diamond in claw
As soon as insert the diamond into the claw, laser beams spring from five emitters on the walls. They hit the diamond and join into a single more powerful beam that strikes the electronic eye on the wall. A sound like a sliding door comes from behind Jones, and she spins around to see the red wall slide down into the floor. It exposes a control panel of sorts, featuring a large red button labeled "Press Me".

>press button
Thallium's voice startles Jones, and she forgets the button for a moment.

"Yes, yes, press it!", Thallium squeaks.

>press button
Jones presses the red button, but nothing seems to happen. After a few seconds, however, she starts to feel light-headed, and shortly after she starts to suffocate. It's not a nice way to die.
Thallium's voice is thick with feigned concern. Oh, my poor, poor Galaxy Jones. And you were so close.

    *** Galaxy Jones was killed by poison gas. ***

In that game you scored 0 out of a possible 10, in 5 turns.

Would you like to RESTART, RESTORE a saved game, QUIT, or UNDO the last command?

* * *

>gonear array of diamonds
Galaxy Jones is in the southern corner of the penthouse. This must be Thallium's "treasure room", to go by the obscene display of wealth. The most notable feature is the array of diamonds lining the walls. Everything else here pales in comparison. The penthouse continues to the northwest, north, and northeast.

Thallium seems to speak from all around Jones. "You like diamonds, Jones? Of course you do -- they're a girl's best friend, after all."

Jones snorts, "Sure, Thallium."

>shoot diamonds
Jones only uses violent means when absolutely necessary.

>take diamond
You pry one of the diamonds out of the wall.

Thallium giggles. "Oh, I hope you're not disappointed, Jones."

>x it
Jones: "Hmm. This is made of glass."

Thallium: "Poor, sad Jones. But here's the thing. There is a real diamond in there; it's just you'll never find it before the building's defenses flood the whole floor with poisonous gas. Or maybe I'm bluffing. Maybe I'm not. Can you afford to gamble?"

Jones tosses the fake away.

>shoot diamonds
Shooting one diamond at a time would be too slow.

* * *

>gonear cage
Galaxy Jones is next to the cage. The closely-set silnium bars seem to dash all hope of a rescue. The flyer pad is to the southwest and the rest of the rooftop to the south.

Europa Callisto is lying at the center of the cage, out of Jones's reach.

Jones tries the strength of the bars just in case. They don't budge.

South of the cage, Thallium crosses the roof to the flyer pad, where he boards the waiting flyer. The flyer lifts off and moves towards Jones.

>showme
cage - room
    Admiral Thallium's flyer - backdrop
    electrostatic field - backdrop
    outside - backdrop
    Jones - person
        black jumpsuit (worn)
            suit light (part of black jumpsuit)
        disruptor pistol
    Europa Callisto - woman
    cage - supporter
    cage-container - transparent open container

>x cage-container
There's nothing like that nearby.

>x cage
(the cage)
The cage is huge for holding just one prisoner. The silnium bars are grey and iridescent. They run both horizontally and vertically, creating a lattice. The floor is hard and cold.

Thallium's flyer hovers over the rooftop. "Jones!"  he bellows. "Play time is over. I grow weary of your intransigence. In a moment this roof will be swarmed by guard robots -- of many different colors -- so many robots you couldn't possibly vandalize them all.  Say your prayers, Jones, or whatever you do when you're about to die."

Jones rolls her eyes.

A little ways off, a small red flyer aims for the rooftop and accelerates.

>x europa
Europa Callisto is a stunningly beautiful woman with long ice-blue hair and piercing blue eyes. Right now she's looking pretty ragged, though.

>take her
Jones can't reach Europa inside the cage.

>i
Jones is carrying:
  a black jumpsuit (being worn)
  a disruptor pistol

>touch callisto
Jones can't reach Europa inside the cage.

Thallium's flyer is circling you not too far away. "Give up, Jones! You'll never get through my silnium bars, haha!"

>gonear air
(the air handling room)
Galaxy Jones is in the air handling room. There is a good number of loud fans and other air handling machinery here. A small hinged vent opening leads into some ductwork, and from there to the outside. A door leads west.

>showme
air handling room - room
    air handling door - closed door
    Jones - person
        black jumpsuit (worn)
            suit light (part of black jumpsuit)
        disruptor pistol
    vent access door - closed door
    fans
    ductwork

>x fans
They're loud.

>x ductwork
A short length leading from the fans here to the outside.

>out
The atmosphere is too thin out there. Jones needs protective gear.

>purloin atmo
[Purloined.]

>out
Thallium's flyer floats after Jones.

The scaffold is not at this floor.

Thallium: "Jones! In a moment I shall leave you to be slaughtered by my minions!"

>gonear scaffold
Which do you mean, the window washing scaffold, the scaffold control panel, the scaffold, the scaffold up button, or the scaffold down button?

>window
(the window washing scaffold)
Galaxy Jones is on a window washing scaffold. It's lined up with the eighth floor window. There doesn't seem to be any way to get into the building here. Mounted on the scaffold is a control panel with two buttons: one indicating up and one indicating down.

>showme
window washing scaffold - room
    windows - backdrop
    wall - backdrop
    the city - backdrop
    Jones - person
        Atmo-Suit
        black jumpsuit (worn)
            suit light (part of black jumpsuit)
        disruptor pistol
    scaffold control panel
        scaffold up button (part of scaffold control panel)
        scaffold down button (part of scaffold control panel)

>x wall
Right now, it's Jones's only friend.

>x windows
It's dark inside, preventing Jones from seeing what's in there.

>w
Thallium's flyer floats after Jones.

None of the windows here are open.

>e
That way leads to a quick death.

* * *

>gonear cage
Galaxy Jones is next to the cage. The closely-set silnium bars seem to dash all hope of a rescue. The flyer pad is to the southwest and the rest of the rooftop to the south.

Europa Callisto is lying at the center of the cage, out of Jones's reach.

Jones tries the strength of the bars just in case. They don't budge.

South of the cage, Thallium crosses the roof to the flyer pad, where he boards the waiting flyer. The flyer lifts off and moves towards Jones.

>x cage
The cage is huge for holding just one prisoner. The silnium bars are grey and iridescent. They run both horizontally and vertically, creating a lattice. The floor is hard and cold.

Thallium's flyer hovers over the rooftop. "Jones!"  he bellows. "Play time is over. I grow weary of your intransigence. In a moment this roof will be swarmed by guard robots -- of many different colors -- so many robots you couldn't possibly vandalize them all.  Say your prayers, Jones, or whatever you do when you're about to die."

Jones rolls her eyes.

A little ways off, a small red flyer aims for the rooftop and accelerates.

>up
Jones gets onto the cage.

>d
Jones gets off the cage.

Galaxy Jones is next to the cage. The closely-set silnium bars seem to dash all hope of a rescue. The flyer pad is to the southwest and the rest of the rooftop to the south.

Europa Callisto is lying at the center of the cage, out of Jones's reach.

Admiral Thallium's flyer is hovering above you.

* * *

>gonear claw
Galaxy Jones is in the western corner of the penthouse. The purpose of this room is unclear. Instead of the black carpet that plagues the rest of the penthouse, the floor is fashioned from a striking polished red granite. Instead of windows, there are walls. Thallium's personal insignia, the ten planets in order overlaid with the motto "Planetas Vincam", is carved into the deep red wood outer wall, and inlaid with ebony. In the center of the room is a thin metal pillar ending in a claw, which looks like it's meant to hold something. Finally, there is something that looks like an electronic eye set into the inner wall. One may leave to the northeast or southeast.

>purloin real
[Purloined.]

>put it in claw
As soon as insert the diamond into the claw, laser beams spring from five emitters on the walls. They hit the diamond and join into a single more powerful beam that strikes the electronic eye on the wall. A sound like a sliding door comes from behind Jones, and she spins around to see the red wall slide down into the floor. It exposes a control panel of sorts, featuring a large red button labeled "Press Me".

>press button
Thallium's voice startles Jones, and she forgets the button for a moment.

"Yes, yes, press it!", Thallium squeaks.

>press button
Jones presses the red button, but nothing seems to happen. After a few seconds, however, she starts to feel light-headed, and shortly after she starts to suffocate. It's not a nice way to die.

Thallium's voice is thick with feigned concern. "Oh, my poor, poor Galaxy Jones. And you were so close."

    *** Galaxy Jones was killed by poison gas. ***

In that game you scored 0 out of a possible 10, in 4 turns.

Would you like to RESTART, RESTORE a saved game, QUIT, or UNDO the last command?

* * *

>gonear elevator car-room
There seems to be no such object anywhere in the model world.

>gonear tenth hall
Galaxy Jones is in the tenth floor elevator hall. The elevator car to the west stands open. There is a stairwell to the east. The hall runs north and south into a sumptuous corporate office.

>w
Galaxy Jones is in the elevator car. It's luxurious, with gold-plated walls and crystal lighting on the ceiling. The button panel is lacquered dark mahogany with what look like real ivory buttons. The carpeting is soft and plush. A golden keyhole sits above the buttons. You can leave the elevator to the east.

One of the ceiling panels looks loose.

Admiral Thallium's voice oozes from concealed speakers: "Yes, Jones, that is real ivory. I imported the elephant here myself for a hunt on my estate. You have no idea how much money it takes to simulate an African jungle on Mars. In retrospect I should have gotten an Indian elephant."

>showme
elevator car - room
    elevator car - backdrop
    Jones - person
        black jumpsuit (worn)
            suit light (part of black jumpsuit)
        disruptor pistol
    golden keyhole
    ceiling panel
    elevator car door
    walls
    crystal lighting
    elevator control panel
    ivory buttons
    carpeting

>x car
Which do you mean, the elevator car, the elevator car door, or the elevator car?

>showme all elevator car
(the elevator car)
elevator car - room
    elevator car - backdrop
    Jones - person
        black jumpsuit (worn)
            suit light (part of black jumpsuit)
        disruptor pistol
    golden keyhole
    ceiling panel
    elevator car door
    walls
    crystal lighting
    elevator control panel
    ivory buttons
    carpeting
singular-named, improper-named, unused; lighted, visited, apparent, open space, safe; list grouping key: none
printed name: "elevator car"
printed plural name: none
indefinite article: none
most recent reference: nominal
third singular pronoun: It-pronoun
conversation: none
description: "It's luxurious, with gold-plated walls and crystal lighting on the ceiling. The button panel is lacquered dark mahogany with what look like real ivory buttons. The carpeting is soft and plush. A golden keyhole sits above the buttons. You can leave the elevator to the east."
map region: tenth-floor-region
preposition: "in"
destination name: none
floor: 10

* * *

>gonear penthouse west
Galaxy Jones is in the western corner of the penthouse. The purpose of this room is unclear. Instead of the black carpet that plagues the rest of the penthouse, the floor is fashioned from a striking polished red granite. Instead of windows, there are walls. Thallium's personal insignia, the ten planets in order overlaid with the motto "Planetas Vincam", is carved into the deep red wood outer wall, and inlaid with ebony. In the center of the room is a thin metal pillar ending in a claw, which looks like it's meant to hold something. Finally, there is something that looks like an electronic eye set into the inner wall. One may leave to the northeast or southeast.

>purloin real
[Purloined.]

* * *

>put it in claw
As soon as insert the diamond into the claw, laser beams spring from five emitters on the walls. They hit the diamond and join into a single more powerful beam that strikes the electronic eye on the wall. A sound like a sliding door comes from behind Jones, and she spins around to see the red wall slide down into the floor. It exposes a control panel of sorts, featuring a large red button labeled "Press Me".

>x claw
In the claw is a diamond.

>take gem
Taken.

>x claw
It looks like it could grip a small object.

>showme
western corner of the penthouse - room
    penthouse control panel
        large red button (part of penthouse control panel)
    Jones - person
        diamond - gem
        black jumpsuit (worn)
            suit light (part of black jumpsuit)
        disruptor pistol
    metal pillar
        claw (part of metal pillar) - open container
    granite floor
    walls
    insignia
    electronic eye

>x red button
It's labeled "Press Me".

>x panel
Jones discovers a secret panel, which when opened exposes a small black button.

>showme
western corner of the penthouse - room
    penthouse control panel
        small black button (part of penthouse control panel)
        large red button (part of penthouse control panel)
    Jones - person
        diamond - gem
        black jumpsuit (worn)
            suit light (part of black jumpsuit)
        disruptor pistol
    metal pillar
        claw (part of metal pillar) - open container
    granite floor
    walls
    insignia
    electronic eye

>x black
(the black jumpsuit)
It's an advanced Smart Suit, able to communicate sound, vision, and radar back to Beck at Galaxy Base. Also it has a neat light.

>x black button
Very nondescript.

>x diamond
Maybe 2.5 carats, it's a beautiful gem, if you're into diamonds.

>ne
Galaxy Jones is in the northern corner of the penthouse. This is Thallium's bedroom. Apart from the expansive round bed in the center of the room, notable features include the line of dummies displaying his various suits of clothes, a large vanity table, and the complete lack of mirrors on the ceiling, thankfully. One may leave the room to the southwest, south, and southeast.

>showme
northern corner of the penthouse - room
    outside - backdrop
    Jones - person
        diamond - gem
        black jumpsuit (worn)
            suit light (part of black jumpsuit)
        disruptor pistol
    expensive round bed
    dummies
    Admiral Thallium's clothes
    vanity table

>x outside
(outside)
Looking down at New Reykjavik, one can trace the history of the city, as it expanded radially from its original domes, the multiple frontiers colliding and interfering like ripples in a pond, until eventually, the map gave way to rectangular regularity. The Viking Building stands near the periphery, overlooking the vast red plain of Utopia Planitia.

>x window
Looking down at New Reykjavik, one can trace the history of the city, as it expanded radially from its original domes, the multiple frontiers colliding and interfering like ripples in a pond, until eventually, the map gave way to rectangular regularity. The Viking Building stands near the periphery, overlooking the vast red plain of Utopia Planitia.

>x bed
It's round and huge, and it looks supremely comfortable.

>x dummies
The best outfit is his Napoleon outfit.

>x clothes
Hideous.

>x table
A vanity table. So aptly named for a man like the Admiral.

>take it
It's too big to carry around.

>look under table
Jones finds nothing of interest.

>ne
The diamond-shaped penthouse bends to the southeast and southwest.

>se
Galaxy Jones is in the eastern corner of the penthouse. This is apparently an office. A huge desk constructed of bubinga wood and carved in intricate patterns sits before the panoramic window. Video screens, currently displaying Thallium's logo, line the walls. Jones can go northwest or southwest.

>showme
eastern corner of the penthouse - room
    outside - backdrop
    Jones - person
        diamond - gem
        black jumpsuit (worn)
            suit light (part of black jumpsuit)
        disruptor pistol
    huge desk
    video screens
    walls
    Admiral Thallium's logo

>x outside
(outside)
Looking down at New Reykjavik, one can trace the history of the city, as it expanded radially from its original domes, the multiple frontiers colliding and interfering like ripples in a pond, until eventually, the map gave way to rectangular regularity. The Viking Building stands near the periphery, overlooking the vast red plain of Utopia Planitia.

>x desk
Bubinga wood, if you must know, is, according to Wikipedia, "a flowering plant genus in the family Fabaceae".

>x bubinga
Bubinga wood, if you must know, is, according to Wikipedia, "a flowering plant genus in the family Fabaceae".

>x screens
They are showing Thallium's logo, the ten planets in order overlaid with the motto "Planetas Vincam".

>x logo
The ten planets in order overlaid with the motto "Planetas Vincam".

>x planets
The ten planets in order overlaid with the motto "Planetas Vincam".

>take planets
Jones can't take that.

>x logo
The ten planets in order overlaid with the motto "Planetas Vincam".

>take it
Jones can't take that.

>take bubinga
This desk would take three or four people to move.

>sw
Galaxy Jones is in the southern corner of the penthouse. This must be Thallium's "treasure room", to go by the obscene display of wealth. The most notable feature is the array of diamonds lining the walls. Everything else here pales in comparison. The penthouse continues to the northwest, north, and northeast.

Thallium seems to speak from all around Jones. "You like diamonds, Jones? Of course you do -- they're a girl's best friend, after all."

Jones snorts, "Sure, Thallium."

>showme
southern corner of the penthouse - room
    outside - backdrop
    Jones - person
        diamond - gem
        black jumpsuit (worn)
            suit light (part of black jumpsuit)
        disruptor pistol
    treasure
    array of diamonds

>x array
So many of them, from the tiny to the obscenely large. It looks like it wouldn't be hard to pry one out.

>take it
Jones can't take that.

>take array
Jones can't take that.

>take diamond
(the diamond)
Jones already has that.

>restart
Are you sure you want to restart?

* * *

>gonear array
Which do you mean, the catering table or the array of diamonds?

>diamonds
Galaxy Jones is in the southern corner of the penthouse. This must be Thallium's "treasure room", to go by the obscene display of wealth. The most notable feature is the array of diamonds lining the walls. Everything else here pales in comparison. The penthouse continues to the northwest, north, and northeast.

Thallium seems to speak from all around Jones. "You like diamonds, Jones? Of course you do -- they're a girl's best friend, after all."

Jones snorts, "Sure, Thallium."

>showme
southern corner of the penthouse - room
    outside - backdrop
    Jones - person
        black jumpsuit (worn)
            suit light (part of black jumpsuit)
        disruptor pistol
    treasure
    array of diamonds

>take array
You pry one of the diamonds out of the wall.

Thallium giggles. "Oh, I hope you're not disappointed, Jones."

>showme
southern corner of the penthouse - room
    outside - backdrop
    Jones - person
        diamond - gem
        black jumpsuit (worn)
            suit light (part of black jumpsuit)
        disruptor pistol
    treasure
    array of diamonds

>x treasure
A wall of diamonds is treasure enough, don't you think?

>x diamond
(the diamond)

Jones: "Hmm. This is made of glass."

Thallium: "Poor, sad Jones. But here's the thing. There is a real diamond in there; it's just you'll never find it before the building's defenses flood the whole floor with poisonous gas. Or maybe I'm bluffing. Maybe I'm not. Can you afford to gamble?"

Jones tosses the fake away.

>x diamonds
It's impossible to tell which ones are real and which are glass without prying each one out separately.

>take diamond
Jones will never find the real diamond this way.

>nw
Galaxy Jones is in the western corner of the penthouse. The purpose of this room is unclear. Instead of the black carpet that plagues the rest of the penthouse, the floor is fashioned from a striking polished red granite. Instead of windows, there are walls. Thallium's personal insignia, the ten planets in order overlaid with the motto "Planetas Vincam", is carved into the deep red wood outer wall, and inlaid with ebony. In the center of the room is a thin metal pillar ending in a claw, which looks like it's meant to hold something. Finally, there is something that looks like an electronic eye set into the inner wall. One may leave to the northeast or southeast.

>purloin hammer
[Purloined.]

>se
Galaxy Jones is in the southern corner of the penthouse. This must be Thallium's "treasure room", to go by the obscene display of wealth. The most notable feature is the array of diamonds lining the walls. Everything else here pales in comparison. The penthouse continues to the northwest, north, and northeast.

>hit
What should Jones hit?

>diammond
There's nothing like that nearby.

>diamond
I didn't understand that sentence.

>hit diamond
(with the hammer)
Jones commences to smash all of the diamonds. After destroying several dozen fraudulent gems, she finds one that won't break. She takes the real diamond.

Thallium: "Wow, clever solution. Be careful you don't cut yourself."

Jones: "I appreciate your concern."

>x glass
The remains of dozens of glass diamonds litter the floor.

>showme
southern corner of the penthouse - room
    glass shards
    Jones - person
        diamond - gem
        hammer
        black jumpsuit (worn)
            suit light (part of black jumpsuit)
        disruptor pistol
    outside - backdrop
    treasure
    array of diamonds

>take glass
Jones would just cut her hands.

>n
Galaxy Jones is in the 100th floor elevator hall. The luxury is staggering.  The walls are made of polished black marble, and the floors are covered in plush black carpeting that muffles the sound of footsteps. The ceiling is high and adorned with a crystal chandelier. The elevator doors to the west are gold-plated. Sumptuous living quarters are visible to the north and south.

>n
Galaxy Jones is in the northern corner of the penthouse. This is Thallium's bedroom. Apart from the expansive round bed in the center of the room, notable features include the line of dummies displaying his various suits of clothes, a large vanity table, and the complete lack of mirrors on the ceiling, thankfully. One may leave the room to the southwest, south, and southeast.

* * *

>x control
There's nothing like that nearby.

>i
Jones is carrying:
  a diamond
  a hammer
  a black jumpsuit (being worn)
  a disruptor pistol

>put diamond in claw
As soon as insert the diamond into the claw, laser beams spring from five emitters on the walls. They hit the diamond and join into a single more powerful beam that strikes the electronic eye on the wall. A sound like a sliding door comes from behind Jones, and she spins around to see the red wall slide down into the floor. It exposes a control panel of sorts, featuring a large red button labeled "Press Me".

* * *

>showme
penthouse roof - room
    cage - backdrop
    Admiral Thallium's flyer - backdrop
    electrostatic field - backdrop
    outside - backdrop
    roof access door - locked door
    Jones - person
        hammer
        black jumpsuit (worn)
            suit light (part of black jumpsuit)
        disruptor pistol
    Admiral Thallium - man
    lounge area
    rooftop seating

>x cage
You can see the cage with Europa Callisto in it from here. She's lying on the floor and not moving.

>x flyer
It's big and green and black. Looks like a Sirius XE.

>x field
It can't be seen, but it's comforting to know it's there.

>x outside
(outside)
Looking down at New Reykjavik, one can trace the history of the city, as it expanded radially from its original domes, the multiple frontiers colliding and interfering like ripples in a pond, until eventually, the map gave way to rectangular regularity. The Viking Building stands near the periphery, overlooking the vast red plain of Utopia Planitia.

>x door
Looking strangely out of place, it is a common grey metal door with a push bar.

>open it
It seems to be locked.

>unlock it
Jones lacks a key that fits the roof access door.

>x thallium
(Admiral Thallium)
The "Admiral" is a disctinctly ridiculous figure. He dresses in a mockery of a Martian admiral's uniform, plastered with medals. His hair is slicked back and his mustache is painstakingly waxed.

>x seating
Jones has other things to focus on.

>l
Galaxy Jones is on the penthouse roof. It is an extravagant and opulent space, designed to showcase Thallium's wealth and power. Much of the rooftop is devoted to an outdoor lounge area, with comfortable seating and a fire pit, centered around a hot tub and flanked by a bar. All around is the city of New Reykjavik, and beyond that the red Martian landscape. Around the entirety of the roof is an electrostatic field designed to keep air in and particulates out. To the north is a large cage, and to the west is a landing pad. Jones can distantly see a woman lying on the floor of the cage. A green and black flyer sits on the landing pad.

Admiral Thallium is sulking.

>x tub
Looks like a good time, if Jones weren't already busy.

>showme
penthouse roof - room
    cage - backdrop
    Admiral Thallium's flyer - backdrop
    electrostatic field - backdrop
    outside - backdrop
    roof access door - locked door
    Jones - person
        hammer
        black jumpsuit (worn)
            suit light (part of black jumpsuit)
        disruptor pistol
    Admiral Thallium - man
    lounge area
    rooftop seating

>x lounge
Looks like a good time, if Jones weren't already busy.

>w
Thallium trails after Jones.

Um, Jones -- that harlot you're so bent on freeing from captivity is over there. Now get out of the way, I'm trying to escape."

Thallium pushes past Jones. She attempts to grab his shoulder, but she is thrown back by an unseen force.

Thallium smirks. "Personal security field, remember? Now I must be off."

Jones watches as Thallium boards the flyer. It takes off a moment later.

Galaxy Jones is on the flyer pad. This is what one would expect from a rooftop flyer pad: landing lights surrounding a large letter F painted in white on a red background. Europa's cage is to the northeast and the rest of the rooftop is to the east.

>showme
flyer pad - room
    cage - backdrop
    Admiral Thallium's flyer - backdrop
    electrostatic field - backdrop
    outside - backdrop
    Jones - person
        hammer
        black jumpsuit (worn)
            suit light (part of black jumpsuit)
        disruptor pistol

>x cage
You can see the cage with Europa Callisto in it from here. She's lying on the floor and not moving.

Thallium's flyer hovers over the rooftop. "Jones!"  he bellows. "Play time is over. I grow weary of your intransigence. In a moment this roof will be swarmed by guard robots -- of many different colors -- so many robots you couldn't possibly vandalize them all.  Say your prayers, Jones, or whatever you do when you're about to die."

Jones rolls her eyes.

A little ways off, a small red flyer aims for the rooftop and accelerates.

>x flyer
Which do you mean, the red flyer, Admiral Thallium's flyer, or the flyer pad?

>admiral
Hovering above Jones, it's distinctly menacing. It's not visibly armed, but it conveys the impression of a beast about to strike. It's flying low, the rails of its landing gear just a few feet above Jones's head.

>x pad
Galaxy Jones is on the flyer pad. This is what one would expect from a rooftop flyer pad: landing lights surrounding a large letter F painted in white on a red background. Europa's cage is to the northeast and the rest of the rooftop is to the east.

Admiral Thallium's flyer is hovering above you.

>x red
Which do you mean, the red flyer or outside?

>flyer
It's little more than a growing red speck.

>x outside
(outside)
Looking down at New Reykjavik, one can trace the history of the city, as it expanded radially from its original domes, the multiple frontiers colliding and interfering like ripples in a pond, until eventually, the map gave way to rectangular regularity. The Viking Building stands near the periphery, overlooking the vast red plain of Utopia Planitia.

Thallium's flyer is circling you not too far away. "Give up, Jones! You'll never get through my silnium bars, haha!"

>showme
flyer pad - room
    red flyer - backdrop
    cage - backdrop
    Admiral Thallium's flyer - backdrop
    electrostatic field - backdrop
    outside - backdrop
    Jones - person
        hammer
        black jumpsuit (worn)
            suit light (part of black jumpsuit)
        disruptor pistol

>x thallium
Hovering above Jones, it's distinctly menacing. It's not visibly armed, but it conveys the impression of a beast about to strike. It's flying low, the rails of its landing gear just a few feet above Jones's head.

>ne
Thallium's flyer floats after Jones.

Galaxy Jones is next to the cage. The closely-set silnium bars seem to dash all hope of a rescue. The flyer pad is to the southwest and the rest of the rooftop to the south.

Europa Callisto is lying at the center of the cage, out of Jones's reach.

Admiral Thallium's flyer is hovering above you.

>showme
cage - room
    Admiral Thallium's flyer - backdrop
    electrostatic field - backdrop
    red flyer - backdrop
    outside - backdrop
    Jones - person
        hammer
        black jumpsuit (worn)
            suit light (part of black jumpsuit)
        disruptor pistol
    Europa Callisto - woman
    cage - supporter
    cage-container - transparent open container

>x cage
(the cage)
The cage is huge for holding just one prisoner. The silnium bars are grey and iridescent. They run both horizontally and vertically, creating a lattice. The floor is hard and cold.

>x cage-container
The cage-container is empty.

* * *

>purloin real diamond
[Purloined.]

>x walls
The outer wall is all of red wood inlaid with ebony, while the inner wall, made of brushed stainless steel, is inset with an electronic eye.

>put gem in claw
As soon as insert the diamond into the claw, laser beams spring from five emitters on the walls. They hit the diamond and join into a single more powerful beam that strikes the electronic eye on the wall. A sound like a sliding door comes from behind Jones, and she spins around to see the red wall slide down into the floor. It exposes a control panel of sorts, featuring a large red button labeled "Press Me".

>x walls
The outer wall has moved to expose a control panel, while the inner wall, made of brushed stainless steel, is inset with an electronic eye.

>x claw
It looks like it could grip a small object.

In the claw is a diamond.

* * *

>x car
(the elevator car)
Galaxy Jones is in the elevator car. It's luxurious, with gold-plated walls and crystal lighting on the ceiling. The button panel is lacquered dark mahogany with what look like real ivory buttons. The carpeting is soft and plush. A golden keyhole sits above the buttons. You can leave the elevator to the east.

One of the ceiling panels looks loose.

>x car door
The door is open.

Thallium's voice booms over the office PA: "You can run, Jones, but you can't - well, there aren't very many places you can hide."

>close car door
Jones can't close them by hand, and the elevator seems to be off.

* * *

>gonear window washing
(the window washing scaffold)
Galaxy Jones is on a window washing scaffold. It's lined up with the eighth floor window. There doesn't seem to be any way to get into the building here. Mounted on the scaffold is a control panel with two buttons: one indicating up and one indicating down.

>showme
window washing scaffold - room
    windows - backdrop
    wall - backdrop
    the city - backdrop
    Jones - person
        black jumpsuit (worn)
            suit light (part of black jumpsuit)
        disruptor pistol
    scaffold control panel
        scaffold up button (part of scaffold control panel)
        scaffold down button (part of scaffold control panel)

>x control panel
It's got two buttons: up and down.

>x up
(the scaffold up button)
It's a green button with an arrow pointing up.

>x down
(the scaffold down button)
It's a red button with an arrow pointing down.

>x wall
Right now, it's Jones's only friend.

* * *

>x windows
It's dark inside, preventing Jones from seeing what's in there.

>press up
(the scaffold up button)
Jones presses the button, and the scaffold begins to rise.

Galaxy Jones is on a window washing scaffold. It's lined up with the ninth floor window. She could climb back into the building through the window here. Mounted on the scaffold is a control panel with two buttons: one indicating up and one indicating down.

Jones: "Beck?"

Beck: "Yes?"

Jones: "I hate it out here."

Beck: "Well, there's the open window right next to you."

>x window
(windows)
The window here is broken, allowing Jones to reenter the building.

>x wall
Right now, it's Jones's only friend.

>w
Galaxy Jones is in the Cybernetica office. It's spacious and luxurious, designed to make developers forget how spent they are from months of overwork and abuse. Ergonomic desks and chairs fill space like a furniture fractal, before giving way to an open area, presumably for group activities.

As soon as Jones steps into the office, a shot zaps just past her nose. She dives to the ground, protected by the maze of desks and chairs. Peeking through the mesh back of one of the chairs, she takes notice of both the purple guard robot training its disruptor on the room, and the chair's fine construction and lumbar support.

Jones (whispering): "We've got another one! I'm out of sight for now, but it's going to be hard to get a shot off at this 'bot."

Beck: "What's the situation?"

Jones: "I'm on the floor with desks and chairs all around. The target is a few yards off, coming this way. I can get a shot in, but it might just absorb it anyway."

Beck: "Well, see if you can sneak up on it. Maybe close up you can find a way past its defenses."

>sneak up on robot
Jones creeps a little ways toward the guard robot.

* * *

>g
Slowly, slowly, Jones gets a little closer. Just a little more...

She must have poked up her shoulder or something, for the guard robot fires his disruptor. The shot takes out a window on the east side of the room. The electrostatic field around the building keeps the atmosphere from pouring out.

>g
Jones is right up next to the robot, crouched beneath a desk. She can see right up under its armor.

>shoot robot
Jones aims the pistol upward under the robot's enhanced armor and fires. She flinches back when the robot's innards explode downward in a shower of sparks. It topples over, dead. Jones stands up and surveys her handiwork.

 _________      __                     _____                     
 __/ ____/___ _/ /___ __  ____  __     __/ /___  ____  ___  _____
 _/ / __/ __ `/ / __ `/ |/ / / / /____ _/ / __ \/ __ \/ _ \/ ___/
 / /_/ / /_/ / / /_/ />  </ /_/ / _/ /_/ / /_/ / / / /  __(__  ) 
 \____/\__,_/_/\__,_/_/|_|\__, /  _\____/\____/_/ /_/\___/____/  
 _____________________________/ 

[Your score has just gone up by one point.]

Jones: "Better than a video game. "

Beck: "Nice, but don't forget to credit your handler."

Jones: "Yes, yes, thanks for helping me not get killed."

Beck: "You're welcome."

>x window
Which do you mean, outside or broken window?

>broken
Looks like Jones could get through if she's careful. There's a ledge outside.

>e
The atmosphere is too thin out there. Jones needs protective gear.

>showme broken
broken window - thing
location: in the Cybernetica office
singular-named, proper-named, unused; unlit, inedible, fixed in place, scenery, neuter, seen, familiar, examined, non-pourable, dull
list grouping key: none
printed name: "broken window"
printed plural name: none
indefinite article: none
most recent reference: nominal
third singular pronoun: It-pronoun
conversation: none
description: "Looks like Jones could get through if she's careful. There's a ledge outside."
initial appearance: none
third-plural-pronoun: They-pronoun

>restart
Are you sure you want to restart?

* * *

>gonear cybernetica office
(the Cybernetica office)
Galaxy Jones is in the Cybernetica office. It's spacious and luxurious, designed to make developers forget how spent they are from months of overwork and abuse. Ergonomic desks and chairs fill space like a furniture fractal, before giving way to an open area, presumably for group activities.

As soon as Jones steps into the office, a shot zaps just past her nose. She dives to the ground, protected by the maze of desks and chairs. Peeking through the mesh back of one of the chairs, she takes notice of both the purple guard robot training its disruptor on the room, and the chair's fine construction and lumbar support.

Jones (whispering): "We've got another one! I'm out of sight for now, but it's going to be hard to get a shot off at this 'bot."

Beck: "What's the situation?"

Jones: "I'm on the floor with desks and chairs all around. The target is a few yards off, coming this way. I can get a shot in, but it might just absorb it anyway."

Beck: "Well, see if you can sneak up on it. Maybe close up you can find a way past its defenses."

>x window
Which do you mean, outside or broken window?

* * *

>broken
Looks like Jones could get through if she's careful. There's a ledge outside.

>e
Jones can leave through the door to the west.

* * *

>n
Jones approaches the Viking Building entryway, the dramatic façade towering over her.

Galaxy Jones is at the entry doorway. A glass revolving door leads into a large open space north of here. The speeder dock is to the south.

Jones looks up at the 100 stories of glass and steel. "What do you want to bet Thallium's got Europa all the way at the top?"

Beck: "Oh, no doubt."

>gonear tenth hall
Galaxy Jones is in the tenth floor elevator hall. The elevator car to the west stands open. There is a stairwell to the east. The hall runs north and south into a sumptuous corporate office.

>s
Galaxy Jones is on the south side of the Consolidated Microthings office. This is reception. It has a great view of the New Reykjavik Botanic Dome. Couches are lined up to take advantage. The floor extends east and west, and north to the elevator.

Jones sees the mauve guard robot nearby to the west.

>z
Jones stands around and waits.

The mauve guard robot approaches from the west.

The guard robot moves in on Jones with its slashing knife arms, slicing her to ribbons.

    *** Jones was killed by the mauve guard robot ***

In that game you scored 0 out of a possible 10, in 3 turns.

Would you like to RESTART, RESTORE a saved game, QUIT, or UNDO the last command?

>undo
Galaxy Jones is on the south side of the Consolidated Microthings office.
[Previous turn undone.]

>z
Jones stands around and waits.

The mauve guard robot approaches from the west.

The guard robot moves in on Jones with its slashing knife arms, slicing her to ribbons.

    *** Jones was killed by the mauve guard robot ***

In that game you scored 0 out of a possible 10, in 3 turns.

Would you like to RESTART, RESTORE a saved game, QUIT, or UNDO the last command?

>z
Please give one of the answers above.

Would you like to RESTART, RESTORE a saved game, QUIT, or UNDO the last command?

>undo
Galaxy Jones is on the south side of the Consolidated Microthings office.
[Previous turn undone.]

>z
Jones stands around and waits.

The mauve guard robot approaches from the west.

The robot electrocutes Jones with its electro-darts.

    *** Jones was killed by the mauve guard robot ***

In that game you scored 0 out of a possible 10, in 3 turns.

Would you like to RESTART, RESTORE a saved game, QUIT, or UNDO the last command?

>undo
Galaxy Jones is on the south side of the Consolidated Microthings office.
[Previous turn undone.]

>z
Jones stands around and waits.

The mauve guard robot approaches from the west.

Jones doesn't stand a chance against the mauve guard robot's terrible knives.

    *** Jones was killed by the mauve guard robot ***

In that game you scored 0 out of a possible 10, in 3 turns.

Would you like to RESTART, RESTORE a saved game, QUIT, or UNDO the last command?

>undo
Galaxy Jones is on the south side of the Consolidated Microthings office.
[Previous turn undone.]

>n
Galaxy Jones is in the tenth floor elevator hall. The elevator car to the west stands open. There is a stairwell to the east. The hall runs north and south into a sumptuous corporate office.

The mauve guard robot appears nearby to the south, coming from the west.

>z
Jones stands around and waits.

The mauve guard robot approaches from the south.

The guard robot moves in on Jones with its slashing knife arms, slicing her to ribbons.

    *** Jones was killed by the mauve guard robot ***

In that game you scored 0 out of a possible 10, in 4 turns.

Would you like to RESTART, RESTORE a saved game, QUIT, or UNDO the last command?

>undo
Galaxy Jones is in the tenth floor elevator hall.
[Previous turn undone.]

>z
Jones stands around and waits.

The mauve guard robot approaches from the south.

The robot electrocutes Jones with its electro-darts.

    *** Jones was killed by the mauve guard robot ***

In that game you scored 0 out of a possible 10, in 4 turns.

Would you like to RESTART, RESTORE a saved game, QUIT, or UNDO the last command?

>undo
Galaxy Jones is in the tenth floor elevator hall.
[Previous turn undone.]

>undo
Galaxy Jones is on the south side of the Consolidated Microthings office.
[Previous turn undone.]

>z
Jones stands around and waits.

The mauve guard robot approaches from the west.

The robot slaughters Jones.

    *** Jones was killed by the mauve guard robot ***

In that game you scored 0 out of a possible 10, in 3 turns.

Would you like to RESTART, RESTORE a saved game, QUIT, or UNDO the last command?

>undo
Galaxy Jones is on the south side of the Consolidated Microthings office.
[Previous turn undone.]

>z
Jones stands around and waits.

The mauve guard robot approaches from the west.

The robot slaughters Jones.

Thallium's voice booms over the office PA: "You can run, Jones, but you can't - well, there aren't very many places you can hide."

    *** Jones was killed by the mauve guard robot ***

In that game you scored 0 out of a possible 10, in 3 turns.

Would you like to RESTART, RESTORE a saved game, QUIT, or UNDO the last command?

* * *

>gonear tenth hall
Suddenly two robot guards, green and red, emerge from niches in the back wall! Jones dives behind the front desk and draws her disruptor pistol.

Jones shouts, "I'm under fire from two ugly robot things!"

Beck responds, "Monitoring your suit radar."

>shoot art
There's nothing like that nearby.

>retstart
I didn't understand that sentence.

>restart
Are you sure you want to restart?

* * *

>hall
Galaxy Jones is in the tenth floor elevator hall. The elevator car to the west stands open. There is a stairwell to the east. The hall runs north and south into a sumptuous corporate office.

>w
Galaxy Jones is in the elevator car. It's luxurious, with gold-plated walls and crystal lighting on the ceiling. The button panel is lacquered dark mahogany with what look like real ivory buttons. The carpeting is soft and plush. A golden keyhole sits above the buttons.

One of the ceiling panels looks loose.

Admiral Thallium's voice oozes from concealed speakers: "Yes, Jones, that is real ivory. I imported the elephant here myself for a hunt on my estate. You have no idea how much money it takes to simulate an African jungle on Mars. In retrospect I should have gotten an Indian elephant."

>undo
Galaxy Jones is in the tenth floor elevator hall.
[Previous turn undone.]

>w
Galaxy Jones is in the elevator car. It's luxurious, with gold-plated walls and crystal lighting on the ceiling. The button panel is lacquered dark mahogany with what look like real ivory buttons. The carpeting is soft and plush. A golden keyhole sits above the buttons.

One of the ceiling panels looks loose.

Admiral Thallium's voice oozes from concealed speakers: "Yes, Jones, that is real ivory. I imported the elephant here myself for a hunt on my estate. You have no idea how much money it takes to simulate an African jungle on Mars. In retrospect I should have gotten an Indian elephant."

* * *

>restart
Are you sure you want to restart?

* * *

>actions
Actions listing on.

>scenes
Scene 'Entire Game' playing (for 0 mins now)
(Scene monitoring now switched on. Type "scenes off" to switch it off again.)

>n
[going north]
Jones approaches the Viking Building entryway, the dramatic façade towering over her.

Galaxy Jones is at the entry doorway. A glass revolving door leads into a large open space north of here. The speeder dock is to the south.

Jones looks up at the 100 stories of glass and steel. "What do you want to bet Thallium's got Europa all the way at the top?"

Beck: "Oh, no doubt."
[going north - succeeded]

>n
[going north]
Jones takes a deep breath. "I'm going in."

Beck replies, "You got this, Galaxy."

Jones passes through the revolving door and into the lobby, alert to any defenses.

Galaxy Jones is in the lobby. The ground floor of the Viking Building is breathtaking. Low-G architecture means more glass and thinner supports, and the building takes advantage of that. Four walls of glass surround a central pillar in which are set the utility rooms and elevators. In between is an expanse of plants, water features, and stylish seating. Near the entryway is a front desk. A giant crystal sculpture floats above the center of the area, suspended on almost invisible cables. She may go east and west from here, north to the elevators, or south out of the building.

[going north - succeeded]

[Scene 'Lobby Shootout' begins]

>ask beck about beck
[quizzing Beck about Beck]

Jones: "How're you doing, Beck?"

[quizzing Beck about Beck - failed]

Suddenly two robot guards, green and red, emerge from niches in the back wall! Jones dives behind the front desk and draws her disruptor pistol.

Jones shouts, "I'm under fire from two ugly robot things!"

Beck responds, "Monitoring your suit radar."

* * *

>scenes
Scene 'Entire Game' playing (for 0 mins now)
(Scene monitoring now switched on. Type "scenes off" to switch it off again.)

>actions
Actions listing on.

>n
[going north]
Jones approaches the Viking Building entryway, the dramatic façade towering over her.

Galaxy Jones is at the entry doorway. A glass revolving door leads into a large open space north of here. The speeder dock is to the south.

Jones looks up at the 100 stories of glass and steel. "What do you want to bet Thallium's got Europa all the way at the top?"

Beck: "Oh, no doubt."
[going north - succeeded]

* * *

>go south
[going south]
foobar.
[going south - failed]

Suddenly two robot guards, green and red, emerge from niches in the back wall! Jones dives behind the front desk and draws her disruptor pistol.

Jones shouts, "I'm under fire from two ugly robot things!"

Beck responds, "Monitoring your suit radar."

>undo
Galaxy Jones is in the lobby.
[Previous turn undone.]

>enter elevators
[entering the elevators]
As soon as Jones starts to act, an energy beam zips past her head, forcing her back down behind the desk.
[entering the elevators - failed]

Suddenly two robot guards, green and red, emerge from niches in the back wall! She dives behind the front desk and draws her disruptor pistol.

Jones shouts, "I'm under fire from two ugly robot things!"

Beck responds, "Monitoring your suit radar."

* * *

>z
Suddenly two robot guards, green and red, emerge from niches in the back wall! Jones dives behind the front desk and draws her disruptor pistol.

Jones shouts, "I'm under fire from two ugly robot things!"

Beck responds, "Monitoring your suit radar."

>shoot robots
A barrage of fire from the robots prevents Jones from firing.

Zip! Disruptor fire scorches a nearby couch.

>shoot robots
Oof. Big miss.

The two robots coordinate fire over the desk, narrowly missing Jones.

>shoot robots
Oops! Jones misses.

>shoot robots
Jones sticks her head out from behind the desk and squeezes off a shot at the red and green guard robots. In her haste it goes wide of the target.

One of the robots fires directly above Jones's head.

Beck: "How's it going in there?"

"Jones: "You know -- like all art, it's hit or miss."

>shoot robots
Jones's shot goes wide, reflecting off one of the building struts and into the suspended sculpture. The artwork begins to spin wildly, straining its cables.

>shoot robots
Oof. Big miss.

Beck: "Robot on your right!"

One robot tries to flank Jones, but a shot from her disruptor sends it scurrying back.

>shoot robots
A barrage of fire from the robots prevents Jones from firing.

The two robots coordinate fire over the desk, narrowly missing her.

>shoot robots
Jones's shot goes wide, reflecting off one of the building struts and into the suspended sculpture. The artwork begins to spin wildly, straining its cables.

>shoot robots
Oops! Jones misses.

The two robots coordinate fire over the desk, narrowly missing her.

>shoot robots
Jones's shot goes wide, reflecting off one of the building struts and into the suspended sculpture. The artwork begins to spin wildly, straining its cables.

* * *

>shoot robots
Oops! Jones misses.

The two robots coordinate fire over the desk, narrowly missing her.

>shoot robots
Jones sticks her head out from behind the desk and squeezes off a shot at the red and green guard robots. In her haste it goes wide of the target.

>shoot robots
A perfect shot! Yet, somehow, the robot is unscathed.

Jones: "Target seems to be absorbing disruptor fire. This will make things a little harder."

Beck: "Got it."

>shoot robots
Jones sticks her head out from behind the desk and squeezes off a shot at the red and green guard robots. In her haste it goes wide of the target.

>shoot robots
A perfect shot! Yet, somehow, the robot is unscathed.

Jones: "I could use some ideas here!"

>shoot robots
Jones sticks her head out from behind the desk and squeezes off a shot at the red and green guard robots. In her haste it goes wide of the target.

A robot fires a blistering shot into the front desk.

>shoot robots
Oof. Big miss.

>shoot robots
Jones sticks her head out from behind the desk and squeezes off a shot at the red and green guard robots. In her haste it goes wide of the target.

>shoot robots
Jones's shot hits a robot dead on, but nothing happens, almost as if the robot had absorbed the energy.

One robot tries to flank her, but a shot from her disruptor sends it scurrying back.

>shoot robots
Jones's shot goes wide, reflecting off one of the building struts and into the suspended sculpture. The artwork begins to spin wildly, straining its cables.

A robot fires a blistering shot into the front desk.

>shoot robots
A perfect shot! Yet, somehow, the robot is unscathed.

Zip! Disruptor fire scorches a nearby couch.

>shoot art
Jones fires the disruptor into the sculpture's main support cable, snapping it. The huge crystal blob starts to sag, straining the other cables. In quick succession they break as well, and the whole installation plummets to the ground, right on top of the hapless guard robots.
 _________      __                     _____                     
 __/ ____/___ _/ /___ __  ____  __     __/ /___  ____  ___  _____
 _/ / __/ __ `/ / __ `/ |/ / / / /____ _/ / __ \/ __ \/ _ \/ ___/
 / /_/ / /_/ / / /_/ />  </ /_/ / _/ /_/ / /_/ / / / /  __(__  ) 
 \____/\__,_/_/\__,_/_/|_|\__, /  _\____/\____/_/ /_/\___/____/  
 _____________________________/ 

[Your score has just gone up by one point.]

Beck: "What was that crash? What's going on?"

Jones: "That, my friend, was what you'd call a work of art. Targets terminated."

>w
Jones crosses the floor carefully, disruptor pistol at the ready.

Galaxy Jones is at the southwest corner of the ground floor. A lush indoor waterfall here contrasts with the dusty red streets of New Reykjavik beyond the glass walls. The ground floor extends north and east.

Admiral Thallium's voice booms from the ceiling. "Little Galaxy thinks she's beaten the big bad Admiral. Sorry dear, that was only a taste."

>n
Galaxy Jones is on the west side of the ground floor. Semicircular couches open on either side of a central carpeted path leading north and south. Set in the central pillar of the building to the east is a utility door. The city looms beyond the glass wall to the west.

>n
Galaxy Jones is at the northwest corner of the ground floor. A large relief map of Mars is mounted on the north wall here. One can leave here to the south or east.

>e
Galaxy Jones is on the north side of the ground floor. The area is dominated by a towering statue of Admiral Thallium against the north wall. The ground floor extends west and east from here. The elevator is to the south.

* * *

>e
Galaxy Jones is at the northeast corner of the ground floor. The area is dedicated to celebrating the military career of Admiral Thallium. Uniforms, medals, ribbons, and other miscellanea are mounted on the wall or in showcases. All this despite the fact that no one has turned up any evidence that Thallium served in any navy of any country on any planet. One can escape to the west or south.

Jones: "Now this is some choice bullshit here."

Beck: "Looks like the record of the good Admiral's long and dedicated service."

>s
Galaxy Jones is on the east side of the ground floor. Apparently some kind of function was happening here before Admiral Thallium emptied the building, for there is an array of canapes on a catering table here. The floor stretches north and south, and there's a closet door to the west.

Beck: "Blueprints indicate a closet to the west of you. Might be useful."

>s
Galaxy Jones is at the southeast corner of the ground floor. The centerpiece of this area is the actual Viking 2 lander, which landed right here on Utopia Planitia. The glass walls look out onto the city. Jones can go north or west from here.

>s
That way leads through the glass wall.

>w
Galaxy Jones is in the lobby. The ground floor of the Viking Building is breathtaking. Low-G architecture means more glass and thinner supports, and the building takes advantage of that. Four walls of glass surround a central pillar in which are set the utility rooms and elevators. In between is an expanse of plants, water features, and stylish seating. Near the entryway is a front desk. Jones may go east and west from here, north to the elevators, or south out of the building. There are two niches in the central wall from which the guard robots emerged.

Spread across the floor in a tangled ruin are the remains of a giant crystal sculpture and two guard robots.

* * *

>w
Galaxy Jones is at the southwest corner of the ground floor. A lush indoor waterfall here contrasts with the dusty red streets of New Reykjavik beyond the glass walls. The ground floor extends north and east.

>n
Beck: "Yawn."

Jones: "I can't take you anywhere."

Galaxy Jones is on the west side of the ground floor. Semicircular couches open on either side of a central carpeted path leading north and south. Set in the central pillar of the building to the east is a utility door. The city looms beyond the glass wall to the west.

>n
Galaxy Jones is at the northwest corner of the ground floor. A large relief map of Mars is mounted on the north wall here. One can leave here to the south or east.

>n
Jones can't walk through walls. She can go east or south from here.

>n
Jones can't walk through walls. She can go east or south from here.

* * *

>e
Galaxy Jones is at the northeast corner of the ground floor. The area is dedicated to celebrating the military career of Admiral Thallium. Uniforms, medals, ribbons, and other miscellanea are mounted on the wall or in showcases. All this despite the fact that no one has turned up any evidence that Thallium served in any navy of any country on any planet. One can escape to the west or south.

>e
Jones can't walk through walls. She can go south or west from here.

>s
Galaxy Jones is on the east side of the ground floor. Apparently some kind of function was happening here before Admiral Thallium emptied the building, for there is an array of canapes on a catering table here. The floor stretches north and south, and there's a closet door to the west.

* * *

>n
Galaxy Jones is at the northwest corner of the ground floor. A large relief map of Mars is mounted on the north wall here. One can leave here to the south or east.

>e
Beck: "Doo dee doo dee doo"

Jones: "Shut up."

Galaxy Jones is on the north side of the ground floor. The area is dominated by a towering statue of Admiral Thallium against the north wall. The ground floor extends west and east from here. The elevator is to the south.

>e
Galaxy Jones is at the northeast corner of the ground floor. The area is dedicated to celebrating the military career of Admiral Thallium. Uniforms, medals, ribbons, and other miscellanea are mounted on the wall or in showcases. All this despite the fact that no one has turned up any evidence that Thallium served in any navy of any country on any planet. One can escape to the west or south.

* * *

>n
Jones approaches the Viking Building entryway, the dramatic façade towering over her.

Galaxy Jones is at the entry doorway. A glass revolving door leads into a large open space north of here. The speeder dock is to the south.

Jones looks up at the 100 stories of glass and steel. "What do you want to bet Thallium's got Europa all the way at the top?"

Beck: "Oh, no doubt."

>restore
Restore failed.

>gonear air
(the air handling room)
Galaxy Jones is in the air handling room. There is a good number of loud fans and other air handling machinery here. A small hinged vent opening leads into some ductwork, and from there to the outside. A door leads west.

* * *

>w
(first opening the air handling door)

Galaxy Jones is on the north side of the Consolidated Microthings office. This is the company cafeteria. The elevator is south, the air handling room is to the east, and the office continues to the west and southeast.

>s
Galaxy Jones is in the tenth floor elevator hall. The elevator car to the west stands open. There is a stairwell to the east. The hall runs north and south into a sumptuous corporate office.

Thallium's voice booms over the office PA: "You can run, Jones, but you can't - well, there aren't very many places you can hide."

>undo
Galaxy Jones is on the north side of the Consolidated Microthings office.
[Previous turn undone.]

>s
Galaxy Jones is in the tenth floor elevator hall. The elevator car to the west stands open. There is a stairwell to the east. The hall runs north and south into a sumptuous corporate office.

>s
Galaxy Jones is on the south side of the Consolidated Microthings office. This is reception. It has a great view of the New Reykjavik Botanic Dome. Couches are lined up to take advantage. The floor extends east and west, and north to the elevator.

Jones sees the mauve guard robot nearby to the west.

>z
Jones stands around and waits.

The mauve guard robot approaches from the west.

The guard robot moves in on Jones with its slashing knife arms, slicing her to ribbons.

    *** Jones was killed by the mauve guard robot ***

In that game you scored 0 out of a possible 10, in 5 turns.

Would you like to RESTART, RESTORE a saved game, QUIT, or UNDO the last command?

>undo
Galaxy Jones is on the south side of the Consolidated Microthings office.
[Previous turn undone.]

>z
Jones stands around and waits.

The mauve guard robot approaches from the west.

The robot slaughters Jones.

    *** Jones was killed by the mauve guard robot ***

In that game you scored 0 out of a possible 10, in 5 turns.

Would you like to RESTART, RESTORE a saved game, QUIT, or UNDO the last command?

>undo
Galaxy Jones is on the south side of the Consolidated Microthings office.
[Previous turn undone.]

>z
Jones stands around and waits.

The mauve guard robot approaches from the west.

The guard robot moves in on Jones with its slashing knife arms, slicing her to ribbons.

    *** Jones was killed by the mauve guard robot ***

In that game you scored 0 out of a possible 10, in 5 turns.

Would you like to RESTART, RESTORE a saved game, QUIT, or UNDO the last command?

* * *

>undo
Galaxy Jones is on the south side of the Consolidated Microthings office.
[Previous turn undone.]

>z
Jones stands around and waits.

The mauve guard robot approaches from the west.

Jones doesn't stand a chance against the mauve guard robot's terrible knives.

    *** Jones was killed by the mauve guard robot ***

In that game you scored 0 out of a possible 10, in 5 turns.

Would you like to RESTART, RESTORE a saved game, QUIT, or UNDO the last command?

>undo
Galaxy Jones is on the south side of the Consolidated Microthings office.
[Previous turn undone.]

>z
Jones stands around and waits.

The mauve guard robot approaches from the west.

Jones doesn't stand a chance against the mauve guard robot's terrible knives.
Thallium's voice booms over the office PA: "You can run, Jones, but you can't - well, there aren't very many places you can hide."

    *** Jones was killed by the mauve guard robot ***

In that game you scored 0 out of a possible 10, in 5 turns.

Would you like to RESTART, RESTORE a saved game, QUIT, or UNDO the last command?

* * *

>enter elevators
[entering the elevators]
foobar?
[entering the elevators - failed]

Suddenly two robot guards, green and red, emerge from niches in the back wall! Jones dives behind the front desk and draws her disruptor pistol.

Jones shouts, "I'm under fire from two ugly robot things!"

Beck responds, "Monitoring your suit radar."

>undo
Galaxy Jones is in the lobby.
[Previous turn undone.]

>ask beck about elevators
[quizzing Beck about the elevators]

foobar?
[quizzing Beck about the elevators - failed]

Suddenly two robot guards, green and red, emerge from niches in the back wall! Jones dives behind the front desk and draws her disruptor pistol.

Jones shouts, "I'm under fire from two ugly robot things!"

Beck responds, "Monitoring your suit radar."

>undo
Galaxy Jones is in the lobby.
[Previous turn undone.]

>n
[going north]
foobar.
[going north - failed]

Suddenly two robot guards, green and red, emerge from niches in the back wall! Jones dives behind the front desk and draws her disruptor pistol.

Jones shouts, "I'm under fire from two ugly robot things!"

Beck responds, "Monitoring your suit radar."

* * *

>showme
speeder dock - room
    building entryway - backdrop
    outside - backdrop
    Jones - person
        black jumpsuit (worn)
            suit light (part of black jumpsuit)
        disruptor pistol
    speeder
        tinted speeder windows (part of speeder)
        turbines (part of speeder)
        wings (part of speeder)
    parking bays

>x dock
Galaxy Jones is in the speeder dock. A safe harbor from the periodic dust storms of Utopia Planitia, the dock features several dozen speeder bays. Only a few are filled right now. The building entryway is to the north, under a red stone façade carved into the likeness of a fearsome Viking.

Jones's speeder, Galaxy One, sits in one of the parking bays.

>x entryway
The entryway is dominated by the towering façade of a Viking king, namesake of the building itself.

>x outside
(outside)
Outside the building are the red-dusted streets of New Reykjavik.

* * *

>x jumpsuit
It's an advanced Smart Suit, able to communicate sound, vision, and radar back to Beck at Galaxy Base. Also it has a neat light.

>x light
It automatically goes on when it gets dark. Cool.

>showme
speeder dock - room
    building entryway - backdrop
    outside - backdrop
    Jones - person
        black jumpsuit (worn)
            suit light (part of black jumpsuit)
        disruptor pistol
    speeder
        tinted speeder windows (part of speeder)
        turbines (part of speeder)
        wings (part of speeder)
    parking bays

>x pistol
A compact instrument of death, with only one setting: kill.

>x speeder
(the speeder)
Galaxy One is a Dust Runner, a top-of-the-line model from Olympus Speedworks. It's deep crimson with tinted windows. Powerful turbines adorn vestigial wings that sweep back in severe rearward arcs.

>x windows
(outside)
Outside the building are the red-dusted streets of New Reykjavik.

>x speeder window
There's nothing like that nearby.

>x speeder windows
The tint is too dark to see through.

>x turbines
The engines cause Jones to recoil from the waves of heat rolling off of them.

>x wings
Not technically necessary as the speeder works via anti-gravity, the blade-like wings nonetheless give the vehicle a certain flair unobtainable by other means.

>x bays
Most of the parking bays are unfilled.

>n
Jones approaches the Viking Building entryway, the dramatic façade towering over her.

Galaxy Jones is at the entry doorway. A glass revolving door leads into a large open space north of here. The speeder dock is to the south.

Jones looks up at the 100 stories of glass and steel. "What do you want to bet Thallium's got Europa all the way at the top?"

Beck: "Oh, no doubt."

>showme
entry doorway - room
    building entryway - backdrop
    Jones - person
        black jumpsuit (worn)
            suit light (part of black jumpsuit)
        disruptor pistol
    entry door
    open space

>x doorway
(the building entryway)
The entryway is dominated by the towering façade of a Viking king, namesake of the building itself.

>x entryway
The entryway is dominated by the towering façade of a Viking king, namesake of the building itself.

>x door
A glass revolving door emblazoned with the symbol of a Viking king astride the planet Mars.

>x space
There's nothing like that nearby.

>x symbol
There's nothing like that nearby.

>x space
There's nothing like that nearby.

>x open space
On the far side of the glass walls is a large open space serving as the extended lobby of the building.

>n
Jones takes a deep breath. "I'm going in."

Beck replies, "You got this, Galaxy."

Jones passes through the revolving door and into the lobby, alert to any defenses.

Galaxy Jones is in the lobby. The ground floor of the Viking Building is breathtaking. Low-G architecture means more glass and thinner supports, and the building takes advantage of that. Four walls of glass surround a central pillar in which are set the utility rooms and elevators. In between is an expanse of plants, water features, and stylish seating. Near the entryway is a front desk. A giant crystal sculpture floats above the center of the area, suspended on almost invisible cables. She may go east and west from here, north to the elevators, or south out of the building.

>x lobby
Suddenly two robot guards, green and red, emerge from niches in the back wall! Jones dives behind the front desk and draws her disruptor pistol.

Jones shouts, "I'm under fire from two ugly robot things!"

Beck responds, "Monitoring your suit radar."

>x lobby
Galaxy Jones is in the lobby. The ground floor of the Viking Building is breathtaking. Low-G architecture means more glass and thinner supports, and the building takes advantage of that. Four walls of glass surround a central pillar in which are set the utility rooms and elevators. In between is an expanse of plants, water features, and stylish seating. Near the entryway is a front desk. A giant crystal sculpture floats above the center of the area, suspended on almost invisible cables. Jones may go east and west from here, north to the elevators, or south out of the building. There are two niches in the central wall from which the guard robots emerged.

Two guard robots, red and green, criss-cross the lobby, stalking her.

Jones: "I could use some ideas here!"

>showme
lobby - room
    red and green guard robots - guard robot
    central pillar - backdrop
    utility rooms - backdrop
    elevators - backdrop
    pyramids - backdrop
    supports - backdrop
    chandeliers - backdrop
    ceiling - backdrop
    floor - backdrop
    building entryway - backdrop
    outside - backdrop
    Jones - person
        black jumpsuit (worn)
            suit light (part of black jumpsuit)
        disruptor pistol
    lobby
    niches
    charging stations
    front desk - pseudocontainer
        *sticky note
    giant sculpture
    tasteful couch - couch
    elevators
* denotes things which are not in scope

>x robot
Definitely not a friendly android. More of a spiny killer with a disruptor barrel mounted on its head.

Beck: "How's it going in there?"

"Jones: "You know -- like all art, it's hit or miss."

>x pillar
The central area where the elevators and utility rooms are.

>x utility
The utility rooms are somewhere around the central pillar.

Zip! Disruptor fire scorches a nearby couch.

>x elevators
They're in the center of the building.

A robot fires a blistering shot into the front desk.

>x elevator
They're in the center of the building.

The robots intone "Destroy Jones" in an eerie drone.

>showme
lobby - room
    red and green guard robots - guard robot
    central pillar - backdrop
    utility rooms - backdrop
    elevators - backdrop
    pyramids - backdrop
    supports - backdrop
    chandeliers - backdrop
    ceiling - backdrop
    floor - backdrop
    building entryway - backdrop
    outside - backdrop
    Jones - person
        black jumpsuit (worn)
            suit light (part of black jumpsuit)
        disruptor pistol
    lobby
    niches
    charging stations
    front desk - pseudocontainer
        *sticky note
    giant sculpture
    tasteful couch - couch
    elevators
* denotes things which are not in scope

>x pyramids
Angled reflective surfaces on the ceiling meant to disperse light.

Beck: "Robot on your right!"

One robot tries to flank Jones, but a shot from her disruptor sends it scurrying back.

>x supports
Thin but incredibly strong.

One robot tries to flank Jones, but a shot from her disruptor sends it scurrying back.

>s chandeliers
I only understood you as far as wanting to (go) s.

>x chandeliers
A baroque conglomeration of gold, silver, and crystal.

One of the robots fires directly above Jones's head.

>x ceiling
The whole ground floor is bright and airy, its ceiling covered with reflective pyramids. Supporting struts criss-cross the area, from which sparkling crystal chandeliers are suspended.

Zip! Disruptor fire scorches a nearby couch.

>x floor
Yards and yards of white and grey marble, rare for Mars.

Zip! Disruptor fire scorches a nearby couch.

>xentryway
I didn't understand that sentence.

>x entryway
The entryway (exit actually) leads out to the speeder dock.

The two robots coordinate fire over the desk, narrowly missing Jones.

>showme
lobby - room
    red and green guard robots - guard robot
    central pillar - backdrop
    utility rooms - backdrop
    elevators - backdrop
    pyramids - backdrop
    supports - backdrop
    chandeliers - backdrop
    ceiling - backdrop
    floor - backdrop
    building entryway - backdrop
    outside - backdrop
    Jones - person
        black jumpsuit (worn)
            suit light (part of black jumpsuit)
        disruptor pistol
    lobby
    niches
    charging stations
    front desk - pseudocontainer
        *sticky note
    giant sculpture
    tasteful couch - couch
    elevators
* denotes things which are not in scope

>x outside
(outside)
Outside the building are the red-dusted streets of New Reykjavik.

A robot fires a blistering shot into the front desk.

>x niches
Aside from a robot charging station, there's nothing here.

One robot tries to flank Jones, but a shot from her disruptor sends it scurrying back.

>x stations
The charging station is a socket fitted in a depression contoured to fit one of those robots.

The robots intone "Destroy Jones" in an eerie drone.

>x front desk
There's not much on the desk other than a sticky note that says "0".

>x note
The note says "0".

>take it
As soon as Jones starts to act, an energy beam zips past her head, forcing her back down behind the desk.

One of the robots fires directly above her head.

>x sculpture
It's a huge crystal abstraction, provocative in its arrogance but evocative of nothing. A typical public installation by the artist Rambutan. It's held up by metal cables.

One robot tries to flank Jones, but a shot from her disruptor sends it scurrying back.

>x cables
It's a huge crystal abstraction, provocative in its arrogance but evocative of nothing. A typical public installation by the artist Rambutan. It's held up by metal cables.

The robots intone "Destroy Jones" in an eerie drone.

>x couch
Quite tasteful for a homicidal madman, really.

>showme
lobby - room
    red and green guard robots - guard robot
    central pillar - backdrop
    utility rooms - backdrop
    elevators - backdrop
    pyramids - backdrop
    supports - backdrop
    chandeliers - backdrop
    ceiling - backdrop
    floor - backdrop
    building entryway - backdrop
    outside - backdrop
    Jones - person
        black jumpsuit (worn)
            suit light (part of black jumpsuit)
        disruptor pistol
    lobby
    niches
    charging stations
    front desk - pseudocontainer
        sticky note
    giant sculpture
    tasteful couch - couch
    elevators

>shoot art
Jones fires the disruptor into the sculpture's main support cable, snapping it. The huge crystal blob starts to sag, straining the other cables. In quick succession they break as well, and the whole installation plummets to the ground, right on top of the hapless guard robots.
 _________      __                     _____                     
 __/ ____/___ _/ /___ __  ____  __     __/ /___  ____  ___  _____
 _/ / __/ __ `/ / __ `/ |/ / / / /____ _/ / __ \/ __ \/ _ \/ ___/
 / /_/ / /_/ / / /_/ />  </ /_/ / _/ /_/ / /_/ / / / /  __(__  ) 
 \____/\__,_/_/\__,_/_/|_|\__, /  _\____/\____/_/ /_/\___/____/  
 _____________________________/ 

[Your score has just gone up by one point.]

Beck: "What was that crash? What's going on?"

Jones: "That, my friend, was what you'd call a work of art. Targets terminated."

* * *

>w
Jones crosses the floor carefully, disruptor pistol at the ready.

Galaxy Jones is at the southwest corner of the ground floor. A lush indoor waterfall here contrasts with the dusty red streets of New Reykjavik beyond the glass walls. The ground floor extends north and east.

Admiral Thallium's voice booms from the ceiling. "Little Galaxy thinks she's beaten the big bad Admiral. Sorry dear, that was only a taste."

>touch art
There's nothing like that nearby.

>x art
There's nothing like that nearby.

>e
Galaxy Jones is in the lobby. The ground floor of the Viking Building is breathtaking. Low-G architecture means more glass and thinner supports, and the building takes advantage of that. Four walls of glass surround a central pillar in which are set the utility rooms and elevators. In between is an expanse of plants, water features, and stylish seating. Near the entryway is a front desk. Jones may go east and west from here, north to the elevators, or south out of the building. There are two niches in the central wall from which the guard robots emerged.

Spread across the floor in a tangled ruin are the remains of a giant crystal sculpture and two guard robots.

>touch art
Jones feels nothing unexpected.

>smell art
I didn't understand that sentence.

>throw art
The tangled ruin is already here.

>take it
Jones might find something useful in the mixture of sculpture and robots, but the thing as a whole is a huge mess.

>drop it
The tangled ruin is already here.

* * *

>take speeder
(the speeder)
Stop being silly.

>drop dust
Jones hasn't got that.

>n
Jones approaches the Viking Building entryway, the dramatic façade towering over her.

Galaxy Jones is at the entry doorway. A glass revolving door leads into a large open space north of here. The speeder dock is to the south.

Jones looks up at the 100 stories of glass and steel. "What do you want to bet Thallium's got Europa all the way at the top?"

Beck: "Oh, no doubt."

* * *

>w
Jones crosses the floor carefully, disruptor pistol at the ready.

Galaxy Jones is at the southwest corner of the ground floor. A lush indoor waterfall here contrasts with the dusty red streets of New Reykjavik beyond the glass walls. The ground floor extends north and east.

Admiral Thallium's voice booms from the ceiling. "Little Galaxy thinks she's beaten the big bad Admiral. Sorry dear, that was only a taste."

>undo
Galaxy Jones is in the lobby.
[Previous turn undone.]

>undo
Galaxy Jones is at the entry doorway.
[Previous turn undone.]

>n
Jones takes a deep breath. "I'm going in."

Beck replies, "You got this, Galaxy."

Jones passes through the revolving door and into the lobby, alert to any defenses.

Galaxy Jones is in the lobby. The ground floor of the Viking Building is breathtaking. Low-G architecture means more glass and thinner supports, and the building takes advantage of that. Four walls of glass surround a central pillar in which are set the utility rooms and elevators. In between is an expanse of plants, water features, and stylish seating. Near the entryway is a front desk. A giant crystal sculpture floats above the center of the area, suspended on almost invisible cables. She may go east and west from here, north to the elevators, or south out of the building.

* * *

>undo
Galaxy Jones is in the lobby.
[Previous turn undone.]

>n
Suddenly two robot guards, green and red, emerge from niches in the back wall! Jones dives behind the front desk and draws her disruptor pistol.

Jones shouts, "I'm under fire from two ugly robot things!"

Beck responds, "Monitoring your suit radar."

>undo
Galaxy Jones is in the lobby.
[Previous turn undone.]

>climb
What should Jones climb?

>roof
There's nothing like that nearby.

>undo
Galaxy Jones is in the lobby.
[Previous turn undone.]

>n
You must name something more substantial.

Suddenly two robot guards, green and red, emerge from niches in the back wall! She dives behind the front desk and draws her disruptor pistol.

Jones shouts, "I'm under fire from two ugly robot things!"

Beck responds, "Monitoring your suit radar."

>undo
Galaxy Jones is in the lobby.
[Previous turn undone.]

>showme
lobby - room
    central pillar - backdrop
    utility rooms - backdrop
    elevators - backdrop
    pyramids - backdrop
    supports - backdrop
    chandeliers - backdrop
    ceiling - backdrop
    floor - backdrop
    building entryway - backdrop
    outside - backdrop
    Jones - person
        black jumpsuit (worn)
            suit light (part of black jumpsuit)
        disruptor pistol
    lobby
    niches
    charging stations
    front desk - pseudocontainer
        *sticky note
    giant sculpture
    tasteful couch - couch
    elevators
* denotes things which are not in scope

>x desk
Suddenly two robot guards, green and red, emerge from niches in the back wall! Jones dives behind the front desk and draws her disruptor pistol.

Jones shouts, "I'm under fire from two ugly robot things!"

Beck responds, "Monitoring your suit radar."

>undo
Galaxy Jones is in the lobby.
[Previous turn undone.]

>jump
Suddenly two robot guards, green and red, emerge from niches in the back wall! Jones dives behind the front desk and draws her disruptor pistol.

Jones shouts, "I'm under fire from two ugly robot things!"

Beck responds, "Monitoring your suit radar."

>undo
Galaxy Jones is in the lobby.
[Previous turn undone.]

>s
Suddenly two robot guards, green and red, emerge from niches in the back wall! Jones dives behind the front desk and draws her disruptor pistol.

Jones shouts, "I'm under fire from two ugly robot things!"

Beck responds, "Monitoring your suit radar."

>undo
Galaxy Jones is in the lobby.
[Previous turn undone.]

I beg your pardon?

>undo
Galaxy Jones is at the entry doorway.
[Previous turn undone.]

* * *

>w
Suddenly two robot guards, green and red, emerge from niches in the back wall! Jones dives behind the front desk and draws her disruptor pistol.

Jones shouts, "I'm under fire from two ugly robot things!"

Beck responds, "Monitoring your suit radar."

>n
Trying to reach an exit would surely get Jones shot.

Jones: "I'm pinned down here!"

Zip! Disruptor fire scorches a nearby couch.

>w
Trying to reach an exit would surely get Jones shot.

The two robots coordinate fire over the desk, narrowly missing her.

Jones: "I could use some ideas here!"

>shoot art
Jones fires the disruptor into the sculpture's main support cable, snapping it. The huge crystal blob starts to sag, straining the other cables. In quick succession they break as well, and the whole installation plummets to the ground, right on top of the hapless guard robots.
 _________      __                     _____                     
 __/ ____/___ _/ /___ __  ____  __     __/ /___  ____  ___  _____
 _/ / __/ __ `/ / __ `/ |/ / / / /____ _/ / __ \/ __ \/ _ \/ ___/
 / /_/ / /_/ / / /_/ />  </ /_/ / _/ /_/ / /_/ / / / /  __(__  ) 
 \____/\__,_/_/\__,_/_/|_|\__, /  _\____/\____/_/ /_/\___/____/  
 _____________________________/ 

[Your score has just gone up by one point.]

Beck: "What was that crash? What's going on?"

Jones: "That, my friend, was what you'd call a work of art. Targets terminated."

* * *

>n
Galaxy Jones is in the ground floor elevator hall. This hallway between the north and south ends of the ground floor is home to the elevator to the west. To the east is the entrance to a stairwell.

Admiral Thallium's voice booms from the ceiling. "Little Galaxy thinks she's beaten the big bad Admiral. Sorry dear, that was only a taste."

>restart
Are you sure you want to restart?

* * *

>exit
Suddenly two robot guards, green and red, emerge from niches in the back wall! Jones dives behind the front desk and draws her disruptor pistol.

Jones shouts, "I'm under fire from two ugly robot things!"

Beck responds, "Monitoring your suit radar."

>undo
Galaxy Jones is in the lobby.
[Previous turn undone.]

>enter elevator
As soon as Jones starts to act, an energy beam zips past her head, forcing her back down behind the desk.

Suddenly two robot guards, green and red, emerge from niches in the back wall! She dives behind the front desk and draws her disruptor pistol.

Jones shouts, "I'm under fire from two ugly robot things!"

Beck responds, "Monitoring your suit radar."

>undo
Galaxy Jones is in the lobby.
[Previous turn undone.]

* * *

>enter elevator
As soon as Jones starts to act, an energy beam zips past her head, forcing her back down behind the desk.

Suddenly two robot guards, green and red, emerge from niches in the back wall! She dives behind the front desk and draws her disruptor pistol.

Jones shouts, "I'm under fire from two ugly robot things!"

Beck responds, "Monitoring your suit radar."

* * *

>actions
Actions listing on.

>enter elevator
[entering the elevators]
As soon as Jones starts to act, an energy beam zips past her head, forcing her back down behind the desk.
[entering the elevators - failed]

Suddenly two robot guards, green and red, emerge from niches in the back wall! She dives behind the front desk and draws her disruptor pistol.

Jones shouts, "I'm under fire from two ugly robot things!"

Beck responds, "Monitoring your suit radar."

>restart
[restarting the game]
Are you sure you want to restart?

* * *

>scenes
Scene 'Entire Game' playing (for 0 mins now)
(Scene monitoring now switched on. Type "scenes off" to switch it off again.)

>n
Jones approaches the Viking Building entryway, the dramatic façade towering over her.

Galaxy Jones is at the entry doorway. A glass revolving door leads into a large open space north of here. The speeder dock is to the south.

Jones looks up at the 100 stories of glass and steel. "What do you want to bet Thallium's got Europa all the way at the top?"

Beck: "Oh, no doubt."

>n
Jones takes a deep breath. "I'm going in."

Beck replies, "You got this, Galaxy."

Jones passes through the revolving door and into the lobby, alert to any defenses.

Galaxy Jones is in the lobby. The ground floor of the Viking Building is breathtaking. Low-G architecture means more glass and thinner supports, and the building takes advantage of that. Four walls of glass surround a central pillar in which are set the utility rooms and elevators. In between is an expanse of plants, water features, and stylish seating. Near the entryway is a front desk. A giant crystal sculpture floats above the center of the area, suspended on almost invisible cables. She may go east and west from here, north to the elevators, or south out of the building.

[Scene 'Lobby Shootout' begins]

>enter elevators
As soon as Jones starts to act, an energy beam zips past her head, forcing her back down behind the desk.

Suddenly two robot guards, green and red, emerge from niches in the back wall! She dives behind the front desk and draws her disruptor pistol.

Jones shouts, "I'm under fire from two ugly robot things!"

Beck responds, "Monitoring your suit radar."

>undo
Galaxy Jones is in the lobby.
[Previous turn undone.]

* * *

>undo
Galaxy Jones is at the entry doorway.
[Previous turn undone.]

>actions
Actions listing on.

>n
[going north]
Jones takes a deep breath. "I'm going in."

Beck replies, "You got this, Galaxy."

Jones passes through the revolving door and into the lobby, alert to any defenses.

Galaxy Jones is in the lobby. The ground floor of the Viking Building is breathtaking. Low-G architecture means more glass and thinner supports, and the building takes advantage of that. Four walls of glass surround a central pillar in which are set the utility rooms and elevators. In between is an expanse of plants, water features, and stylish seating. Near the entryway is a front desk. A giant crystal sculpture floats above the center of the area, suspended on almost invisible cables. She may go east and west from here, north to the elevators, or south out of the building.

[going north - succeeded]

[Scene 'Lobby Shootout' begins]

>enter elevators
[entering the elevators]
As soon as Jones starts to act, an energy beam zips past her head, forcing her back down behind the desk.
[entering the elevators - failed]

Suddenly two robot guards, green and red, emerge from niches in the back wall! She dives behind the front desk and draws her disruptor pistol.

Jones shouts, "I'm under fire from two ugly robot things!"

Beck responds, "Monitoring your suit radar."

>undo
Galaxy Jones is in the lobby.
[Previous turn undone.]

>go north
[going north]
[going north - failed]

Suddenly two robot guards, green and red, emerge from niches in the back wall! Jones dives behind the front desk and draws her disruptor pistol.

Jones shouts, "I'm under fire from two ugly robot things!"

Beck responds, "Monitoring your suit radar."

>und
I didn't understand that sentence.

>undo
Galaxy Jones is in the lobby.
[Previous turn undone.]