>sneak
(toward the purple guard robot)
Jones creeps a little ways toward the guard robot.

>sneak
(toward the purple guard robot)
Slowly, slowly, Jones gets a little closer. Just a little more...

She must have poked up her shoulder or something, for the guard robot fires his disruptor. The shot takes out a window on the east side of the room. The electrostatic field around the building keeps the atmosphere from pouring out.

>sneak
(toward the purple guard robot)
Jones is right up next to the robot, crouched beneath a desk. She can see right up under its armor.

>x robot
Jones can see up under the robot's armor. A shot here might be effective.

* * *

>gonear ledge
Galaxy Jones is on a ledge. The ledge runs north and south. Jones is plastered up against the wall to the west, trying not to look down. Four thick, tense wires run vertically from above to below her. One of them is within reach.

>look down
Are you sure? Jones is really afraid of heights.

>d
Go down? Jones doesn't even want to look down.

>i
Jones is carrying:
  a black jumpsuit (being worn)
  a disruptor pistol

>purloin coin
[Purloined.]

>drop it
It would probably just fall off the ledge.

>gonear cage
Galaxy Jones is next to the cage. The closely-set silnium bars seem to dash all hope of a rescue. The flyer pad is to the southwest and the rest of the rooftop to the south.

Europa Callisto is lying at the center of the cage, out of Jones's reach.

Jones tries the strength of the bars just in case. They don't budge.

South of the cage, Thallium crosses the roof to the flyer pad, where he boards the waiting flyer. The flyer lifts off and moves towards Jones.

>open cage
There is no discernable door.

Thallium's flyer hovers over the rooftop. "Jones!"  he bellows. "Play time is over. I grow weary of your intransigence. In a moment this roof will be swarmed by guard robots -- of many different colors -- so many robots you couldn't possibly vandalize them all.  Say your prayers, Jones, or whatever you do when you're about to die."

Jones rolls her eyes.

A little ways off, another flyer, small and red, aims for the rooftop and accelerates.

>attach hook to red flyer
There's nothing like that nearby.

>attach hook to green flyer
There's nothing like that nearby.

>hook green flyer
What should Jones hook the green flyer to?

>cable
There's nothing like that nearby.

>purloin cable
(the cable with hooks at either end)
[Purloined.]

>attach hook to red flyer
Jones is not close enough to do that.

>attach hook to green flyer
Jones is not close enough to do that.

>get on cage
Jones gets onto the cage.

>attach cable to cage
Jones throws the cable up to the flyer where it hooks around the rail, and attaches the other end to the cage, then jumps off the cage to escape the aftermath. Seeing his flyer's predicament, Thallium jumps out of the craft and disappears below the edge of the roof. The flyer reaches the end of its tether and slingshots downwards, slamming into side of the building.
 _________      __                     _____                     
 __/ ____/___ _/ /___ __  ____  __     __/ /___  ____  ___  _____
 _/ / __/ __ `/ / __ `/ |/ / / / /____ _/ / __ \/ __ \/ _ \/ ___/
 / /_/ / /_/ / / /_/ />  </ /_/ / _/ /_/ / /_/ / / / /  __(__  ) 
 \____/\__,_/_/\__,_/_/|_|\__, /  _\____/\____/_/ /_/\___/____/  
 _____________________________/ 

[Your score has just gone up by one point.]

The cage has tilted to the side, one attachment torn loose from the rooftop. Jones crawls into the cage to see to Europa Callisto.

"Europa! Can you hear me? I need you to move to get out of this cage. I can't carry you through that small opening. Europa!"

Europa moans but doesn't show any signs of having understood Jones.

Galaxy Jones is in the cage. The whole structure is tilted, leaving a hole at the eastern end. The flyer pad is to the southwest and the rest of the rooftop to the south.

Jones is kneeling at Europa Callisto's side, trying to rouse her.

The red flyer, now recognizable as Galaxy's own, settles down onto the landing pad.

>undo
Galaxy Jones is standing on the cage. 
[Previous turn undone.]

>throw cable at green flyer
Jones throws the cable up to the flyer where it hooks around the rail, and attaches the other end to the cage, then jumps off the cage to escape the aftermath. Seeing his flyer's predicament, Thallium jumps out of the craft and disappears below the edge of the roof. The flyer reaches the end of its tether and slingshots downwards, slamming into side of the building.
 _________      __                     _____                     
 __/ ____/___ _/ /___ __  ____  __     __/ /___  ____  ___  _____
 _/ / __/ __ `/ / __ `/ |/ / / / /____ _/ / __ \/ __ \/ _ \/ ___/
 / /_/ / /_/ / / /_/ />  </ /_/ / _/ /_/ / /_/ / / / /  __(__  ) 
 \____/\__,_/_/\__,_/_/|_|\__, /  _\____/\____/_/ /_/\___/____/  
 _____________________________/ 

[Your score has just gone up by one point.]

The cage has tilted to the side, one attachment torn loose from the rooftop. Jones crawls into the cage to see to Europa Callisto.

"Europa! Can you hear me? I need you to move to get out of this cage. I can't carry you through that small opening. Europa!"

Europa moans but doesn't show any signs of having understood Jones.

Galaxy Jones is in the cage. The whole structure is tilted, leaving a hole at the eastern end. The flyer pad is to the southwest and the rest of the rooftop to the south.

Jones is kneeling at Europa Callisto's side, trying to rouse her.

The red flyer, now recognizable as Galaxy's own, settles down onto the landing pad.

* * *

>n
Suddenly two robot guards, green and red, emerge from niches in the back wall! Jones dives behind the front desk and draws her disruptor pistol.

Jones shouts, "I'm under fire from two ugly robot things!"

Beck responds, "Monitoring your suit radar."

>shoot armor
Oops! Jones misses.

Beck: "How's it going in there?"

"Jones: "You know -- like all art, it's hit or miss."

>undo
Galaxy Jones is in the lobby.
[Previous turn undone.]

>rules
Rules tracing now switched on. Type "rules off" to switch it off again, or "rules all" to include even rules which do not apply.

[Rule "reset conversed this turn rule" applies.]
[Rule "clear LPR rule" applies.]

>shoot armor
[Rule "After deciding the scope of the player" applies.]
[Rule "After deciding the scope of the player" applies.]
[Rule "After deciding the scope of the player" applies.]
[Rule "declare everything initially unmentioned rule" applies.]
[Rule "Rule for supplying a missing second noun while shooting" applies.]
[Rule "After deciding the scope of the player" applies.]
[Rule "After deciding the scope of the player" applies.]
[Rule "After deciding the scope of the player" applies.]
[Rule "assign alternative door targets rule" applies.]
[Rule "announce items from multiple object lists rule" applies.]
[Rule "set pronouns from items from multiple object lists rule" applies.]
[Rule "before stage rule" applies.]
[Rule "Before doing something other than going" applies.]
[Rule "keychain-aware carrying requirements rule" applies.]
[Rule "instead stage rule" applies.]
[Rule "Instead of shooting armor with the disruptor pistol when the noun is incorporated by a guard robot" applies.]
[Rule "assign alternative door targets rule" applies.]
[Rule "announce items from multiple object lists rule" applies.]
[Rule "set pronouns from items from multiple object lists rule" applies.]
[Rule "before stage rule" applies.]
[Rule "Before doing something other than going" applies.]
[Rule "keychain-aware carrying requirements rule" applies.]
[Rule "instead stage rule" applies.]
[Rule "investigate player's awareness before action rule" applies.]
[Rule "player aware of his own actions rule" applies.]
[Rule "check stage rule" applies.]
[Rule "Check shooting something with the disruptor pistol" applies.]
[Rule "carry out stage rule" applies.]
[Rule "after stage rule" applies.]
[Rule "investigate player's awareness after action rule" applies.]
[Rule "report stage rule" applies.]
[Rule "Report shooting a guard robot with the disruptor pistol during Lobby Shootout" applies.]
Oof. Big miss.

[Rule "last specific action-processing rule" applies.]
[Rule "A first turn sequence rule" applies.]
[Rule "every turn stage rule" applies.]
[Rule "Every turn when attack begun is true during lobby shootout" applies.]
Jones: "I could use some ideas here!"

[Rule "Every turn when the mauve guard robot is in the tenth-floor-region and the mauve guard robot is not under attack" applies.]
[Rule "reset protocol rule" applies.]
[Rule "Every turn" applies.]
[Rule "A last turn sequence rule" applies.]
[Rule "notify score changes rule" applies.]
[Rule "show us the people rule" applies.]
[Rule "reset conversed this turn rule" applies.]
[Rule "clear LPR rule" applies.]

>shoot art
[Rule "After deciding the scope of the player" applies.]
[Rule "After deciding the scope of the player" applies.]
[Rule "After deciding the scope of the player" applies.]
[Rule "declare everything initially unmentioned rule" applies.]
[Rule "Rule for supplying a missing second noun while shooting" applies.]
[Rule "After deciding the scope of the player" applies.]
[Rule "After deciding the scope of the player" applies.]
[Rule "After deciding the scope of the player" applies.]
[Rule "assign alternative door targets rule" applies.]
[Rule "announce items from multiple object lists rule" applies.]
[Rule "set pronouns from items from multiple object lists rule" applies.]
[Rule "before stage rule" applies.]
[Rule "Before doing something other than going" applies.]
[Rule "keychain-aware carrying requirements rule" applies.]
[Rule "instead stage rule" applies.]
[Rule "investigate player's awareness before action rule" applies.]
[Rule "player aware of his own actions rule" applies.]
[Rule "check stage rule" applies.]
[Rule "Check shooting something with the disruptor pistol" applies.]
[Rule "carry out stage rule" applies.]
[Rule "Carry out shooting the giant sculpture with the disruptor pistol" applies.]
Jones fires the disruptor into the sculpture's main support cable, snapping it. The huge crystal blob starts to sag, straining the other cables. In quick succession they break as well, and the whole installation plummets to the ground, right on top of the hapless guard robots.
 _________      __                     _____                     
 __/ ____/___ _/ /___ __  ____  __     __/ /___  ____  ___  _____
 _/ / __/ __ `/ / __ `/ |/ / / / /____ _/ / __ \/ __ \/ _ \/ ___/
 / /_/ / /_/ / / /_/ />  </ /_/ / _/ /_/ / /_/ / / / /  __(__  ) 
 \____/\__,_/_/\__,_/_/|_|\__, /  _\____/\____/_/ /_/\___/____/  
 _____________________________/ 

[Rule "notify score changes rule" applies.]
[Your score has just gone up by one point.]

Beck: "What was that crash? What's going on?"

Jones: "That, my friend, was what you'd call a work of art. Targets terminated."
[Rule "after stage rule" applies.]

[Rule "investigate player's awareness after action rule" applies.]
[Rule "report stage rule" applies.]
[Rule "last specific action-processing rule" applies.]
[Rule "A first turn sequence rule" applies.]
[Rule "scene description text rule" applies.]
[Rule "every turn stage rule" applies.]
[Rule "Every turn when the mauve guard robot is in the tenth-floor-region and the mauve guard robot is not under attack" applies.]
[Rule "reset protocol rule" applies.]
[Rule "Every turn" applies.]
[Rule "A last turn sequence rule" applies.]
[Rule "notify score changes rule" applies.]
[Rule "show us the people rule" applies.]
[Rule "reset conversed this turn rule" applies.]
[Rule "clear LPR rule" applies.]

>rules off
[Rule "declare everything initially unmentioned rule" applies.]
[Rule "assign alternative door targets rule" applies.]
Rules tracing now switched off. Type "rules" to switch it on again.

>gonear air
(the air handling room)
Galaxy Jones is in the air handling room. There is a good number of loud fans and other air handling machinery here. A small hinged vent opening leads into some ductwork, and from there to the outside. A door leads west.

* * *

>s
Galaxy Jones is at the southeast corner of the Consolidated Microthings office. This corner of the floor contains the gym and other company amenities. Reception is to the west, and an empty area lies to the north.

Jones sees the mauve guard robot a couple of steps to the west.

>shoot armor
The beam strikes a window and reflects at a crazy angle around the room.

A couple of steps to the west, the mauve guard robot heads east.

>gonear cybernetica
(the Cybernetica office)
Galaxy Jones is in the Cybernetica office. It's spacious and luxurious, designed to make developers forget how spent they are from months of overwork and abuse. Ergonomic desks and chairs fill space like a furniture fractal, before giving way to an open area, presumably for group activities.

As soon as Jones steps into the office, a shot zaps just past her nose. She dives to the ground, protected by the maze of desks and chairs. Peeking through the mesh back of one of the chairs, she takes notice of both the purple guard robot training its disruptor on the room, and the chair's fine construction and lumbar support.

Jones (whispering): "We've got another one! I'm out of sight for now, but it's going to be hard to get a shot off at this 'bot."

Beck: "What's the situation?"

Jones: "I'm on the floor with desks and chairs all around. The target is a few yards off, coming this way. I can get a shot in, but it might just absorb it anyway."

Beck: "Well, see if you can sneak up on it. Maybe close up you can find a way past its defenses."

>shoot armor
Jones raises her head and fires wide. The robot fires back. Jones ducks and crawls off among the labyrinth of desks.

Beck: "Are you still shooting at those things? Even if you hit 'em it's not going to leave a scratch."

Jones (whispering): "So what do you propose?"

Beck: "Get closer. Keep your head down, but move in closer to it until you can get a good shot in."

>gonear cybernetica
(the Cybernetica office)
Galaxy Jones is in the Cybernetica office. It's spacious and luxurious, designed to make developers forget how spent they are from months of overwork and abuse. Ergonomic desks and chairs fill space like a furniture fractal, before giving way to an open area, presumably for group activities. There is a menacing purple guard robot here, looking for Jones.

>sneak
(toward the purple guard robot)
Jones creeps a little ways toward the guard robot.

* * *

>e
The atmosphere is too thin out there. Jones needs protective gear.

* * *

>purloin atmo
[Purloined.]

>e
Jones: "I'm going out the window to see if I can find a way to get up to the tenth floor."

Beck: "Whoa whoa whoa, Jones. You know you're not good with heights."

Jones: "Ask Thallium how how much that matters once I've kicked his ass. Watch me, I'll look down and not even flinch."

Jones puts on the Atmo-Suit.

Galaxy Jones is on a ledge. The ledge runs north and south. Jones is plastered up against the wall, trying not to look down.

* * *

>purloin atmo
[Purloined.]

>remove jumpsuit
Jones needs the jumpsuit to complete her mission.

>e
Jones: "I'm going out the window to see if I can find a way to get up to the tenth floor."

Beck: "Whoa whoa whoa, Jones. You know you're not good with heights."

Jones: "Ask Thallium how how much that matters once I've kicked his ass. Watch me, I'll look down and not even flinch."

Jones puts on the Atmo-Suit.

Galaxy Jones is on a ledge. The ledge runs north and south. Jones is plastered up against the wall, trying not to look down.

>x window
The window here is broken, allowing Jones to reenter the building.

>in
Galaxy Jones is in the Cybernetica office. It's spacious and luxurious, designed to make developers forget how spent they are from months of overwork and abuse. Ergonomic desks and chairs fill space like a furniture fractal, before giving way to an open area, presumably for group activities. One of the windows along the east side of the office is broken.

The remains of the purple guard robot are sprawled on the ground.

Jones takes off the Atmo-Suit.

>x window
(broken window)
Looks like Jones could get through if she's careful. There's a ledge outside.

>e
Jones puts on the Atmo-Suit.

Galaxy Jones is on a ledge. The ledge runs north and south. Jones is plastered up against the wall, trying not to look down.

>d
Go down? Jones doesn't even want to look down.

>x cable
There's nothing like that nearby.

>i
Jones is carrying:
  an Atmo-Suit (being worn)
  a black jumpsuit (being worn)
  a disruptor pistol

>scopr
I didn't understand that sentence.

>scope
1: Jones (1161725)
2: windows (1168733)
3: a wall (1168605)
4: the city (1167325)
5: an Atmo-Suit (1163357)
6: a black jumpsuit (1161757)
7: a suit light (1161277)
8: a disruptor pistol (1161789)
9: Beck (1161213)

>n
The wall juts out and blocks Jones's progress.

* * *

>s
The wall juts out and blocks Jones's progress.

>d
Go down? Jones doesn't even want to look down.

>look up
There's nothing in that direction.

>look out
(the city)
From this perilous location, outside the comforting electrostatic field trapping the atmosphere of the building, one can see with striking clarity the lights of the city. The surrounding plains go on forever.

>gonear cage
Galaxy Jones is next to the cage. The closely-set silnium bars seem to dash all hope of a rescue. The flyer pad is to the southwest and the rest of the rooftop to the south.

Europa Callisto is lying at the center of the cage, out of Jones's reach.

Jones tries the strength of the bars just in case. They don't budge.

South of the cage, Thallium crosses the roof to the flyer pad, where he boards the waiting flyer. The flyer lifts off and moves towards Jones.

* * *

>open cage
There is no discernable door.

Thallium's flyer hovers over the rooftop. "Jones!"  he bellows. "Play time is over. I grow weary of your intransigence. In a moment this roof will be swarmed by guard robots -- of many different colors -- so many robots you couldn't possibly vandalize them all.  Say your prayers, Jones, or whatever you do when you're about to die."

Jones rolls her eyes.

A little ways off, another flyer, small and red, aims for the rooftop and accelerates.

>scope
1: a red flyer (1169789)
2: a green flyer (1169853)
3: an electrostatic field (1169821)
4: outside (1167389)
5: Jones (1161725)
6: Europa Callisto (1167165)
7: a cage (1167197)
8: a cage-container (1167229)
9: an Atmo-Suit (1163357)
10: a black jumpsuit (1161757)
11: a suit light (1161277)
12: a disruptor pistol (1161789)
13: Beck (1161213)

>look down
There's nothing in that direction.

* * *

>gonear
What should Jones gonear?

>cybernetica
(the Cybernetica office)
Galaxy Jones is in the Cybernetica office. It's spacious and luxurious, designed to make developers forget how spent they are from months of overwork and abuse. Ergonomic desks and chairs fill space like a furniture fractal, before giving way to an open area, presumably for group activities.

As soon as she steps into the office, a shot zaps just past her nose. She dives to the ground, protected by the maze of desks and chairs. Peeking through the mesh back of one of the chairs, she takes notice of both the purple guard robot training its disruptor on the room, and the chair's fine construction and lumbar support.

Jones (whispering): "We've got another one! I'm out of sight for now, but it's going to be hard to get a shot off at this 'bot."

Beck: "What's the situation?"

Jones: "I'm on the floor with desks and chairs all around. The target is a few yards off, coming this way. I can get a shot in, but it might just absorb it anyway."

Beck: "Well, see if you can sneak up on it. Maybe close up you can find a way past its defenses."

>x armor
A formidable, nigh-impenetrable barrier.

>sneak
(toward the purple guard robot)
Jones creeps a little ways toward the guard robot.

* * *

>sneak
(toward the purple guard robot)
Jones is right up next to the robot, crouched beneath a desk. She can see right up under its armor.

>x armor
Jones can see up under the robot's armor. A shot here might be effective.

>shoot armor
Jones aims the pistol upward under the robot's enhanced armor and fires. She flinches back when the robot's innards explode downward in a shower of sparks. It topples over, dead. Jones stands up and surveys her handiwork.

 _________      __                     _____                     
 __/ ____/___ _/ /___ __  ____  __     __/ /___  ____  ___  _____
 _/ / __/ __ `/ / __ `/ |/ / / / /____ _/ / __ \/ __ \/ _ \/ ___/
 / /_/ / /_/ / / /_/ />  </ /_/ / _/ /_/ / /_/ / / / /  __(__  ) 
 \____/\__,_/_/\__,_/_/|_|\__, /  _\____/\____/_/ /_/\___/____/  
 _____________________________/ 

[Your score has just gone up by one point.]

Jones: "Better than a video game. "

Beck: "Nice, but don't forget to credit your handler."

Jones: "Yes, yes, thanks for helping me not get killed."

Beck: "You're welcome."

>shoot under armor
There's nothing like that nearby.

>undo
Galaxy Jones is in the Cybernetica office.
[Previous turn undone.]

>z
Jones stands around and waits.

>shoot robot
Jones only uses violent means when absolutely necessary.

>shoot armor
Jones only uses violent means when absolutely necessary.

* * *

>gonear
What should Jones gonear?

>gonear air
(the air handling room)
Galaxy Jones is in the air handling room. There is a good number of loud fans and other air handling machinery here. A small hinged vent opening leads into some ductwork, and from there to the outside. A door leads west.

>purloin gel
Which do you mean, the bottle of Electrofil quick-setting conductive polymer gel or the untakable bottle?

>bottle of electrofil
[Purloined.]

>w
(first opening the air handling door)

Galaxy Jones is on the north side of the Consolidated Microthings office. This is the company cafeteria. The elevator is south, the air handling room is to the east, and the office continues to the west and southeast.

* * *

>open panel
(the ceiling panel)
Jones removes the ceiling panel, exposing a hole wide enough for her to squeeze through.

Thallium's voice booms over the office PA: "You can run, Jones, but you can't - well, there aren't very many places you can hide."

>e
Galaxy Jones is in the tenth floor elevator hall. The elevator car to the west stands open. There is a stairwell to the east. The hall runs north and south into a sumptuous corporate office.

* * *

>s
Galaxy Jones is on the south side of the Consolidated Microthings office. This is reception. The front desk has a great view of the New Reykjavik Botanic Dome. Couches are lined up to take advantage. The floor extends east and west, and north to the elevator.

Jones sees the mauve guard robot nearby to the west.

>n
Galaxy Jones is in the tenth floor elevator hall. The elevator car to the west stands open. There is a stairwell to the east. The hall runs north and south into a sumptuous corporate office.

The mauve guard robot appears nearby to the south, coming from the west.

Beck: "If I only had a heart, indeed."

>w
Galaxy Jones is in the elevator car. It's luxurious, with gold-plated walls and crystal lighting on the ceiling. The button panel is lacquered dark mahogany with what look like real ivory buttons. The carpeting is soft and plush. A golden keyhole sits above the buttons. There is a hole in the ceiling big enough for Jones to squeeze through. You can leave the elevator to the east.

The mauve guard robot appears nearby to the east, coming from the south.

* * *

>u
Galaxy Jones is on the top of the elevator car. The elevator shaft extends many hundreds of feet above her. She can see down into the elevator car from here.

The mauve guard robot enters the elevator car below.

>pour gel on guard
Jones tries, but she can't get close enough to the robot from up here.

>d
Galaxy Jones is in the elevator car. It's luxurious, with gold-plated walls and crystal lighting on the ceiling. The button panel is lacquered dark mahogany with what look like real ivory buttons. The carpeting is soft and plush. A golden keyhole sits above the buttons. There is a hole in the ceiling big enough for Jones to squeeze through. You can leave the elevator to the east.

The guard robot moves in on Jones with its slashing knife arms, slicing her to ribbons.

    *** Jones was killed by the mauve guard robot ***

In that game you scored 0 out of a possible 10, in 12 turns.

Would you like to RESTART, RESTORE a saved game, QUIT, or UNDO the last command?

>undo
Galaxy Jones is on the top of the elevator car.
[Previous turn undone.]

>jump down
You must name something more substantial.

The mauve guard robot exits the elevator car, out of sight.

>undo
Galaxy Jones is on the top of the elevator car.
[Previous turn undone.]

* * *

>jump on robot
Jones drops down through the ceiling and on to the guard robot. It swings around looking for her, obviously panicked that it can't bring its gun to bear on its attacker. Jones manages to hang on.

The mauve guard robot struggles against her hold on it, to no avail.

>pour gel on robot
Jones pours the gel into the vent on the robot's head. The robot flails around wildly and throws her from its back, then lets out a loud crackling sound and stops moving.

Galaxy Jones is in the elevator car. It's luxurious, with gold-plated walls and crystal lighting on the ceiling. The button panel is lacquered dark mahogany with what look like real ivory buttons. The carpeting is soft and plush. A golden keyhole sits above the buttons. There is a hole in the ceiling big enough for Jones to squeeze through. You can leave the elevator to the east.

The remains of the mauve guard robot are sprawled on the ground.

>purloin note
Which do you mean, the sticky note or the present?

>sticky
[Purloined.]

>e
Galaxy Jones is in the tenth floor elevator hall. The elevator car to the west stands open. There is a stairwell to the east. The hall runs north and south into a sumptuous corporate office.

>s
Galaxy Jones is on the south side of the Consolidated Microthings office. This is reception. The front desk has a great view of the New Reykjavik Botanic Dome. Couches are lined up to take advantage. The floor extends east and west, and north to the elevator.

>w
Galaxy Jones is at the southwest corner of the Consolidated Microthings office. This looks like the IT area of the office. Numerous desks and an abundance of computer parts are here. Jones can go north or east from here.

There is a present with a note attached sitting on a desk here.

>read note
(the present)
The note on the present says "For Galaxy -- see you soon! -- Your friend, the Admiral."

>read present
The note on the present says "For Galaxy -- see you soon! -- Your friend, the Admiral."

>take
(the present)
Taken.

* * *

>gonear 100th
Galaxy Jones is in the 100th floor elevator hall. The luxury is staggering.  The walls are made of polished black marble, and the floors are covered in plush black carpeting that muffles the sound of footsteps. The ceiling is high and adorned with a crystal chandelier. The elevator doors to the west are gold-plated. Sumptuous living quarters are visible to the north and south.

>climb chandelier
Little is to be achieved by that.

>swing on chandelier
 _________      __                     _____                     
 __/ ____/___ _/ /___ __  ____  __     __/ /___  ____  ___  _____
 _/ / __/ __ `/ / __ `/ |/ / / / /____ _/ / __ \/ __ \/ _ \/ ___/
 / /_/ / /_/ / / /_/ />  </ /_/ / _/ /_/ / /_/ / / / /  __(__  ) 
 \____/\__,_/_/\__,_/_/|_|\__, /  _\____/\____/_/ /_/\___/____/  
 _____________________________/ 
Jones leaps up and grabs hold of the chandelier, starts it swinging back and forth, does a 180º spin, and then releases into a somersault, sticking the landing!

>s
Galaxy Jones is in the southern corner of the penthouse. This must be Thallium's "treasure room", to go by the obscene display of wealth. The most notable feature is the array of diamonds lining the walls. Everything else here pales in comparison. The penthouse continues to the northwest, north, and northeast.

Thallium seems to speak from all around Jones. "You like diamonds, Jones? Of course you do -- they're a girl's best friend, after all."

Jones snorts, "Sure, Thallium."

I beg your pardon?

>purloin screwdriver
[Purloined.]

>pry with screwdriver
There's nothing like that nearby.

>pry diamond with screwdriver
You pry one of the diamonds out of the wall.

Thallium giggles. "Oh, I hope you're not disappointed, Jones."

>pry diamond
(the diamond)
Jones has already taken a diamond. Isn't one enough?

>pronouns
At the moment, "it" means the diamond, "him" is unset, "her" is unset, and "them" is unset.

>x it
Jones: "Hmm. This is made of glass."

Thallium: "Poor, sad Jones. But here's the thing. There is a real diamond in there; it's just you'll never find it before the building's defenses flood the whole floor with poisonous gas. Or maybe I'm bluffing. Maybe I'm not. Can you afford to gamble?"

Jones tosses the fake away.

>pronouns
At the moment, "it" means the diamond, "him" is unset, "her" is unset, and "them" is unset.

* * *

>pry diamond
(the diamond)
Jones has already taken a diamond. Isn't one enough?

>pry diamond with screwdriver
(the diamond with the screwdriver)
Jones has already taken a diamond. Isn't one enough?

>showme glass diamond
There seems to be no such object anywhere in the model world.

>showme diamond
(the diamond)
diamond - gem
location: carried by Jones in the southern corner of the penthouse
singular-named, improper-named, unused; unlit, inedible, portable, handled, neuter, seen, familiar, non-pourable, dull; list grouping key: none
printed name: "diamond"
printed plural name: "gems"
indefinite article: none
most recent reference: nominal
third singular pronoun: It-pronoun
conversation: none
description: "Worthless."
initial appearance: none
third-plural-pronoun: They-pronoun

>pry diamonds with screwdriver
Jones has already taken a diamond. Isn't one enough?

>pry diamonds
Jones has already taken a diamond. Isn't one enough?

>x diamond
(the diamond)

Jones: "Hmm. This is made of glass."

Thallium: "Poor, sad Jones. But here's the thing. There is a real diamond in there; it's just you'll never find it before the building's defenses flood the whole floor with poisonous gas. Or maybe I'm bluffing. Maybe I'm not. Can you afford to gamble?"

Jones tosses the fake away.

>pry diamond
Jones will never find the real diamond this way.

>pry diamonds
Jones will never find the real diamond this way.

>take diamond
Jones will never find the real diamond this way.

* * *

>smash diamonds
(with the hammer)
Jones commences to smash all of the diamonds. After destroying several dozen fraudulent gems, she finds one that won't break. She takes the real diamond.

Thallium: "Wow, clever solution. Be careful you don't cut yourself."

Jones: "I appreciate your concern."

>take diamond
(the diamond)
Jones already has that.

>pry diamond
(the diamond)
Jones has already taken a diamond. Isn't one enough?

>n
Galaxy Jones is in the 100th floor elevator hall. The luxury is staggering.  The walls are made of polished black marble, and the floors are covered in plush black carpeting that muffles the sound of footsteps. The ceiling is high and adorned with a crystal chandelier. The elevator doors to the west are gold-plated. Sumptuous living quarters are visible to the north and south.

>pry diamond
That can't be pried out.

>s
Galaxy Jones is in the southern corner of the penthouse. This must be Thallium's "treasure room", to go by the obscene display of wealth. The most notable feature is the array of diamonds lining the walls. Everything else here pales in comparison. Broken glass litters the floor. The penthouse continues to the northwest, north, and northeast.

>pry array
Jones has already taken a diamond. Isn't one enough?

>n
Galaxy Jones is in the 100th floor elevator hall. The luxury is staggering.  The walls are made of polished black marble, and the floors are covered in plush black carpeting that muffles the sound of footsteps. The ceiling is high and adorned with a crystal chandelier. The elevator doors to the west are gold-plated. Sumptuous living quarters are visible to the north and south.

>drop diamond
Dropped.

>s
Galaxy Jones is in the southern corner of the penthouse. This must be Thallium's "treasure room", to go by the obscene display of wealth. The most notable feature is the array of diamonds lining the walls. Everything else here pales in comparison. Broken glass litters the floor. The penthouse continues to the northwest, north, and northeast.

>pry diamond
Jones has already taken a diamond. Isn't one enough?

>pry diamond with screwdriver
Jones has already taken a diamond. Isn't one enough?

>w
The diamond-shaped penthouse bends to the northeast and northwest.

>pry diamond
Jones has already taken a diamond. Isn't one enough?

>nw
Galaxy Jones is in the western corner of the penthouse. The purpose of this room is unclear. Instead of the black carpet that plagues the rest of the penthouse, the floor is fashioned from a striking polished red granite. Instead of windows, there are walls. Thallium's personal insignia, the ten planets in order overlaid with the motto "Planetas Vincam", is carved into the deep red wood outer wall, and inlaid with ebony. In the center of the room is a thin metal pillar ending in a claw, which looks like it's meant to hold something. Finally, there is something that looks like an electronic eye set into the inner wall. One may leave to the northeast or southeast.

>pry diamond
There's nothing like that nearby.

>ne
Galaxy Jones is in the northern corner of the penthouse. This is Thallium's bedroom. Apart from the expansive round bed in the center of the room, notable features include the line of dummies displaying his various suits of clothes, a large vanity table, and the complete lack of mirrors on the ceiling, thankfully. One may leave the room to the southwest, south, and southeast.

>s
Galaxy Jones is in the 100th floor elevator hall. The luxury is staggering.  The walls are made of polished black marble, and the floors are covered in plush black carpeting that muffles the sound of footsteps. The ceiling is high and adorned with a crystal chandelier. The elevator doors to the west are gold-plated. Sumptuous living quarters are visible to the north and south.

Also here is a diamond.

>pry diamond
That can't be pried out.

>i
Jones is carrying:
  a hammer
  a screwdriver
  a black jumpsuit (being worn)
  a disruptor pistol

>l
Galaxy Jones is in the 100th floor elevator hall. The luxury is staggering.  The walls are made of polished black marble, and the floors are covered in plush black carpeting that muffles the sound of footsteps. The ceiling is high and adorned with a crystal chandelier. The elevator doors to the west are gold-plated. Sumptuous living quarters are visible to the north and south.

Also here is a diamond.

>take
(the diamond)
Taken.

>n
Jones can't go that way.

>sw
The elevator is to the west, and the hall leads into the penthouse to the north and south.

>s
Galaxy Jones is in the southern corner of the penthouse. This must be Thallium's "treasure room", to go by the obscene display of wealth. The most notable feature is the array of diamonds lining the walls. Everything else here pales in comparison. Broken glass litters the floor. The penthouse continues to the northwest, north, and northeast.

>nw
Galaxy Jones is in the western corner of the penthouse. The purpose of this room is unclear. Instead of the black carpet that plagues the rest of the penthouse, the floor is fashioned from a striking polished red granite. Instead of windows, there are walls. Thallium's personal insignia, the ten planets in order overlaid with the motto "Planetas Vincam", is carved into the deep red wood outer wall, and inlaid with ebony. In the center of the room is a thin metal pillar ending in a claw, which looks like it's meant to hold something. Finally, there is something that looks like an electronic eye set into the inner wall. One may leave to the northeast or southeast.

>put diamond in claw
As soon as Jones inserts the diamond into the claw, laser beams spring from five emitters on the walls. They hit the diamond and join into a single more powerful beam that strikes the electronic eye on the wall. A sound like a sliding door comes from behind her, and she spins around to see the red wall slide down into the floor. It exposes a control panel of sorts, featuring a large red button labeled "Press Me".

>l
Galaxy Jones is in the western corner of the penthouse. The purpose of this room is unclear. Instead of the black carpet that plagues the rest of the penthouse, the floor is fashioned from a striking polished red granite. Instead of windows, there are walls. A control panel featuring a large red button is set into the outer wall. In the center of the room is a thin metal pillar ending in a claw, which looks like it's meant to hold something. Finally, there is something that looks like an electronic eye set into the inner wall. One may leave to the northeast or southeast.

>x control panel
Jones discovers a secret panel, which when opened exposes a small black button.

>l
Galaxy Jones is in the western corner of the penthouse. The purpose of this room is unclear. Instead of the black carpet that plagues the rest of the penthouse, the floor is fashioned from a striking polished red granite. Instead of windows, there are walls. A control panel featuring a large red button and a small black button is set into the outer wall. In the center of the room is a thin metal pillar ending in a claw, which looks like it's meant to hold something. Finally, there is something that looks like an electronic eye set into the inner wall. One may leave to the northeast or southeast.

>press black
(the black jumpsuit)
Nothing obvious happens.

>press black button
Somewhere beyond this room comes the sound of something heavy being moved.

Beck: "Why didn't you press the button that said 'Press Me'? Maybe we should press it anyway. Please?"

* * *

>e
The elevator is to the west, and the hall leads into the penthouse to the north and south. A marble staircase leads to the roof.

* * *

>purloin cable
(the cable with hooks at either end)
[Purloined.]

>n
Galaxy Jones is next to the cage. The closely-set silnium bars seem to dash all hope of a rescue. The flyer pad is to the southwest and the rest of the rooftop to the south.

Europa Callisto is lying at the center of the cage, out of Jones's reach.

Jones tries the strength of the bars just in case. They don't budge.

South of the cage, Thallium crosses the roof to the flyer pad, where he boards the waiting flyer. The flyer lifts off and moves towards Jones.

>hook cable to cage
It doesn't seem useful to attach the cable to this part of the cage.

Thallium's flyer hovers over the rooftop. "Jones!"  he bellows. "Play time is over. I grow weary of your intransigence. In a moment this roof will be swarmed by guard robots -- of many different colors -- so many robots you couldn't possibly vandalize them all.  Say your prayers, Jones, or whatever you do when you're about to die."

Jones rolls her eyes.

A little ways off, another flyer, small and red, aims for the rooftop and accelerates.

>hook cable to flyer
Which do you mean, the red flyer or the green flyer?

>green
Jones is not close enough to do that.

>throw cable at flyer
(the green flyer)
Jones throws the cable, but it comes up short. She gathers it up again.

>u
Jones gets onto the cage.

>throw cable at flyer
(the green flyer)
 _________      __                     _____                     
 __/ ____/___ _/ /___ __  ____  __     __/ /___  ____  ___  _____
 _/ / __/ __ `/ / __ `/ |/ / / / /____ _/ / __ \/ __ \/ _ \/ ___/
 / /_/ / /_/ / / /_/ />  </ /_/ / _/ /_/ / /_/ / / / /  __(__  ) 
 \____/\__,_/_/\__,_/_/|_|\__, /  _\____/\____/_/ /_/\___/____/  
 _____________________________/ 

[Your score has just gone up by one point.]

Jones throws the cable up to the flyer where it hooks around the rail, and attaches the other end to the cage, then jumps off the cage to escape the aftermath. Seeing his flyer's predicament, Thallium jumps out of the craft and disappears below the edge of the roof. The flyer reaches the end of its tether and slingshots downwards, slamming into side of the building.

The cage has tilted to the side, one attachment torn loose from the rooftop. Jones crawls into the cage to see to Europa Callisto.

"Europa! Can you hear me? I need you to move to get out of this cage. I can't carry you through that small opening. Europa!"

Europa moans but doesn't show any signs of having understood Jones.

Galaxy Jones is in the cage. The whole structure is tilted, leaving a hole at the eastern end. The flyer pad is to the southwest and the rest of the rooftop to the south.

Jones is kneeling at Europa Callisto's side, trying to rouse her.

The red flyer, now recognizable as Galaxy's own, settles down onto the landing pad.

* * *

>swing on chandelier
 _________      __                     _____                     
 __/ ____/___ _/ /___ __  ____  __     __/ /___  ____  ___  _____
 _/ / __/ __ `/ / __ `/ |/ / / / /____ _/ / __ \/ __ \/ _ \/ ___/
 / /_/ / /_/ / / /_/ />  </ /_/ / _/ /_/ / /_/ / / / /  __(__  ) 
 \____/\__,_/_/\__,_/_/|_|\__, /  _\____/\____/_/ /_/\___/____/  
 _____________________________/ 
Jones leaps up and grabs hold of the chandelier, starts it swinging back and forth, does a 180º spin, and then releases into a somersault, sticking the landing!

>swing on floor
There's nothing like that nearby.

>swing
(on the chandelier)
At any other time, Jones might consider it.

>s
Galaxy Jones is in the southern corner of the penthouse. This must be Thallium's "treasure room", to go by the obscene display of wealth. The most notable feature is the array of diamonds lining the walls. Everything else here pales in comparison. The penthouse continues to the northwest, north, and northeast.

Thallium seems to speak from all around Jones. "You like diamonds, Jones? Of course you do -- they're a girl's best friend, after all."

Jones snorts, "Sure, Thallium."

>n
Galaxy Jones is in the 100th floor elevator hall. The luxury is staggering.  The walls are made of polished black marble, and the floors are covered in plush black carpeting that muffles the sound of footsteps. The ceiling is high and adorned with a crystal chandelier. The elevator doors to the west are gold-plated. Sumptuous living quarters are visible to the north and south.

>trace 4
[Parser tracing set to level 4.]

>swing on floor
[ "swing" swing / "on" on / "floor" floor ]
[Parsing for the verb 'swing' (1 lines)]

[line 0 * 'on' noun=Routine(606239) -> Climb]
 [line 0 token 1 word 2 : 'on']
  [token resulted in success]
 [line 0 token 2 word 3 : noun=Routine(606239)]
  [Object list from word 3]
  [Calling NounDomain on location and actor]
   [NounDomain called at word 3
   seeking definite object
Parse_name called
Pass 1: 0 Pass 2: 0 Pass 3: 0
   [ND made 0 matches]
  [token resulted in failure with error type 5]
There's nothing like that nearby.

>x floor
[ "x" x / "floor" floor ]
[Parsing for the verb 'x' (1 lines)]

[line 0 * noun -> Examine]
 [line 0 token 1 word 2 : noun]
  [Object list from word 2]
  [Calling NounDomain on location and actor]
   [NounDomain called at word 2
   seeking definite object
Parse_name called
Pass 1: 0 Pass 2: 0 Pass 3: 0
Parse_name called
Pass 1: 0 Pass 2: 0 Pass 3: 0
Parse_name called
Pass 1: 0 Pass 2: 0 Pass 3: 0
Parse_name called
Pass 1: 0 Pass 2: 0 Pass 3: 0
Parse_name called
Pass 1: 0 Pass 2: 0 Pass 3: 0
Parse_name called
Pass 1: 0 Pass 2: 0 Pass 3: 0
Parse_name called
Pass 1: 0 Pass 2: 0 Pass 3: 0
Parse_name called
Pass 1: 0 Pass 2: 0 Pass 3: 0
Parse_name called
Pass 1: 0 Pass 2: 0 Pass 3: 0
Parse_name called
Pass 1: 0 Pass 2: 0 Pass 3: 0
Parse_name called
Pass 1: 0 Pass 2: 0 Pass 3: 0
Parse_name called
Pass 1: 0 Pass 2: 0 Pass 3: 0
Parse_name called
Pass 1: 0 Pass 2: 0 Pass 3: 0
Parse_name called
Pass 1: 0 Pass 2: 0 Pass 3: 0
Parse_name called
Pass 1: 1 Pass 2: 1 Pass 3: 1
Parse_name called
Pass 1: 0 Pass 2: 0 Pass 3: 0
Parse_name called
Pass 1: 0 Pass 2: 0 Pass 3: 0
Parse_name called
Pass 1: 0 Pass 2: 0 Pass 3: 0
Parse_name called
Pass 1: 0 Pass 2: 0 Pass 3: 0
Parse_name called
Pass 1: 1 Pass 2: 1 Pass 3: 1
   [ND made 2 matches]
   [Adjudicating match list of size 2 in context 0
   definite object
   Scoring match list: indef mode 0 type 0, satisfying 0 requirements:
     The carpet (1155244) in the 100th floor elevator hall : 2146 points

     The 100th floor elevator hall (1155180) in nothing : 1136 points
   Single best-scoring object returned.]
  [ND returned the carpet]
  [token resulted in success]
 [line 0 token 2 word 3 : END]
[Line successfully parsed]
(the carpet)
Dark black, almost threatening, rounding out the storm cloud atmosphere of the room.

>trace off
[ "trace" trace / "off" off ]
[Parsing for the verb 'trace' (4 lines)]

[line 0 * -> TraceOn]
 [line 0 token 1 word 2 : END]

[line 1 * number -> TraceLevel]
 [line 1 token 1 word 2 : number]
  [token resulted in failure with error type 3]

[line 2 * 'on' -> TraceOn]
[line rejected for not ending with correct preposition]

[line 3 * 'off' -> TraceOff]
 [line 3 token 1 word 2 : 'off']
  [token resulted in success]
 [line 3 token 2 word 3 : END]
[Line successfully parsed]
Trace off.

I beg your pardon?

>l
Galaxy Jones is in the 100th floor elevator hall. The luxury is staggering.  The walls are made of polished black marble, and the floors are covered in plush black carpeting that muffles the sound of footsteps. The ceiling is high and adorned with a crystal chandelier. The elevator doors to the west are gold-plated. Sumptuous living quarters are visible to the north and south.

* * *

>sneak
(toward the purple guard robot)
Jones creeps a little ways toward the guard robot.

>z
The guard robot moves a little farther away from Jones.

She stands around and waits.

>g
Jones stands around and waits.

>sneak
(toward the purple guard robot)
Jones creeps a little ways toward the guard robot.

* * *

>g
(toward the purple guard robot)
Jones is right up next to the robot, crouched beneath a desk. She can see right up under its armor.

>x armor
Jones can see up under the robot's armor. A shot here might be effective.

>x desk
Very nice and good for hiding under and among.

The guard robot moves a little farther away from Jones.

>sneak
(toward the purple guard robot)
Jones is right up next to the robot, crouched beneath a desk. She can see right up under its armor.

>shoot under armor
(with the disruptor pistol)
Jones aims the pistol upward under the robot's enhanced armor and fires. She flinches back when the robot's innards explode downward in a shower of sparks. It topples over, dead. Jones stands up and surveys her handiwork.

 _________      __                     _____                     
 __/ ____/___ _/ /___ __  ____  __     __/ /___  ____  ___  _____
 _/ / __/ __ `/ / __ `/ |/ / / / /____ _/ / __ \/ __ \/ _ \/ ___/
 / /_/ / /_/ / / /_/ />  </ /_/ / _/ /_/ / /_/ / / / /  __(__  ) 
 \____/\__,_/_/\__,_/_/|_|\__, /  _\____/\____/_/ /_/\___/____/  
 _____________________________/ 

[Your score has just gone up by one point.]

Jones: "Better than a video game. "

Beck: "Nice, but don't forget to credit your handler."

Jones: "Yes, yes, thanks for helping me not get killed."

Beck: "You're welcome."

>shoot robot
Jones only uses violent means when absolutely necessary.

>undo
Galaxy Jones is in the Cybernetica office.
[Previous turn undone.]

>shoot under armor
There's nothing like that nearby.

>gonear air
(the air handling room)
Galaxy Jones is in the air handling room. There is a good number of loud fans and other air handling machinery here. A small hinged vent opening leads into some ductwork, and from there to the outside. A door leads west.

* * *

>s
Galaxy Jones is at the southeast corner of the Consolidated Microthings office. This corner of the floor contains the gym and other company amenities. Reception is to the west, and an empty area lies to the north.

Jones sees the mauve guard robot a couple of steps to the west.

>shoot under armor
There's nothing like that nearby.

>shoot robot
The shot narrowly misses the guard robot.

A couple of steps to the west, the mauve guard robot heads east.

Thallium: "Jones, you still hanging around with that loser Beck?"

>shoot robot
The shot is absorbed by the mauve robot.

The mauve guard robot approaches from the west.

The guard robot moves in on Jones with its slashing knife arms, slicing her to ribbons.

    *** Jones was killed by the mauve guard robot ***

In that game you scored 1 out of a possible 10, in 17 turns.

Would you like to RESTART, RESTORE a saved game, QUIT, or UNDO the last command?

>undo
Galaxy Jones is at the southeast corner of the Consolidated Microthings office.
[Previous turn undone.]

* * *

>n
Galaxy Jones is on the east side of the Consolidated Microthings office. This part of the office is currently unused. Jones can go northwest or south from here.

The mauve guard robot appears nearby to the south, coming from the west.

>nw
Galaxy Jones is on the north side of the Consolidated Microthings office. This is the company cafeteria. The elevator is south, the air handling room is to the east, and the office continues to the west and southeast.

The mauve guard robot appears nearby to the southeast, coming from the south.

Thallium: "Don't you just hate it, Jones -- not knowing when death will just jump out at you?"

>w
Galaxy Jones is at the northwest corner of the Consolidated Microthings office. Various executive offices line the north and west walls here. Jones can go east or south.

The mauve guard robot appears nearby to the east, coming from the southeast.

* * *

>s
Galaxy Jones is on the west side of the Consolidated Microthings office. This ocean of desks looks out toward the Utopia Tower, twice the height of the Viking Building, where Jones is now. One can go north or south.

The mauve guard robot appears nearby to the north, coming from the east.

>s
Galaxy Jones is at the southwest corner of the Consolidated Microthings office. This looks like the IT area of the office. Numerous desks and an abundance of computer parts are here. Jones can go north or east from here.

There is a present with a note attached sitting on a desk here.

A couple of steps to the north, the mauve guard robot heads south.

>e
Galaxy Jones is on the south side of the Consolidated Microthings office. This is reception. The front desk has a great view of the New Reykjavik Botanic Dome. Couches are lined up to take advantage. The floor extends east and west, and north to the elevator.

The mauve guard robot appears nearby to the west, coming from the north.

>n
Galaxy Jones is in the tenth floor elevator hall. The elevator car to the west stands open. There is a stairwell to the east. The hall runs north and south into a sumptuous corporate office.

The mauve guard robot appears nearby to the south, coming from the west.

Beck: "Come and get us, ugly!"

Jones: "'Us'? Seems like I'm the only one with her life on the line."

>n
Galaxy Jones is on the north side of the Consolidated Microthings office. This is the company cafeteria. The elevator is south, the air handling room is to the east, and the office continues to the west and southeast.

A couple of steps to the south, the mauve guard robot heads north.

* * *

>w
Galaxy Jones is at the northwest corner of the Consolidated Microthings office. Various executive offices line the north and west walls here. Jones can go east or south.

Jones sees the mauve guard robot a couple of steps to the south.

>e
Galaxy Jones is on the north side of the Consolidated Microthings office. This is the company cafeteria. The elevator is south, the air handling room is to the east, and the office continues to the west and southeast.

The mauve guard robot appears a couple of steps to the south, coming from the west.

Beck: "I hope you have a warranty, because you're about to be seriously damaged!"

Jones: "Really, Beck? Is this your best material?"

>z
Jones stands around and waits.

A couple of steps to the south, the mauve guard robot heads north.

Thallium: "I bet you're just dying to meet Europa, right, Jones?"

>z
Jones stands around and waits.

The mauve guard robot approaches from the south.

The guard robot moves in on Jones with its slashing knife arms, slicing her to ribbons.

    *** Jones was killed by the mauve guard robot ***

In that game you scored 1 out of a possible 10, in 35 turns.

Would you like to RESTART, RESTORE a saved game, QUIT, or UNDO the last command?

* * *

>gonear filing cabinet
Galaxy Jones is at the south end of the building management office. The building management office is a bunch of desks and task boards. There is a filing cabinet against the east wall. The office exit is to the east, and the office continues to the north.

A screwdriver sits atop the filing cabinet.

>move cabinet
Do you know how heavy paper is?

>take screwdriver
Jones reaches for the screwdriver, but she fumbles it and it rolls off the back of the filing cabinet.

Jones: "Damn."

Beck: "What? What's going on?"

Jones: "Just being clumsy is all."

>move cabinet
Jones can't move it, but she might be able to look behind it.

>look behind cabinet
(taking the screwdriver)
Jones reaches behind the cabinet to retrieve the screwdriver. A swipe and a hiss make her recoil.

Jones: "Holy --!"

Beck: "What now?"

Jones: "There's a cat here! Behind a filing cabinet. Gotta get behind there to get a screwdriver, so I need a way to drive off the cat."

>look behind cabinet
(taking the screwdriver)
Forget it. Jones isn't getting another scratch.

* * *

>gonear first floor shaft
There seems to be no such object anywhere in the model world.

>gonear first dhaft
There seems to be no such object anywhere in the model world.

>gonear first shaft
There seems to be no such object anywhere in the model world.

>gonear ground shaft
Galaxy Jones is in the ground floor elevator shaft. Jones is at the bottom of a dark well. Shining her suit light up, she can see that the elevator car is several floors up, unmoving. There is a ladder running up the wall next to the door.

Beck: "Ooh. It's like we're in an action film."

>climb
What should Jones climb?

>ladder
She climbs up the shaft, stopping at each floor to test each door. She gets all the way to the ninth floor, directly below the elevator car, before finding one that opens.

Galaxy Jones is in the ninth floor elevator shaft. The door to the east is open.

Beck: "Huh. Seems like it should have taken longer than that."

>undo
Galaxy Jones is in the ground floor elevator shaft.
[Previous turn undone.]

>climb shaft
There's nothing like that nearby.

* * *

>gonear ground shaft
Galaxy Jones is in the ground floor elevator shaft. Jones is at the bottom of a dark well. Shining her suit light up, she can see that the elevator car is several floors up, unmoving. There is a ladder running up the wall next to the door.

Beck: "Ooh. It's like we're in an action film."

>climb shaft
There's nothing like that nearby.

>scope
1: an elevator car (1164184)
2: a ladder (1164152)
3: Jones (1157368)
4: an elevator door (1158072)
5: a black jumpsuit (1157400)
6: a suit light (1156984)
7: a disruptor pistol (1157432)
8: Beck (1156920)

>gonear chemical
Which do you mean, the Martian Chemical office, the chemical cabinet, the Martian Chemical door, or the martian chemical logo?

>office
(the Martian Chemical office)
Galaxy Jones is in the Martian Chemical office. This seems like the business office of the chemical company rather than the lab. Most of the room is taken up by desks and other office stuff. There is a cabinet that looks intriguing, however.

>scope
1: outside (1162936)
2: a Martian Chemical door (1160344)
3: a martian chemical logo (1160376)
4: Jones (1157368)
5: a chemical cabinet (1160056)
6: a bottle of Electrofil quick-setting conductive polymer gel (1160088)
7: a desks (1160120)
8: an office stuff (1160152)
9: a black jumpsuit (1157400)
10: a suit light (1156984)
11: a disruptor pistol (1157432)
12: Beck (1156920)

>take bottle
Taken.

>scope
1: outside (1162936)
2: a Martian Chemical door (1160344)
3: a martian chemical logo (1160376)
4: Jones (1157368)
5: a chemical cabinet (1160056)
6: an untakable bottle (1164760)
7: a desks (1160120)
8: an office stuff (1160152)
9: a bottle of Electrofil quick-setting conductive polymer gel (1160088)
10: a black jumpsuit (1157400)
11: a suit light (1156984)
12: a disruptor pistol (1157432)
13: Beck (1156920)

>take bottle
Jones already has that.

>open cabinet
The cabinet is full of bottles of Electrofil quick-setting conductive polymer gel.

>take bottle
Jones already has that.

>gonear ninth hall
Galaxy Jones is in the ninth floor elevator hall. The elevator is to the west, the stairwell is to the east, and a corridor leads north and south. There is a bottled water vending machine here.

>drop gell
There's nothing like that nearby.

>drop gel
Dropped.

>gonear chemical
Which do you mean, the Martian Chemical office, the chemical cabinet, the Martian Chemical door, or the martian chemical logo?

* * *

>office
(the Martian Chemical office)
Galaxy Jones is in the Martian Chemical office. This seems like the business office of the chemical company rather than the lab. Most of the room is taken up by desks and other office stuff. There is a cabinet that looks intriguing, however.

>take bottle
Jones has already taken one bottle of Electrofil from the cabinet. She should use it before taking another.

>scope
1: Jones (1157368)
2: outside (1162936)
3: a Martian Chemical door (1160344)
4: a martian chemical logo (1160376)
5: a chemical cabinet (1160056)
6: an untakable bottle (1164760)
7: a desks (1160120)
8: an office stuff (1160152)
9: a black jumpsuit (1157400)
10: a suit light (1156984)
11: a disruptor pistol (1157432)
12: Beck (1156920)

>take untakable
There's nothing like that nearby.

>showme untakable
There seems to be no such object anywhere in the model world.

>w
(first opening the Martian Chemical door)
It seems to be locked.

>gonear ninth hall
Galaxy Jones is in the ninth floor elevator hall. The elevator is to the west, the stairwell is to the east, and a corridor leads north and south. There is a bottled water vending machine here.

Also here is a bottle of Electrofil quick-setting conductive polymer gel.

>take gel
Taken.

>gonear air
(the air handling room)
Galaxy Jones is in the air handling room. There is a good number of loud fans and other air handling machinery here. A small hinged vent opening leads into some ductwork, and from there to the outside. A door leads west.

* * *

>e
Galaxy Jones is in the tenth floor elevator hall. The elevator car to the west stands open. There is a stairwell to the east. The hall runs north and south into a sumptuous corporate office.

Thallium's voice booms over the office PA: "You can run, Jones, but you can't - well, there aren't very many places you can hide."

>s
Galaxy Jones is on the south side of the Consolidated Microthings office. This is reception. The front desk has a great view of the New Reykjavik Botanic Dome. Couches are lined up to take advantage. The floor extends east and west, and north to the elevator.

Jones sees the mauve guard robot nearby to the west.

* * *

>n
Galaxy Jones is in the tenth floor elevator hall. The elevator car to the west stands open. There is a stairwell to the east. The hall runs north and south into a sumptuous corporate office.

The mauve guard robot appears nearby to the south, coming from the west.

>w
Galaxy Jones is in the elevator car. It's luxurious, with gold-plated walls and crystal lighting on the ceiling. The button panel is lacquered dark mahogany with what look like real ivory buttons. The carpeting is soft and plush. A golden keyhole sits above the buttons. There is a hole in the ceiling big enough for Jones to squeeze through. You can leave the elevator to the east.

The mauve guard robot appears nearby to the east, coming from the south.

Thallium: "Jones, you still hanging around with that loser Beck?"

>u
Galaxy Jones is on the top of the elevator car. The elevator shaft extends many hundreds of feet above her. She can see down into the elevator car from here.

The mauve guard robot enters the elevator car below.

* * *

>gonear chemical office
(the Martian Chemical office)
Galaxy Jones is in the Martian Chemical office. This seems like the business office of the chemical company rather than the lab. Most of the room is taken up by desks and other office stuff. There is a cabinet that looks intriguing, however.

>take gel
Taken.

>showme gel
bottle of Electrofil quick-setting conductive polymer gel - thing
location: carried by Jones in the Martian Chemical office
singular-named, improper-named, unused; unlit, inedible, portable, handled, neuter, seen, familiar, pourable, interesting
list grouping key: none
printed name: "bottle of Electrofil quick-setting conductive polymer gel"
printed plural name: none
indefinite article: none
most recent reference: nominal
third singular pronoun: It-pronoun
conversation: none
description: "An opaque pink bottle labeled "Electrofil" in large friendly letters, it apparently hardens into a conductive substance very quickly."
initial appearance: none
third-plural-pronoun: They-pronoun

>scope
1: Jones (1157368)
2: outside (1162936)
3: a Martian Chemical door (1160344)
4: a martian chemical logo (1160376)
5: a chemical cabinet (1160056)
6: an untakable bottle (1164760)
7: a desks (1160120)
8: an office stuff (1160152)
9: a bottle of Electrofil quick-setting conductive polymer gel (1160088)
10: a black jumpsuit (1157400)
11: a suit light (1156984)
12: a disruptor pistol (1157432)
13: Beck (1156920)

* * *

>gonear ledge
Galaxy Jones is on a ledge. It runs north and south. Jones is plastered up against the wall to the west, trying not to look down. Four thick, tense wires run vertically from above to below her. One of them is within reach.

>x wire
The wires look very tense. They run up and down.

>climb wire
The Atmo-Suit's gloves have neither enough friction or enough durability for Jones to climb the wire. Even if she did manage to maintain a grip on the wire, she'd shred the gloves and then her hands.

>climb up
You must name something more substantial.

>hook cable to wire
There's nothing like that nearby.

>purloin cable
(the cable with hooks at either end)
[Purloined.]

>hook cable to wire
Jones would achieve nothing by this.

>actions
Actions listing on.

>hook cable to wire
[tying the cable with hooks at either end to the wires]
Jones would achieve nothing by this.
[tying the cable with hooks at either end to the wires - failed the block tying rule]

* * *

>w
Galaxy Jones is at the south end of the building management office. The building management office is a bunch of desks and task boards. There is a filing cabinet against the east wall. The office exit is to the east, and the office continues to the north.

A screwdriver sits atop the filing cabinet.

>move cabinet
Do you know how heavy paper is?

* * *

>take screwdriver
Jones reaches for the screwdriver, but she fumbles it and it rolls off the back of the filing cabinet.

Jones: "Damn."

Beck: "What? What's going on?"

Jones: "Just being clumsy is all."

>move cabinet
Do you know how heavy paper is?

>take cabinet
Do you know how heavy paper is?

* * *

>n
Galaxy Jones is next to the cage. The closely-set silnium bars seem to dash all hope of a rescue. The flyer pad is to the southwest and the rest of the rooftop to the south.

Europa Callisto is lying at the center of the cage, out of Jones's reach.

Jones tries the strength of the bars just in case. They don't budge.

South of the cage, Thallium crosses the roof to the flyer pad, where he boards the waiting flyer. The flyer lifts off and moves towards Jones.

>purloin cable
(the cable with hooks at either end)
[Purloined.]

>throw cable at flyer
Jones throws the cable, but it comes up short. She gathers it up again.

Thallium's flyer hovers over the rooftop. "Jones!"  he bellows. "Play time is over. I grow weary of your intransigence. In a moment this roof will be swarmed by guard robots -- of many different colors -- so many robots you couldn't possibly vandalize them all.  Say your prayers, Jones, or whatever you do when you're about to die."

Jones rolls her eyes.

A little ways off, another flyer, small and red, aims for the rooftop and accelerates.

>attach cable to cage
It doesn't seem useful to attach the cable to this part of the cage.

>climb cage
Jones gets onto the cage.

>l
Galaxy Jones is standing on the cage. The closely-set silnium bars seem to dash all hope of a rescue. The flyer pad is to the southwest and the rest of the rooftop to the south.

Europa Callisto is lying at the center of the cage, out of Jones's reach.

The green flyer is hovering above you.

* * *

>n
Jones approaches the Viking Building entryway, the dramatic façade towering over her.

Galaxy Jones is at the entry doorway. A glass revolving door leads into a large open space north of here. The speeder dock is to the south.

Jones looks up at the 100 stories of glass and steel. "What do you want to bet Thallium's got Europa all the way at the top?"

Beck: "Oh, no doubt."

>enter door
Jones takes a deep breath. "I'm going in."

Beck replies, "You got this, Galaxy."

Jones passes through the revolving door and into the lobby, alert to any defenses.

Galaxy Jones is in the lobby. The ground floor of the Viking Building is breathtaking. Low-G architecture means more glass and thinner supports, and the building takes advantage of that. Four walls of glass surround a central pillar in which are set the utility rooms and elevators. In between is an expanse of plants, water features, and stylish seating. Near the entryway is a front desk. A giant crystal sculpture floats above the center of the area, suspended on almost invisible cables. She may go east and west from here, north to the elevators, or south out of the building.

>gonear cage
South of the cage, Thallium crosses the roof to the flyer pad, where he boards the waiting flyer. The flyer lifts off and moves towards Jones.

Suddenly two robot guards, green and red, emerge from niches in the back wall! Jones dives behind the front desk and draws her disruptor pistol.

Jones shouts, "I'm under fire from two ugly robot things!"

Beck responds, "Monitoring your suit radar."

>l
Galaxy Jones is next to the cage. The closely-set silnium bars seem to dash all hope of a rescue. The flyer pad is to the southwest and the rest of the rooftop to the south.

Europa Callisto is lying at the center of the cage, out of Jones's reach.

The green flyer is hovering above you.

Thallium's flyer hovers over the rooftop. "Jones!"  he bellows. "Play time is over. I grow weary of your intransigence. In a moment this roof will be swarmed by guard robots -- of many different colors -- so many robots you couldn't possibly vandalize them all.  Say your prayers, Jones, or whatever you do when you're about to die."

Jones rolls her eyes.

A little ways off, another flyer, small and red, aims for the rooftop and accelerates.

* * *

>purloin red card
[Purloined.]

>w
Jones crosses the floor carefully, disruptor pistol at the ready.

Galaxy Jones is at the southwest corner of the ground floor. A lush indoor waterfall here contrasts with the dusty red streets of New Reykjavik beyond the glass walls. The ground floor extends north and east.

Admiral Thallium's voice booms from the ceiling. "Little Galaxy thinks she's beaten the big bad Admiral. Sorry dear, that was only a taste."

>n
Galaxy Jones is on the west side of the ground floor. Semicircular couches open on either side of a central carpeted path leading north and south. Set in the central pillar of the building to the east is a utility door with a swipe lock. The city looms beyond the glass wall to the west.

>swipe card through card lock
(the red cardkey through the swipe lock)
Jones unlocks the utility door.

* * *

>s
Suddenly two robot guards, green and red, emerge from niches in the back wall! Jones dives behind the front desk and draws her disruptor pistol.

Jones shouts, "I'm under fire from two ugly robot things!"

Beck responds, "Monitoring your suit radar."

>restart
Are you sure you want to restart?

* * *

>enter door
There's nothing like that nearby.

>x door
There's nothing like that nearby.

>l
Galaxy Jones is in the speeder dock. A safe harbor from the periodic dust storms of Utopia Planitia, the dock features several dozen speeder bays. Only a few are filled right now. The building entryway is to the north, under a red stone façade carved into the likeness of a fearsome Viking.

Jones's speeder, Galaxy One, sits in one of the parking bays.

>enter
You must supply a noun.

>enter building
Jones approaches the Viking Building entryway, the dramatic façade towering over her.

Galaxy Jones is at the entry doorway. A glass revolving door leads into a large open space north of here. The speeder dock is to the south.

Jones looks up at the 100 stories of glass and steel. "What do you want to bet Thallium's got Europa all the way at the top?"

Beck: "Oh, no doubt."

>enter door
That's not something Jones can enter.