 _________      __                     _____                     
 __/ ____/___ _/ /___ __  ____  __     __/ /___  ____  ___  _____
 _/ / __/ __ `/ / __ `/ |/_/ / / /  __ _/ / __ \/ __ \/ _ \/ ___/
 / /_/ / /_/ / / /_/ />  </ /_/ /  / /_/ / /_/ / / / /  __(__  ) 
 \____/\__,_/_/\__,_/_/|_|\__, /   \____/\____/_/ /_/\___/____/  
 _____________________________/ 
An Interactive Fiction by Philip Riley
Release 1 / Serial number 230219 / Inform 7 build 6M62 (I6/v6.34 lib 6/12N) SD

Galaxy Jones is in the speeder dock. A safe harbor from the periodic dust storms of Utopia Planitia, the dock features several dozen speeder bays. Only a few are filled right now. The building entryway is to the north, under a red stone façade carved into a fearsome Viking.

Jones's speeder, Galaxy One, sits in one of the parking bays.

>enter speeder
You have a job to do here.

* * *

>gonear tenth
Galaxy Jones is on the tenth floor.

>s
Galaxy Jones is on the south side of the Sirius Cybernetics office.

>w
Galaxy Jones is at the southwest corner of the Sirius Cybernetics office.

>m
That's not a verb I recognise.

>n
Galaxy Jones is on the west side of the Sirius Cybernetics office.

>n
Galaxy Jones is at the northwest corner of the Sirius Cybernetics office.

>e
Galaxy Jones is on the north side of the Sirius Cybernetics office.

>e
Galaxy Jones is at the northeast corner of the Sirius Cybernetics office.

>s
Galaxy Jones is on the east side of the Sirius Cybernetics office.

>s
Galaxy Jones is at the southeast corner of the Sirius Cybernetics office.

>w
Galaxy Jones is on the south side of the Sirius Cybernetics office.

>n
Galaxy Jones is on the tenth floor.

>e
Jones can't go that way.

* * *

>w
Jones can't go that way.

>resatart
That's not a verb I recognise.

>restart
Are you sure you want to restart?

>y
 _________      __                     _____                     
 __/ ____/___ _/ /___ __  ____  __     __/ /___  ____  ___  _____
 _/ / __/ __ `/ / __ `/ |/_/ / / /  __ _/ / __ \/ __ \/ _ \/ ___/
 / /_/ / /_/ / / /_/ />  </ /_/ /  / /_/ / /_/ / / / /  __(__  ) 
 \____/\__,_/_/\__,_/_/|_|\__, /   \____/\____/_/ /_/\___/____/  
 _____________________________/ 
An Interactive Fiction by Philip Riley
Release 1 / Serial number 230219 / Inform 7 build 6M62 (I6/v6.34 lib 6/12N) SD

Galaxy Jones is in the speeder dock.

>gonear tenth
Galaxy Jones is on the tenth floor.

* * *

>w
Galaxy Jones is at the southwest corner of the Sirius Cybernetics office.

>n
Galaxy Jones is on the west side of the Sirius Cybernetics office.

* * *

>w
Galaxy Jones is at the southwest corner of the Sirius Cybernetics office.

>n
Galaxy Jones is in the west corner of the Sirius Cybernetics office.

>n
Galaxy Jones is in the northwest corner of the Sirius Cybernetics office.

>e
Galaxy Jones is in the north corner of the Sirius Cybernetics office.

>e
Galaxy Jones is in the northeast corner of the Sirius Cybernetics office.

>s
Galaxy Jones is in the east corner of the Sirius Cybernetics office.

>s
Galaxy Jones is in the southeast corner of the Sirius Cybernetics office.

>w
Galaxy Jones is in the south corner of the Sirius Cybernetics office.

* * *

>gonear tenth
Galaxy Jones is on the tenth floor.

>w
Jones can't go that way.

>s
Galaxy Jones is in the offices of Sirius Cybernetics, south.

>w
Galaxy Jones is in the offices of Sirius Cybernetics, southwest.

>m
That's not a verb I recognise.

>n
Galaxy Jones is in the offices of Sirius Cybernetics, west.

>n
Galaxy Jones is in the offices of Sirius Cybernetics, northwest.

>e
Galaxy Jones is in the offices of Sirius Cybernetics, north.

>e
Galaxy Jones is in the offices of Sirius Cybernetics, northeast.

>s
Galaxy Jones is in the offices of Sirius Cybernetics, east.

>s
Galaxy Jones is in the offices of Sirius Cybernetics, southeast.

>w
Galaxy Jones is in the offices of Sirius Cybernetics, south.

* * *

>gonear tenth floor
Galaxy Jones is on the tenth floor.

>s
Galaxy Jones is in Sirius Cybernetics, north.

>showme sirius-1
There seems to be no such object anywhere in the model world.

>showme
Sirius Cybernetics, north - sirius-room
    Jones - person

* * *

>n
Galaxy Jones is in the entry doorway. 

Also here is Entry Door.

>n
(first opening Entry Door)

Galaxy Jones is in the lobby. 

Also here is Entry Door.

I beg your pardon?

>w
Galaxy Jones is on the ground floor.

>n
Galaxy Jones is on the ground floor.

>e
Galaxy Jones is in the elevator room.

>w
Galaxy Jones is on the ground floor.

>n
Jones can't go that way.

* * *

>n
(first opening Entry Door)

Galaxy Jones is in the lobby. 

Also here is Entry Door.

>e
Galaxy Jones is on the ground floor.

>n
Galaxy Jones is on the ground floor.

>w
Galaxy Jones is in the maintenance closet.

* * *

>n
(first opening Entry Door)

Galaxy Jones is in the lobby. 

Also here is Entry Door.

>n
Galaxy Jones is in the elevator banks.

>s
Galaxy Jones is in Lobby. 

Also here is Entry Door.

>w
Galaxy Jones is in Ground Floor.

* * *

>n
Galaxy Jones is in the elevator banks.

>w
Galaxy Jones is in the ground floor elevator shaft.

>n
Jones can't go that way.

>u
Galaxy Jones is in the second floor elevator shaft.

* * *

>u
Galaxy Jones is in the eighth floor elevator shaft.

>u
Galaxy Jones is on the ninth floor elevator shaft.

>e
Galaxy Jones is in the elevator door.

>e
Galaxy Jones is on the ninth floor elevator shaft.

* * *

>w
Galaxy Jones is in the ground floor elevator shaft.

>u
Galaxy Jones is in the second floor elevator shaft.

* * *

>u
Galaxy Jones is in the eighth floor elevator shaft.

>u
Galaxy Jones is in the ninth floor elevator shaft. 

Also here is an elevator door.

>n
Jones can't go that way.

>e
(first opening the elevator door)

Galaxy Jones is in the ninth floor elevator banks. 

Also here is an elevator door.

>n
Galaxy Jones is in the ninth floor north hallway.

>w
Galaxy Jones is in the north end of the Microthings office.

>s
Jones can't go that way.

>e
Galaxy Jones is in the ninth floor north hallway.

>s
Galaxy Jones is in the ninth floor elevator banks. 

Also here is an elevator door.

>w
Galaxy Jones is in the ninth floor elevator shaft. 

Also here is an elevator door.

>e
Galaxy Jones is in the ninth floor elevator banks. 

Also here is an elevator door.

>s
Galaxy Jones is in the ninth floor south hallway.

>w
Galaxy Jones is in the south end of the Microthings office.

* * *

>n
(first opening Entry Door)

Galaxy Jones is in the lobby. 

Also here is Entry Door.

>w
Galaxy Jones is on the ground floor.

* * *

>n
Galaxy Jones is on the ground floor.

>n
Galaxy Jones is on the ground floor.

>e
Galaxy Jones is on the ground floor.

>n
Jones can't go that way.

>e
Jones can't go that way.

* * *

>e
Galaxy Jones is on the ground floor.

>s
Galaxy Jones is in the elevator banks.

>e
Galaxy Jones is in the ground floor stairwell.

>u
Jones can't go that way.

>w
Galaxy Jones is in the elevator banks.

>w
Galaxy Jones is in the ground floor elevator shaft.

* * *

>u
Galaxy Jones is in the ninth floor elevator shaft. 

Also here is an elevator door.

>e
(first opening the elevator door)

Galaxy Jones is on the ninth floor elevator banks. 

Also here is an elevator door.

>n
Jones can't go that way.

>s
Jones can't go that way.

* * *

>w
Galaxy Jones is on the ground floor.

>w
Jones can't go that way.

>n
Galaxy Jones is on the ground floor.

* * *

>e
Galaxy Jones is on the ground floor.

>e
Galaxy Jones is on the ground floor.

>s
Galaxy Jones is on the ground floor.

>s
Galaxy Jones is on the ground floor.

>w
Galaxy Jones is in the lobby. 

Also here is Entry Door.

>n
Galaxy Jones is in the elevator banks.

>n
Jones can't go that way.

* * *

>n
(first opening Entry Door)

Galaxy Jones is in the lobby. 

Also here is Entry Door.

>wn
That's not a verb I recognise.

>n
Galaxy Jones is in the elevator banks.

* * *

>u
Galaxy Jones is in the ninth floor elevator shaft. 

Also here is an elevator door.

>e
(first opening the elevator door)

Galaxy Jones is in the ninth floor elevator banks. 

Also here is an elevator door.

* * *

>e
Galaxy Jones is in the Martian Chronicle office.

>n
Jones can't go that way.

* * *

>n
Galaxy Jones is in the entry doorway. 

Also here is Entry Door.

>w
You can't go that way.

>n
(first opening Entry Door)

Lobby
You can see Entry Door here.

>w
Ground Floor

>n
Ground Floor

>n
You can't go that way.

>s
Ground Floor

>s
You can't go that way.

>ee
That's not a verb I recognise.

>e
Lobby
You can see Entry Door here.

* * *

>x engines
There's nothing like that nearby.

>x turbines
Still hot, the engines cause Jones to recoil from the waves of heat rolling off of them.

* * *

>x galaxy
(the speeder)
Galaxy One is a Dust Runner, a top-of-the-line model from Olympus Speedworks. It's a deep crimson with tinted windows, and powerful turbines on struts that sweep back in severe rearward arcs.

>x jones
As good-looking as ever.

* * *

>x galaxy one
There's nothing like that nearby.

>x speeder
Galaxy One is a Dust Runner, a top-of-the-line model from Olympus Speedworks. It's a deep crimson with tinted windows and powerful turbines on struts that sweep back in severe rearward arcs.

* * *

>x one
Galaxy One is a Dust Runner, a top-of-the-line model from Olympus Speedworks. It's deep crimson with tinted windows, and powerful turbines on struts that sweep back in severe rearward arcs.

* * *

>x speeder
Galaxy One is a Dust Runner, a top-of-the-line model from Olympus Speedworks. It's deep crimson with tinted windows. Powerful turbines adorn the vestigial wings that sweep back in severe rearward arcs.

>enter it
You have a job to do here.

>get in speeder
You have a job to do here.

* * *

>x turbine
There's nothing like that nearby.

>x turbines
Still hot, the engines cause Jones to recoil from the waves of heat rolling off of them.