 _________      __                     _____                     
 __/ ____/___ _/ /___ __  ____  __     __/ /___  ____  ___  _____
 _/ / __/ __ `/ / __ `/ |/_/ / / /  __ _/ / __ \/ __ \/ _ \/ ___/
 / /_/ / /_/ / / /_/ />  </ /_/ /  / /_/ / /_/ / / / /  __(__  ) 
 \____/\__,_/_/\__,_/_/|_|\__, /   \____/\____/_/ /_/\___/____/  
 _____________________________/ 
An Interactive Fiction by Philip Riley
Release 1 / Serial number 230219 / Inform 7 build 6M62 (I6/v6.34 lib 6/12N) SD

Galaxy Jones is in the speeder dock. A safe harbor from the periodic dust storms of Utopia Planitia, the dock features several dozen speeder bays. Only a few are filled right now. The building entryway is to the north, under a red stone façade carved into the likeness of a fearsome Viking.

Jones's speeder, Galaxy One, sits in one of the parking bays.

>i
Jones is carrying:
  a disruptor gun

>x gun
There seems to be nothing special about it.

>n
Jones approaches the Viking Building entryway, the dramatic façade towering over her.

Galaxy Jones is at the entry doorway.

>n
(first opening the entry door)
Jones enters the lobby warily, alert to any defenses.

Galaxy Jones is in the lobby. There is a front desk here.

>n
Galaxy Jones is in the elevator banks.

* * *

>m
That's not a verb I recognise.

>n
Jones approaches the Viking Building entryway, the dramatic façade towering over her.

Galaxy Jones is at the entry doorway.

* * *

>n
(first opening the entry door)
Jones enters the lobby warily, alert to any defenses.

Galaxy Jones is in the lobby. There is a front desk here.

>x art
Before Jones gets a chance to do anything, two robot guards emerge from niches in the back wall! She dives behind the front desk.

>shoot sculpture
(with the disruptor pistol)

>x it
Jones can't see 'it' (nothing) at the moment.

>x art
There's nothing like that nearby.

>x sculpture
You dig through the ruins and come up with a thingy which you take.

Taken.

* * *

>n
Jones approaches the Viking Building entryway, the dramatic façade towering over her.

Galaxy Jones is at the entry doorway.

>n
(first opening the entry door)
Jones enters the lobby warily, alert to any defenses.

Galaxy Jones is in the lobby. The ground floor of the Viking Building is breathtaking. Low-G architecture means more glass and thinner supports, and the building takes advantage of that. Four walls of glass surround a central pillar in which are set the utility rooms and elevators. In between is an expanse of plants, water installations, and stylish seating. Near the entryway is a front desk. Above it floats suspended a giant crystal sculpture.

>e
Before Jones gets a chance to do anything, two robot guards emerge from niches in the back wall!
 _________      __                     _____                     
 __/ ____/___ _/ /___ __  ____  __     __/ /___  ____  ___  _____
 _/ / __/ __ `/ / __ `/ |/_/ / / /  __ _/ / __ \/ __ \/ _ \/ ___/
 / /_/ / /_/ / / /_/ />  </ /_/ /  / /_/ / /_/ / / / /  __(__  ) 
 \____/\__,_/_/\__,_/_/|_|\__, /   \____/\____/_/ /_/\___/____/  
 _____________________________/

* * *

>n
(first opening the entry door)
Jones enters the lobby warily, alert to any defenses.

Galaxy Jones is in the lobby. The ground floor of the Viking Building is breathtaking. Low-G architecture means more glass and thinner supports, and the building takes advantage of that. Four walls of glass surround a central pillar in which are set the utility rooms and elevators. In between is an expanse of plants, water installations, and stylish seating. Near the entryway is a front desk. Above it floats suspended a giant crystal sculpture.

>fire desk
(at the disruptor pistol)
Before Jones gets a chance to do anything, two robot guards emerge from niches in the back wall! She dives behind the front desk and draws her disruptor pistol.

>fire desk
(at the disruptor pistol)
You can't fire the front desk!

The green robot fires a blistering shot into the front desk.

>dire pistol
That's not a verb I recognise.

>fire pistol
(at the disruptor pistol)
Shooting that would accomplish nothing.

The green robot tries to flank Jones, but a shot from her disruptor sends it scurrying back.

>fire pistol at red robot
A barrage of fire from the robots prevents Jones from firing. The green robot fires a blistering shot into the front desk.

>fire pistol at red robot
Oof. Big miss.

* * *

>n
(first opening the entry door)
Jones enters the lobby warily, alert to any defenses.

Galaxy Jones is in the lobby. The ground floor of the Viking Building is breathtaking. Low-G architecture means more glass and thinner supports, and the building takes advantage of that. Four walls of glass surround a central pillar in which are set the utility rooms and elevators. In between is an expanse of plants, water installations, and stylish seating. Near the entryway is a front desk. Above it floats suspended a giant crystal sculpture.

>mn
That's not a verb I recognise.

>n
Before Jones gets a chance to do anything, two robot guards emerge from niches in the back wall! She dives behind the front desk.

* * *

>n
(first opening the entry door)
Jones enters the lobby warily, alert to any defenses.

Galaxy Jones is in the lobby. The ground floor of the Viking Building is breathtaking. Low-G architecture means more glass and thinner supports, and the building takes advantage of that. Four walls of glass surround a central pillar in which are set the utility rooms and elevators. In between is an expanse of plants, water installations, and stylish seating. Near the entryway is a front desk. Above it floats suspended a giant crystal sculpture.

>n
Before Jones gets a chance to do anything, two robot guards emerge from niches in the back wall! She dives behind the front desk and draws her disruptor pistol.

>e
Trying to reach an exit would surely get Jones shot.

>w
Trying to reach an exit would surely get Jones shot.

>s
Trying to reach an exit would surely get Jones shot.

>n
Trying to reach an exit would surely get Jones shot.

>w
Trying to reach an exit would surely get Jones shot.

One of the robots fires directly above your head.

>e
Trying to reach an exit would surely get Jones shot.

One of the robots fires directly above your head.

>shoot robots
There's nothing like that nearby.

* * *

>n
Before Jones gets a chance to do anything, two robot guards emerge from niches in the back wall! She dives behind the front desk and draws her disruptor pistol.

>fire desk at red robot
You can't fire the front desk!

The green robot fires a blistering shot into the front desk.

>fire at the sculpture
(with the disruptor pistol)
Shooting that would accomplish nothing.

Jones fires the disruptor into the sculpture's main support cable, snapping it. The huge crystal blob starts to sag, straining the other cables. In quick succession they break as well, and the whole installation plummets to the ground, right on top of the hapless guard robots.

 _________      __                     _____                     
 __/ ____/___ _/ /___ __  ____  __     __/ /___  ____  ___  _____
 _/ / __/ __ `/ / __ `/ |/_/ / / /  __ _/ / __ \/ __ \/ _ \/ ___/
 / /_/ / /_/ / / /_/ />  </ /_/ /  / /_/ / /_/ / / / /  __(__  ) 
 \____/\__,_/_/\__,_/_/|_|\__, /   \____/\____/_/ /_/\___/____/  
 _____________________________/ 

[Your score has just gone up by one point.]

* * *

>n
Before Jones gets a chance to do anything, two robot guards emerge from niches in the back wall! She dives behind the front desk and draws her disruptor pistol.

>restart
Are you sure you want to restart?

>y
 _________      __                     _____                     
 __/ ____/___ _/ /___ __  ____  __     __/ /___  ____  ___  _____
 _/ / __/ __ `/ / __ `/ |/_/ / / /  __ _/ / __ \/ __ \/ _ \/ ___/
 / /_/ / /_/ / / /_/ />  </ /_/ /  / /_/ / /_/ / / / /  __(__  ) 
 \____/\__,_/_/\__,_/_/|_|\__, /   \____/\____/_/ /_/\___/____/  
 _____________________________/ 
An Interactive Fiction by Philip Riley
Release 1 / Serial number 230219 / Inform 7 build 6M62 (I6/v6.34 lib 6/12N) SD

Galaxy Jones is in the speeder dock. A safe harbor from the periodic dust storms of Utopia Planitia, the dock features several dozen speeder bays. Only a few are filled right now. The building entryway is to the north, under a red stone façade carved into a fearsome Viking.

Jones's speeder, Galaxy One, sits in one of the parking bays.

>scenes
Scene 'Entire Game' playing (for 0 mins now)
(Scene monitoring now switched on. Type "scenes off" to switch it off again.)

>n
Jones approaches the Viking Building entryway, the dramatic façade towering over her.

Galaxy Jones is at the entry doorway.

* * *

>n
(first opening the entry door)
Jones enters the lobby warily, alert to any defenses.

Galaxy Jones is in the lobby. There is a front desk here.

>n
Before Jones gets a chance to do anything, two robot guards emerge from niches in the back wall! She dives behind the front desk.

[Scene 'Lobby Shootout' begins]

* * *

>n
Before Jones gets a chance to do anything, two robot guards emerge from niches in the back wall! She dives behind the front desk and draws her disruptor pistol.

>s
Trying to reach an exit would surely get Jones shot.

>e
Trying to reach an exit would surely get Jones shot.

* * *

>w
Trying to reach an exit would surely get Jones shot.

>mn
That's not a verb I recognise.

>ne
Trying to reach an exit would surely get Jones shot.

* * *

>n
Before Jones gets a chance to do anything, two robot guards emerge from niches in the back wall! She dives behind the front desk and draws her disruptor pistol.

>shoot art
(with the disruptor pistol)
Jones fires the disruptor into the sculpture's main support cable. The huge crystal blob starts to sag, straining the other cables. In quick succession they snap as well, and the whole installation plummets to the ground, right on top of the hapless guard robots.

 _________      __                     _____                     
 __/ ____/___ _/ /___ __  ____  __     __/ /___  ____  ___  _____
 _/ / __/ __ `/ / __ `/ |/_/ / / /  __ _/ / __ \/ __ \/ _ \/ ___/
 / /_/ / /_/ / / /_/ />  </ /_/ /  / /_/ / /_/ / / / /  __(__  ) 
 \____/\__,_/_/\__,_/_/|_|\__, /   \____/\____/_/ /_/\___/____/  
 _____________________________/ 

[Your score has just gone up by one point.]

>undo
lobby
[Previous turn undone.]

>rules
Rules tracing now switched on. Type "rules off" to switch it off again, or "rules all" to include even rules which do not apply.

[Rule "clear LPR rule" applies.]

>shoot art
[Rule "declare everything initially unmentioned rule" applies.]
[Rule "Rule for supplying a missing second noun while shooting" applies.]
(with the disruptor pistol)
[Rule "announce items from multiple object lists rule" applies.]
[Rule "set pronouns from items from multiple object lists rule" applies.]
[Rule "before stage rule" applies.]
[Rule "instead stage rule" applies.]
[Rule "investigate player's awareness before action rule" applies.]
[Rule "player aware of his own actions rule" applies.]
[Rule "check stage rule" applies.]
[Rule "carry out stage rule" applies.]
[Rule "Carry out shooting the giant sculpture with the disruptor pistol" applies.]
Jones fires the disruptor into the sculpture's main support cable. The huge crystal blob starts to sag, straining the other cables. In quick succession they snap as well, and the whole installation plummets to the ground, right on top of the hapless guard robots.

 _________      __                     _____                     
 __/ ____/___ _/ /___ __  ____  __     __/ /___  ____  ___  _____
 _/ / __/ __ `/ / __ `/ |/_/ / / /  __ _/ / __ \/ __ \/ _ \/ ___/
 / /_/ / /_/ / / /_/ />  </ /_/ /  / /_/ / /_/ / / / /  __(__  ) 
 \____/\__,_/_/\__,_/_/|_|\__, /   \____/\____/_/ /_/\___/____/  
 _____________________________/ 
[Rule "after stage rule" applies.]

[Rule "investigate player's awareness after action rule" applies.]
[Rule "report stage rule" applies.]
[Rule "last specific action-processing rule" applies.]
[Rule "A first turn sequence rule" applies.]
[Rule "every turn stage rule" applies.]
[Rule "A last turn sequence rule" applies.]
[Rule "notify score changes rule" applies.]
[Your score has just gone up by one point.]

[Rule "clear LPR rule" applies.]

* * *

>n
Before Jones gets a chance to do anything, two robot guards emerge from niches in the back wall! She dives behind the front desk and draws her disruptor pistol.

>shoot red robot
(with the disruptor pistol)
A robot says, "Destroy Jones" in droning repetition.

* * *

>n
Before Jones gets a chance to do anything, two robot guards emerge from niches in the back wall! She dives behind the front desk and draws her disruptor pistol.

>shoot robot
Which do you mean, the green guard robot or the red guard robot?

>green
(with the disruptor pistol)
Oops, Jones misses.

A robot tries to flank her, but a shot from her disruptor sends it scurrying back.

>shoot robot
Which do you mean, the green guard robot or the red guard robot?

>red
(with the disruptor pistol)
Oops, Jones misses.

* * *

>n
Before Jones gets a chance to do anything, two robot guards emerge from niches in the back wall! She dives behind the front desk and draws her disruptor pistol.

>shoot sculpture
(with the disruptor pistol)
Jones fires the disruptor into the sculpture's main support cable. The huge crystal blob starts to sag, straining the other cables. In quick succession they snap as well, and the whole installation plummets to the ground, right on top of the hapless guard robots.

 _________      __                     _____                     
 __/ ____/___ _/ /___ __  ____  __     __/ /___  ____  ___  _____
 _/ / __/ __ `/ / __ `/ |/_/ / / /  __ _/ / __ \/ __ \/ _ \/ ___/
 / /_/ / /_/ / / /_/ />  </ /_/ /  / /_/ / /_/ / / / /  __(__  ) 
 \____/\__,_/_/\__,_/_/|_|\__, /   \____/\____/_/ /_/\___/____/  
 _____________________________/

>l
Galaxy Jones is in the lobby. There is a front desk here.

Spread across the floor in a tangled ruin are the remains of a giant crystal sculpture and two guard robots.

>x ruin
There seems to be nothing special about it.

* * *

>showme
lobby - room
    smashed sculpture
    wrecked green robot
    wrecked red robot
    building entryway - backdrop
    entry door - open door
    Jones - person
        disruptor pistol
    front desk - pseudocontainer
        note

>l
Galaxy Jones is in the lobby. There is a front desk here.

The remains of a huge sculpture are smashed on the floor here.

Also here are a wrecked green robot and a wrecked red robot.

* * *

>x ruinb
There's nothing like that nearby.

>x ruin
You dig through the ruins and come up with a thingy. Taken.

>x
What do you want to examine?

>i
Jones is carrying:
  a thingy
  a disruptor pistol

>x thingy
There seems to be nothing special about it.

>x pistol
There seems to be nothing special about it.

* * *

>n
Before Jones gets a chance to do anything, two robot guards emerge from niches in the back wall! She dives behind the front desk and draws her disruptor pistol.

>showme
lobby - room
    green guard robot
    red guard robot
    building entryway - backdrop
    entry door - open door
    Jones - person
        disruptor pistol
    front desk - pseudocontainer
        note
    giant sculpture

>x robots
There seems to be nothing special about it.

>x robots
There seems to be nothing special about it.

>x robots
There seems to be nothing special about it.

One of the robots fires directly above your head.

>shoot robot
There's nothing like that nearby.

* * *

>n
Before Jones gets a chance to do anything, two robot guards emerge from niches in the back wall! She dives behind the front desk and draws her disruptor pistol.

>take all from desk
As soon as Jones starts to act, an energy beam zips past her head, forcing her back down behind the desk.

>stand up
But Jones isn't in anything at the moment.

One of the robots fires directly above your head.

>move
(the disruptor pistol)
Nothing obvious happens.

One of the robots fires directly above your head.

>x sculpture
It's a huge crystal abstraction, provocative in its arrogance but evocative of nothing. A typical public installation by the artist Rambutan.

>x me
As good-looking as ever.

One of the robots fires directly above your head.

>x entry
Which do you mean, the building entryway or the entry door?

>door
A glass revolving door emblazoned with the symbol of a Viking kind astride the planet Mars.

>w
Trying to reach an exit would surely get Jones shot.

A robot says, "Destroy Jones" in droning repetition.

* * *

>n
Before Jones gets a chance to do anything, two robot guards emerge from niches in the back wall! She dives behind the front desk and draws her disruptor pistol.

>undo
lobby
[Previous turn undone.]

>x desk
foo

* * *

>n
Before Jones gets a chance to do anything, two robot guards emerge from niches in the back wall! She dives behind the front desk and draws her disruptor pistol.

>x robot
Which do you mean, the green guard robot or the red guard robot?

>red
There seems to be nothing special about it.

* * *

>n
Before Jones gets a chance to do anything, two robot guards emerge from niches in the back wall! She dives behind the front desk and draws her disruptor pistol.

>z
Jones stands around and waits.

>l
Red and green guard robots criss-cross the lobby, stalking Jones.

>x robots
You can't use multiple objects with that verb.

>x red robot
There seems to be nothing special about it.

* * *

>z
Jones stands around and waits.

One of the robots fires directly above her head.

>z
Jones stands around and waits.

A robot says, "Destroy Jones" in droning repetition.

>z
Jones stands around and waits.

One of the robots fires directly above her head.

* * *

>z
Jones stands around and waits.

A robot says, "Destroy Jones" in droning repetition.

>x me
As good-looking as ever.

>x me
As good-looking as ever.

>x me
As good-looking as ever.

A robot says, "Destroy Jones" in droning repetition.

>x me
As good-looking as ever.

A robot says, "Destroy Jones" in droning repetition.

>x me
As good-looking as ever.

>x me
As good-looking as ever.

One of the robots fires directly above Jones's head.

* * *

>n
(first opening the entry door)
Jones enters the lobby warily, alert to any defenses.

Galaxy Jones is in the lobby. The ground floor of the Viking Building is breathtaking. Low-G architecture means more glass and thinner supports, and the building takes advantage of that. Four walls of glass surround a central pillar in which are set the utility rooms and elevators. In between is an expanse of plants, water installations, and stylish seating. Near the entryway is a front desk. Above it floats suspended a giant crystal sculpture.

>shoot desk
(with the disruptor pistol)
Before Jones gets a chance to do anything, two robot guards emerge from niches in the back wall! She dives behind the front desk.

>s
Galaxy Jones is at the entry doorway.

* * *

>n
Jones enters the lobby warily, alert to any defenses.

Galaxy Jones is in the lobby. There is a front desk here.

>n
Galaxy Jones is in the elevator banks.

>n
Galaxy Jones is on the ground floor.

>n
Jones can't go that way.

>n
Jones can't go that way.

* * *

>shoot desk
(with the disruptor pistol)
Before Jones gets a chance to do anything, two robot guards emerge from niches in the back wall! She dives behind the front desk.

>shoot desk
(with the disruptor pistol)

* * *

>n
(first opening the entry door)
Jones enters the lobby warily, alert to any defenses.

Galaxy Jones is in the lobby. The ground floor of the Viking Building is breathtaking. Low-G architecture means more glass and thinner supports, and the building takes advantage of that. Four walls of glass surround a central pillar in which are set the utility rooms and elevators. In between is an expanse of plants, water installations, and stylish seating. Near the entryway is a front desk. Above it floats suspended a giant crystal sculpture.

>take all from desk
note: Before Jones gets a chance to do anything, two robot guards emerge from niches in the back wall! She dives behind the front desk.

ball: Taken.

>undo
lobby
[Previous turn undone.]

>undo
entry doorway
[Previous turn undone.]

>actions
Actions listing on.

>n
[going north]
(first opening the entry door)
[(1) opening the entry door - silently]
[(1) opening the entry door - silently - succeeded]

Jones enters the lobby warily, alert to any defenses.

Galaxy Jones is in the lobby. There is a front desk here.

[going north - succeeded]

>take all from desk
[removing the note from the front desk]
note: Before Jones gets a chance to do anything, two robot guards emerge from niches in the back wall! She dives behind the front desk.

[removing the note from the front desk - failed]
[removing the ball from the front desk]
ball: [(1) taking the ball]
Taken.
[(1) taking the ball - succeeded]
[removing the ball from the front desk - succeeded]

* * *

>n
(first opening the entry door)
Jones enters the lobby warily, alert to any defenses.

Galaxy Jones is in the lobby. The ground floor of the Viking Building is breathtaking. Low-G architecture means more glass and thinner supports, and the building takes advantage of that. Four walls of glass surround a central pillar in which are set the utility rooms and elevators. In between is an expanse of plants, water installations, and stylish seating. Near the entryway is a front desk. Above it floats suspended a giant crystal sculpture.

>x desk
Before Jones gets a chance to do anything, two robot guards emerge from niches in the back wall! She dives behind the front desk.

>shoot sculpture
(with the disruptor pistol)

>l
Galaxy Jones is in the lobby. There is a front desk here.

Spread across the floor in a tangled ruin are the remains of a giant crystal sculpture and two guard robots.

>x ruin
You search some more, but nothing further turns up.

* * *

>x desk
Before Jones gets a chance to do anything, two robot guards emerge from niches in the back wall! She dives behind the front desk.

>take ball
Taken.

>x desk
The front desk is empty.

* * *

>x desk
Before Jones gets a chance to do anything, two robot guards emerge from niches in the back wall! She dives behind the front desk.

>take note
Taken.

>put it in desk
That can't contain things.

>put it on desk
Putting things on the front desk would achieve nothing.

>n
Galaxy Jones is in the elevator banks.

>i
Jones is carrying:
  a sticky note

>x note
The note says "82436".

>drop note
Dropped.

>take note
Taken.

>put note in desk
Jones puts the sticky note into the front desk.

* * *

>take note
Taken.

>x desk
The is a nice desk.

* * *

>n
(first opening the entry door)
Jones enters the lobby warily, alert to any defenses.

Galaxy Jones is in the lobby. The ground floor of the Viking Building is breathtaking. Low-G architecture means more glass and thinner supports, and the building takes advantage of that. Four walls of glass surround a central pillar in which are set the utility rooms and elevators. In between is an expanse of plants, water installations, and stylish seating. Near the entryway is a front desk. Above it floats suspended a giant crystal sculpture.

>x pillar
There's nothing like that nearby.

>x sculpture
Before Jones gets a chance to do anything, two robot guards emerge from niches in the back wall! She dives behind the front desk and draws her disruptor pistol.

>x pistol
There seems to be nothing special about it.

Zip! Disruptor fire scorches a nearby couch.

>fire desk
(with the disruptor pistol)
Shooting that would accomplish nothing.

One of the robots fires directly above Jones's head.

>fire desk with pistol
Shooting that would accomplish nothing.

* * *

>n
(first opening the entry door)
Jones enters the lobby warily, alert to any defenses.

Galaxy Jones is in the lobby. The ground floor of the Viking Building is breathtaking. Low-G architecture means more glass and thinner supports, and the building takes advantage of that. Four walls of glass surround a central pillar in which are set the utility rooms and elevators. In between is an expanse of plants, water installations, and stylish seating. Near the entryway is a front desk. Above it floats suspended a giant crystal sculpture.

>x sculpture
Before Jones gets a chance to do anything, two robot guards emerge from niches in the back wall! She dives behind the front desk and draws her disruptor pistol.

>x robot
Which do you mean, the green guard robot or the red guard robot?

>red
Definitely not a friendly humanoid. More of a spiny killer with a disruptor turret mounted on its head.

>x green
Definitely not a friendly humanoid. More of a spiny killer with a disruptor turret mounted on its head.

A robot intones "Destroy Jones" in droning repetition.

* * *

>x sculpture
Before Jones gets a chance to do anything, two robot guards emerge from niches in the back wall! She dives behind the front desk and draws her disruptor pistol.

>x sculpture
As soon as you start to act, an energy beam zips past your head, forcing you back down behind the desk.

One of the robots fires directly above your head.

* * *

>n
(first opening the entry door)
Jones enters the lobby warily, alert to any defenses.

Galaxy Jones is in the lobby. The ground floor of the Viking Building is breathtaking. Low-G architecture means more glass and thinner supports, and the building takes advantage of that. Four walls of glass surround a central pillar in which are set the utility rooms and elevators. In between is an expanse of plants, water installations, and stylish seating. Near the entryway is a front desk. Above it floats suspended a giant crystal sculpture.

>z
Before Jones gets a chance to do anything, two robot guards emerge from niches in the back wall! She dives behind the front desk and draws her disruptor pistol.

>fire at red robot
(with the disruptor pistol)
A barrage of fire from the robots prevents Jones from firing. The green robot tries to flank her, but a shot from her disruptor sends it scurrying back.

>z
Jones stands around and waits.

One of the robots fires directly above her head.

* * *

>z
Before Jones gets a chance to do anything, two robot guards emerge from niches in the back wall! She dives behind the front desk and draws her disruptor pistol.

>fire at robot
Which do you mean, the green guard robot or the red guard robot?

>red
(with the disruptor pistol)
Oof. Big miss. The green robot fires a blistering shot into the front desk.

>shoot red robot
(with the disruptor pistol)
Oof. Big miss. The two robots coordinate fire over the desk, narrowly missing Jones.

>shoot red robot
(with the disruptor pistol)
A barrage of fire from the robots prevents Jones from firing. The red robot fires a blistering shot into the front desk.

* * *

>z
Before Jones gets a chance to do anything, two robot guards emerge from niches in the back wall! She dives behind the front desk and draws her disruptor pistol.

>l
Red and green guard robots criss-cross the lobby, stalking Jones. One of the robots fires directly above her head.

>l
Red and green guard robots criss-cross the lobby, stalking Jones. One of the robots fires directly above her head.

>l
Red and green guard robots criss-cross the lobby, stalking Jones. The two robots coordinate fire over the desk, narrowly missing her.

>l
Red and green guard robots criss-cross the lobby, stalking Jones. The green robot fires a blistering shot into the front desk.

>z
Jones stands around and waits.

One of the robots fires directly above her head.

>x
(the disruptor pistol)
There seems to be nothing special about it.

Zip! Disruptor fire scorches a nearby couch.

>i
Jones is carrying:
  a disruptor pistol

One of the robots fires directly above her head.

>fire pistol at robot
Which do you mean, the green guard robot or the red guard robot?

>red
Oops, Jones misses.

>fire pistol at desk
The two robots coordinate fire over the desk, narrowly missing Jones.

* * *

>z
Before Jones gets a chance to do anything, two robot guards emerge from niches in the back wall! She dives behind the front desk and draws her disruptor pistol.

>shoot at robot
There's nothing like that nearby.

>shoot robot
Which do you mean, the green guard robot or the red guard robot?

>green
(with the disruptor pistol)
A barrage of fire from the robots prevents Jones from firing. Zip! Disruptor fire scorches a nearby couch.

* * *

>z
Before Jones gets a chance to do anything, two robot guards emerge from niches in the back wall! She dives behind the front desk and draws her disruptor pistol.

>shoot red robot
(with the disruptor pistol)
Oops, Jones misses.

* * *

>z
Before Jones gets a chance to do anything, two robot guards emerge from niches in the back wall! She dives behind the front desk and draws her disruptor pistol.

>shoot robot
Which do you mean, the green guard robot or the red guard robot?

>green
(with the disruptor pistol)

* * *

>z
Before Jones gets a chance to do anything, two robot guards emerge from niches in the back wall! She dives behind the front desk and draws her disruptor pistol.

>shoot sculpture
(with the disruptor pistol)
Jones fires the disruptor into the sculpture's main support cable, snapping it. The huge crystal blob starts to sag, straining the other cables. In quick succession they break as well, and the whole installation plummets to the ground, right on top of the hapless guard robots.

 _________      __                     _____                     
 __/ ____/___ _/ /___ __  ____  __     __/ /___  ____  ___  _____
 _/ / __/ __ `/ / __ `/ |/_/ / / /  __ _/ / __ \/ __ \/ _ \/ ___/
 / /_/ / /_/ / / /_/ />  </ /_/ /  / /_/ / /_/ / / / /  __(__  ) 
 \____/\__,_/_/\__,_/_/|_|\__, /   \____/\____/_/ /_/\___/____/  
 _____________________________/ 

[Your score has just gone up by one point.]

>fire at sculpture
(with the disruptor pistol)
Shooting that would accomplish nothing.

>x sculpture
You dig through the ruins and come up with a thingy.

>i
Jones is carrying:
  a thingy
  a disruptor pistol

* * *

>x sculpture
You dig through the ruins and come up with a thingy.

>undo
lobby
[Previous turn undone.]

>undo
lobby
[Previous turn undone.]

>fire at sculpture
(with the disruptor pistol)
Shooting that would accomplish nothing.

>x it
You dig through the ruins and come up with a thingy.

* * *

>l
Galaxy Jones is in the lobby. There is a front desk here.

Spread across the floor in a tangled ruin are the remains of a giant crystal sculpture and two guard robots.

>take all from desk
Taken.

>i
Jones is carrying:
  a note
  a disruptor pistol

>undo
lobby
[Previous turn undone.]

>actions
Actions listing on.

>take all from desk
[removing the note from the front desk]
[(1) taking the note]
Taken.
[(1) taking the note - succeeded]

[removing the note from the front desk - succeeded]

* * *

>z
Before Jones gets a chance to do anything, two robot guards emerge from niches in the back wall! She dives behind the front desk and draws her disruptor pistol.

>x art
It's a huge crystal abstraction, provocative in its arrogance but evocative of nothing. A typical public installation by the artist Rambutan.

A robot intones "Destroy Jones" in droning repetition.

>z
Jones stands around and waits.

A robot tries to flank her, but a shot from her disruptor sends it scurrying back.

>x ne
Jones sees nothing unexpected in that direction.

A robot intones "Destroy Jones" in droning repetition.

>x me
As good-looking as ever.

* * *

>x me
As good-looking as ever.

One of the robots fires directly above Jones's head.

>x me
As good-looking as ever.

>x me
As good-looking as ever.

A robot intones "Destroy Jones" in droning repetition.

>x me
As good-looking as ever.

A robot tries to flank Jones, but a shot from her disruptor sends it scurrying back.

>e
Trying to reach an exit would surely get Jones shot.

A robot intones "Destroy Jones" in droning repetition.

>x couch
There's nothing like that nearby.

>x sculpture
It's a huge crystal abstraction, provocative in its arrogance but evocative of nothing. A typical public installation by the artist Rambutan.

>shoot it
(with the disruptor pistol)

* * *

>z
Before Jones gets a chance to do anything, two robot guards emerge from niches in the back wall! She dives behind the front desk and draws her disruptor pistol.

>x sculpture
As soon as Jones starts to act, an energy beam zips past her head, forcing her back down behind the desk.

A robot says, "Destroy Jones" in droning repetition.

>x sculpture
As soon as Jones starts to act, an energy beam zips past her head, forcing her back down behind the desk.

>x me
As soon as Jones starts to act, an energy beam zips past her head, forcing her back down behind the desk.

A robot says, "Destroy Jones" in droning repetition.

* * *

>z
Before Jones gets a chance to do anything, two robot guards emerge from niches in the back wall! She dives behind the front desk and draws her disruptor pistol.

>z
Jones stands around and waits.

>z
Jones stands around and waits.

The red robot fires a blistering shot into the front desk.

>z
Jones stands around and waits.

The two robots coordinate fire over the desk, narrowly missing her.

>l
Red and green guard robots criss-cross the lobby, stalking Jones.

>l
Red and green guard robots criss-cross the lobby, stalking Jones.

>l
Red and green guard robots criss-cross the lobby, stalking Jones.

The green robot tries to flank her, but a shot from her disruptor sends it scurrying back.

>l
Red and green guard robots criss-cross the lobby, stalking Jones.

The two robots coordinate fire over the desk, narrowly missing her.

>l
Red and green guard robots criss-cross the lobby, stalking Jones.

>l
Red and green guard robots criss-cross the lobby, stalking Jones.

The red robot tries to flank her, but a shot from her disruptor sends it scurrying back.

* * *

>z
Jones stands around and waits.

The two robots coordinate fire over the desk, narrowly missing her.

>z
Jones stands around and waits.

The green robot tries to flank her, but a shot from her disruptor sends it scurrying back.

>z
Jones stands around and waits.

>z
Jones stands around and waits.

The red robot tries to flank her, but a shot from her disruptor sends it scurrying back.

>z
Jones stands around and waits.

* * *

>z
Jones stands around and waits.

One of the robots fires directly above her head.

>z
Jones stands around and waits.

One of the robots fires directly above her head.

>z
Jones stands around and waits.

A robot intones "Destroy Jones" in droning repetition.

>z
Jones stands around and waits.

* * *

>z
Jones stands around and waits.

One of the robots fires directly above her head.

>l
Galaxy Jones is in the lobby. The ground floor of the Viking Building is breathtaking. Low-G architecture means more glass and thinner supports, and the building takes advantage of that. Four walls of glass surround a central pillar in which are set the utility rooms and elevators. In between is an expanse of plants, water installations, and stylish seating. Near the entryway is a front desk. Above it floats suspended a giant crystal sculpture.

Also here are the green guard robot and the red guard robot.

One of the robots fires directly above Jones's head.

* * *

>n
Jones approaches the Viking Building entryway, the dramatic façade towering over her.

Galaxy Jones is at the entry doorway.

>s
Galaxy Jones is in the speeder dock. A safe harbor from the periodic dust storms of Utopia Planitia, the dock features several dozen speeder bays. Only a few are filled right now. The building entryway is to the north, under a red stone façade carved into a fearsome Viking.

Jones's speeder, Galaxy One, sits in one of the parking bays.

>n
Galaxy Jones is in the entry doorway.

* * *

>n
Jones approaches the Viking Building entryway, the dramatic façade towering over her.

Galaxy Jones is at the entry doorway.

>shoot door
(with the disruptor pistol)
Shooting that would accomplish nothing.

>n
(first opening the entry door)
Jones enters the lobby warily, alert to any defenses.

Galaxy Jones is in the lobby. The ground floor of the Viking Building is breathtaking. Low-G architecture means more glass and thinner supports, and the building takes advantage of that. Four walls of glass surround a central pillar in which are set the utility rooms and elevators. In between is an expanse of plants, water installations, and stylish seating. Near the entryway is a front desk. Above it floats suspended a giant crystal sculpture.

>shoot sculpture
(with the disruptor pistol)
Before Jones gets a chance to do anything, two robot guards emerge from niches in the back wall! She dives behind the front desk and draws her disruptor pistol.

>z
Jones stands around and waits.

A robot intones "Destroy Jones" in droning repetition.

>shoot robot
Which do you mean, the green guard robot or the red guard robot?

>red
(with the disruptor pistol)
Oops, Jones misses.

One of the robots fires directly above her head.

* * *

>scenes
Scene 'Entire Game' playing (for 0 mins now)
(Scene monitoring now switched on. Type "scenes off" to switch it off again.)

* * *

>n
(first opening the entry door)
Jones enters the lobby warily, alert to any defenses.

Galaxy Jones is in the lobby. There is a front desk here.

>n
Before Jones gets a chance to do anything, two robot guards emerge from niches in the back wall! She dives behind the front desk.

* * *

>n
(first opening the entry door)
Jones enters the lobby warily, alert to any defenses.

Galaxy Jones is in the lobby. There is a front desk here.

>z
Before Jones gets a chance to do anything, two robot guards emerge from niches in the back wall! She dives behind the front desk.

[Scene 'Lobby Shootout' begins]

>shoot sculpture
(with the disruptor pistol)
[Scene 'Lobby Shootout' ends]

>showme
lobby - room
    building entryway - backdrop
    entry door - open door
    Jones - person
        disruptor pistol
    front desk - pseudocontainer
        note
    giant sculpture

>x desk
There's not much on the desk other than a note that says "82436".

* * *

>take speeder
Stop being silly.

>take bay
There's nothing like that nearby.

>x bays
Most of the parking bays are unfilled.

>take bays
They're hardly portable.

>x engines
Still hot, the engines cause Jones to recoil from the waves of heat rolling off of them.

* * *

>x
(the speeder)
Galaxy One is a Dust Runner, a top-of-the-line model from Olympus Speedworks. It's deep crimson with tinted windows. Powerful turbines adorn vestigial wings that sweep back in severe rearward arcs.

>enter speeder
You have a job to do here.

>take it
Taken.

>i
Jones is carrying:
  a speeder

* * *

>x
(the speeder)
Galaxy One is a Dust Runner, a top-of-the-line model from Olympus Speedworks. It's deep crimson with tinted windows. Powerful turbines adorn vestigial wings that sweep back in severe rearward arcs.

>x
(the speeder)
Galaxy One is a Dust Runner, a top-of-the-line model from Olympus Speedworks. It's deep crimson with tinted windows. Powerful turbines adorn vestigial wings that sweep back in severe rearward arcs.

* * *

>x engines
The engines cause Jones to recoil from the waves of heat rolling off of them.

>x wings
Not technically necessary as the speeder works via anti-gravity, the blade-like wings nonetheless give the vehicle a certain flair unobtainable by any other means.

>n
Galaxy Jones is in the entry doorway.

>n
(first opening the entry door)

Galaxy Jones is in the lobby. There is a front desk here.

>x desk
There's not much on the desk other than a note that says "82436".

>take note
Taken.

>x desk
The front desk is empty.

* * *

>x one
Galaxy One is a Dust Runner, a top-of-the-line model from Olympus Speedworks. It's deep crimson with tinted windows. Powerful turbines adorn vestigial wings that sweep back in severe rearward arcs.

>n
Galaxy Jones is in the entry doorway.

* * *

>z
Jones stands around and waits.

>n
Jones approaches the Viking Building entryway, the dramatic façade towering over her.

Galaxy Jones is at the entry doorway.

* * *

>z
Before Jones gets a chance to do anything, two robot guards emerge from niches in the back wall! She dives behind the front desk and draws her disruptor pistol.

>l
Red and green guard robots criss-cross the lobby, stalking Jones.A robot intones "Destroy Jones" in droning repetition.