>n
Jones approaches the Viking Building entryway, the dramatic façade towering over her.

>s
Jones slinks back to the speeder dock.

* * *

>s
Beck: "Where you going, Jones?"

Jones: "Settle down or I'll turn this speeder around."

* * *

>s
Beck: "Yawn."

Jones: "Shut up."

* * *

>ask abogut game
There's nothing like that nearby.

>ask about game
(addressing Beck)
Beck: "Well, you can ask about: INTERACTIVE FICTION, COMMANDS, or SCORING."

>ask about interactive fiction
Beck: "According to Wikipedia, 'Interactive fiction, often abbreviated IF, is software simulating environments in which players use text commands to control characters and influence the environment.' In more plain language, in this game you'll explore places, acquire objects, and defeat enemies all by typing commands. For instance, if you found an axe, you would type TAKE AXE to take it, and DROP AXE to drop it again."

You can move around in the world by typing commands like GO NORTH, which can be abbreviated as N. If you need to refresh your memory about your surroundings you can say LOOK, or just L. To see what you're holding, use INVENTORY, or I. You can find out more about that axe from before by typing EXAMINE AXE, or just X AXE."

Of course, any game has limitations, so you can't just enter any old sentence and expect to have it understood. ASK BECK ABOUT COMMANDS for a partial list of commands that will work."

>ask beck about commands
Beck: "I'm not sure what you're asking about, Jones."

* * *

>ask about commands
(addressing Beck)

"Here's a partial list of commands with explanations and/or examples:"
 
 * TAKE: TAKE GOLD COIN
 * DROP: DROP GOLD COIN
 * I: list the player's possessions
 * X: examine something; X GOLD COIN
 * L: look around
 * CLIMB: CLIMB BEANSTALK
 * GET OFF: GET OFF BEANSTALK
 * PUT INTO: PUT GOLD COIN INTO TREASURE CHEST
 * PUSH: PUSH BIG RED BUTTON
 * PUT INTO: PUT GOLD COIN INTO TREASURE CHEST
 
 not to mention POUR, TYPE, OPEN, CLOSE, SHOOT, and a few others you'll have to figure out for yourself.

>glklist
Window 50 (0): pair, no parent (root), stream 27
Window 48 (201): textbuffer, parent is window 50, stream 25
Window 49 (202): textgrid, parent is window 50, stream 26
Stream 27 (0)
Stream 26 (0)
Stream 25 (0)
Stream 21 (0)
Stream 22 (0)

* * *

>ask about credits
(addressing Beck)

"Here are the credits:"

Extensions by:
Standard Rules version 3/120430 by Graham Nelson
Deluxe Doors version 4 by Emily Short
Skeleton Keys by Emily Short
Epistemology version 9 by Eric Eve
Conversation Framework version 11 by Eric Eve
Property Checking version 4 by Emily Short
Gender Options version 3/210331 by Nathanael Nerode

Story by Phil Riley.
Programming by Phil Riley.
Playtesting by Leon Lin, Oliver Matthias, and Jade.
Invaluable inspiration from Laura Taalman.

>ask beck for help
Beck: "Looks like you're managing okay."

* * *

>actions
Actions listing on.

>ask for tomato
[implicit-imploring "tomato"]
[(1) imploring Beck for "tomato"]
[(1) imploring Beck for "tomato" - succeeded]

[implicit-imploring "tomato" - failed]

>tell beck about foo
That's not a verb I recognise.

>show beck the pistol
[showing the disruptor pistol to Beck]
Beck is unimpressed.
[showing the disruptor pistol to Beck - failed the block showing rule]

* * *

>ask about game
(addressing Beck)

Beck: "Well, you can ask about: INTERACTIVE FICTION, COMMANDS, or SCORING."

>ask about interactive fiction
Beck: "According to Wikipedia, 'Interactive fiction, often abbreviated IF, is software simulating environments in which players use text commands to control characters and influence the environment.' In more plain language, in this game you'll explore places, acquire objects, and defeat enemies all by typing commands. For instance, if you found an axe, you would type TAKE AXE to take it, and DROP AXE to drop it again."

You can move around in the world by typing commands like GO NORTH, which can be abbreviated as N. If you need to refresh your memory about your surroundings you can say LOOK, or just L. To see what you're holding, use INVENTORY, or I. You can find out more about that axe from before by typing EXAMINE AXE, or just X AXE."

Of course, any game has limitations, so you can't just enter any old sentence and expect to have it understood. ASK BECK ABOUT COMMANDS for a partial list of commands that will work."

>ask about scoring
Every once in a while you'll get some points for doing something especially great. There are 0 points.

* * *

>ask beck about akljsdf
Beck: "I'm not sure what you're asking about, Jones."

* * *

>ask beck about game
Beck: "Well, you can ask about: INTERACTIVE FICTION, COMMANDS, or SCORING."

>ask about interactive fiction
Beck: "According to Wikipedia, 'Interactive fiction, often abbreviated IF, is software simulating environments in which players use text commands to control characters and influence the environment.' In more plain language, in this game you'll explore places, acquire objects, and defeat enemies all by typing commands. For instance, if you found an axe, you would type TAKE AXE to take it, and DROP AXE to drop it again."

You can move around in the world by typing commands like GO NORTH, which can be abbreviated as N. If you need to refresh your memory about your surroundings you can say LOOK, or just L. To see what you're holding, use INVENTORY, or I. You can find out more about that axe from before by typing EXAMINE AXE, or just X AXE."

Of course, any game has limitations, so you can't just enter any old sentence and expect to have it understood. ASK BECK ABOUT COMMANDS for a partial list of commands that will work."

* * *

>ask beck about me
Beck: "Well, I think you're very nice, Jones."

>ask beck about speeder
Beck: "I keep reminding you, but you still haven't taken it in for yearly maintenance."

>gonear 100th
Galaxy Jones is in the 100th floor elevator hall. The luxury is staggering.  The walls are made of polished black marble, and the floors are covered in plush black carpeting that muffles the sound of footsteps. The ceiling is high and adorned with a crystal chandelier. The elevator doors to the west are gold-plated. Sumptuous living quarters are visible to the north and south.

>n
Galaxy Jones is in the northern corner of the penthouse. This is Thallium's bedroom. Apart from the expansive round bed in the center of the room, notable features include the line of dummies displaying his various suits of clothes, a large vanity table, and the complete lack of mirrors on the ceiling, thankfully. One may leave the room to the southwest, south, and southeast.

>sw
Galaxy Jones is in the western corner of the penthouse. The purpose of this room is unclear. Instead of the black carpet that plagues the rest of the penthouse, the floor is fashioned from a striking polished red granite. Instead of windows, there are walls. Thallium's personal insignia, the ten planets in order overlaid with the motto "Planetas Vincam", is carved into the deep red wood outer wall, and inlaid with ebony. In the center of the room is a thin metal pillar ending in a claw, which looks like it's meant to hold something. Finally, there is something that looks like an electronic eye set into the inner wall. One may leave to the northeast or southeast.

>x pillar
There seems to be nothing special about it.

* * *

>ask beck for asdf
Jones is more than capable of acquiring things by herself.

* * *

>ask beck for asdfa
Jones is more than capable of acquiring things by herself.

* * *

>actions
Actions listing on.

>ask beck for pistol
[requesting Beck for the disruptor pistol]
[requesting Beck for the disruptor pistol - succeeded]

* * *

>ask beck for help
Beck: "Looks like you're managing okay."

>ask beck about speeder
Beck: "I keep reminding you, but you still haven't taken it in for yearly maintenance."

>ask beck about dock
Beck: "Guess everyone went home when Thallium went ape."

>ask beck about game
Beck: "I'm not sure what you're asking about, Jones."

* * *

>ask beck for pistol
Jones is more than capable of acquiring things by herself.

>ask beck for help
Beck: "Looks like you're managing okay."

>n
Jones approaches the Viking Building entryway, the dramatic façade towering over her.

Galaxy Jones is at the entry doorway. A glass revolving door leads into a large open space north of here. The speeder dock is to the south.

Jones peers upwards at the 100 stories of glass and steel. "What do you want to bet Thallium's got Europa all the way at the top?"

Beck: "Oh, no doubt."

>n
Jones takes a deep breath. "I'm going in."

Beck replies, "You got this, Galaxy."

Jones passes through the revolving door and into the lobby, alert to any defenses.

Galaxy Jones is in the lobby. The ground floor of the Viking Building is breathtaking. Low-G architecture means more glass and thinner supports, and the building takes advantage of that. Four walls of glass surround a central pillar in which are set the utility rooms and elevators. In between is an expanse of plants, water features, and stylish seating. Near the entryway is a front desk. A giant crystal sculpture floats above the center of the area, suspended on almost invisible cables. She may go east and west from here, north to the elevators, or south out of the building.

Suddenly two robot guards, green and red, emerge from niches in the back wall! She dives behind the front desk and draws her disruptor pistol.

Jones shouts, "I'm under fire from two ugly robot things!"

Beck responds, "Monitoring your suit radar."

>ask beck for help
Beck: "I dunno, maybe shoot the robots?"

The robots intone "Destroy Jones" in an eerie drone.
Jones: "I could use some ideas here!"

* * *

>ask beck to reset help
Resetting all help messages.

>reset help
Resetting all help messages.

* * *

>gonear 100th
Galaxy Jones is in the 100th floor elevator hall. The luxury is staggering.  The walls are made of polished black marble, and the floors are covered in plush black carpeting that muffles the sound of footsteps. The ceiling is high and adorned with a crystal chandelier. The elevator doors to the west are gold-plated. Sumptuous living quarters are visible to the north and south.

>e
Jones can't go that way.

>s
Galaxy Jones is in the southern corner of the penthouse. This must be Thallium's "treasure room", to go by the obscene display of wealth. The most notable feature is the array of diamonds lining the walls. Everything else here pales in comparison. The penthouse continues to the northwest, north, and northeast.

Thallium seems to speak from all around Jones. "You like diamonds, Jones? Of course you do -- they're a girl's best friend, after all."

Jones snorts, "Sure, Thallium."

>take diamond
Taken.

Thallium giggles. "Oh, I hope you're not disappointed, Jones."

>x it
Jones: "Hmm. This is made of glass."

Thallium: "Poor, sad Jones. But here's the thing. There is a real diamond in there; it's just you'll never find it before the building's defenses flood the whole floor with poisonous gas. Or maybe I'm bluffing. Maybe I'm not. Can you afford to gamble?"

Jones tosses the fake away.

>purloin hammer
[Purloined.]

>smash diamonds
(with the hammer)
Jones commences to smash all of the diamonds. After destroying several dozen fraudulent gems, she finds one that won't break. She takes the real diamond.

Thallium: "Wow, clever solution. Be careful you don't cut yourself."

Jones: "I appreciate your concern."

>nw
Galaxy Jones is in the western corner of the penthouse. The purpose of this room is unclear. Instead of the black carpet that plagues the rest of the penthouse, the floor is fashioned from a striking polished red granite. Instead of windows, there are walls. Thallium's personal insignia, the ten planets in order overlaid with the motto "Planetas Vincam", is carved into the deep red wood outer wall, and inlaid with ebony. In the center of the room is a thin metal pillar ending in a claw, which looks like it's meant to hold something. Finally, there is something that looks like an electronic eye set into the inner wall. One may leave to the northeast or southeast.

>put diamond in claw
As soon as insert the real diamond into the claw, laser beams spring from five emitters on the walls. They hit the diamond and join into a single more powerful beam that strikes the electronic eye on the wall. A sound like a sliding door comes from behind Jones, and she spins around to see the red wall slide down into the floor. It exposes a control panel of sorts, featuring a large red button labeled "Press Me".

>x panel
Jones discovers a secret panel, which when opened exposes a small black button.

>press black button
Somewhere beyond this room comes the sound of something heavy being moved.

>ne
Galaxy Jones is in the northern corner of the penthouse. This is Thallium's bedroom. Apart from the expansive round bed in the center of the room, notable features include the line of dummies displaying his various suits of clothes, a large vanity table, and the complete lack of mirrors on the ceiling, thankfully. One may leave the room to the southwest, south, and southeast.

>s
Galaxy Jones is in the 100th floor elevator hall. The luxury is staggering.  The walls are made of polished black marble, and the floors are covered in plush black carpeting that muffles the sound of footsteps. The ceiling is high and adorned with a crystal chandelier. The elevator doors to the west are gold-plated. Sumptuous living quarters are visible to the north and south. A portion of the eastern wall has slid away to reveal a stunning white marble staircase.

Jones: "Must be the way up to the roof. Beck, you there?"

Beck: "Yep, I'm here, just a bit busy is all. I'll meet you on that roof."

>e
Are you sure you wish to face the evil Admiral Thallium? Are you ready to pass the point of no return?

* * *

>e
Are you sure you wish to face the evil Admiral Thallium? Are you ready to pass the point of no return?

>y
Galaxy Jones is on the roof stairs. Thick slabs of marble lead from the hall to the west to the rooftop door above.

>u
(first opening the roof access door)
Jones opens the door and steps through onto the roof. The door crashes shut, and a lock audibly clicks.
 _________      __                     _____                     
 __/ ____/___ _/ /___ __  ____  __     __/ /___  ____  ___  _____
 _/ / __/ __ `/ / __ `/ |/ / / / /____ _/ / __ \/ __ \/ _ \/ ___/
 / /_/ / /_/ / / /_/ />  </ /_/ / _/ /_/ / /_/ / / / /  __(__  ) 
 \____/\__,_/_/\__,_/_/|_|\__, /  _\____/\____/_/ /_/\___/____/  
 _____________________________/ 

[Your score has just gone up by one point.]

Jones walks out onto the luxurious penthouse roof. Admiral Thallium turns from the railing to face her. He is dressed in an absurd elaboration of a Martian Admiral's uniform. He looks Jones up and down with a lecherous leer. "Ah, Galaxy Jones, as lovely as ever. If it weren't so unbearably cliché I'd ask you to join me in my rise to greatness. But alas, you are too habituated to the smug high of 'goodness'." He sighs dramatically. "We've trodden similar ground before; no need to discuss it further. Although I would challenge any of your various amoureux to conjugate 'tread' correctly.

"Anyway, I guess this is the time where you do something predictably undignified and violent. Before you do I feel I should inform you that your sidearm has been rendered quite ineffective by my personal security field. But do go ahead and try it."

Jones sneers. "I wouldn't give you the satisfaction," she says, looking around. "I see you don't have any of your robot pets up here. How are you going to stop me from rescuing Europa?"

"Oh please, while we're trying things, try that too. I wish you luck breaking the silnium bars of the cage."

"What's silnium?"

"A superstrong material invented here in my Martian Chemical laboratory. We had a press conference for it -- weren't you watching?"

"Couldn't be bothered."

"Oh for frotz sake, Jones, you're so frustrating!"

Thallium turns his back on Jones and stares out over the city.

Galaxy Jones is on the penthouse roof. It is an extravagant and opulent space, designed to showcase Thallium's wealth and power. Much of the rooftop is devoted to an outdoor lounge area, with comfortable seating and a fire pit, centered around a hot tub and flanked by a bar. All around is the city of New Reykjavik, and beyond that the red Martian landscape. Around the entirety of the roof is an electrostatic field designed to keep air in and particulates out. To the north is a large cage, and to the west is a landing pad. Jones can distantly see a woman lying on the floor of the cage. A green and black flyer sits on the landing pad.

Admiral Thallium is sulking.

>d
(first opening the roof access door)
(first unlocking the roof access door)
Jones lacks a key that fits the roof access door.

>w
Thallium trails after Jones.

Um, Jones -- that harlot you're so bent on freeing from captivity is over there. Now get out of the way, I'm trying to escape."

Thallium shoulders past Jones. She attempts to grab his shoulder, but she is thrown back by an unseen force.

Thallium smirks. "Personal security field, remember? Now I must be off."

Jones watches as Thallium boards the flyer. It takes off a moment later.

Galaxy Jones is on the flyer pad. This is what one would expect from a rooftop flyer pad: landing lights surrounding a large letter F painted in white on a red background.

* * *

>gonear 100th
Galaxy Jones is in the 100th floor elevator hall. The luxury is staggering.  The walls are made of polished black marble, and the floors are covered in plush black carpeting that muffles the sound of footsteps. The ceiling is high and adorned with a crystal chandelier. The elevator doors to the west are gold-plated. Sumptuous living quarters are visible to the north and south.

>s
Galaxy Jones is in the southern corner of the penthouse. This must be Thallium's "treasure room", to go by the obscene display of wealth. The most notable feature is the array of diamonds lining the walls. Everything else here pales in comparison. The penthouse continues to the northwest, north, and northeast.

Thallium seems to speak from all around Jones. "You like diamonds, Jones? Of course you do -- they're a girl's best friend, after all."

Jones snorts, "Sure, Thallium."

>ask beck about diamond
Beck: "I'm not sure what you're asking about, Jones."

>take diamond
Taken.

Thallium giggles. "Oh, I hope you're not disappointed, Jones."

>ask beck about diamond
Beck: "How much do you think it's worth?"

>x it
Jones: "Hmm. This is made of glass."

Thallium: "Poor, sad Jones. But here's the thing. There is a real diamond in there; it's just you'll never find it before the building's defenses flood the whole floor with poisonous gas. Or maybe I'm bluffing. Maybe I'm not. Can you afford to gamble?"

Jones tosses the fake away.

>ask beck about diamond
Beck: "Don't get attached to pretty things, Jones."

>purloin hammer
[Purloined.]

* * *

>smash diamonds
(with the hammer)
Jones commences to smash all of the diamonds. After destroying several dozen fraudulent gems, she finds one that won't break. She takes the real diamond.

Thallium: "Wow, clever solution. Be careful you don't cut yourself."

Jones: "I appreciate your concern."

>ask beck about it
Beck: "Ooh pretty."

>ask beck about diamond
(the real diamond)

Beck: "Ooh pretty."

>ask beck about real diamond
Beck: "Ooh pretty."

>i
Jones is carrying:
  a real diamond
  a hammer
  a disruptor pistol

>showme real diamond
real diamond - gem
location: carried by Jones in the southern corner of the penthouse
singular-named, improper-named, unused; unlit, inedible, portable, handled, neuter, unseen, unfamiliar, non-pourable
list grouping key: none
printed name: "real diamond"
printed plural name: "gems"
indefinite article: none
most recent reference: nominal
third singular pronoun: It-pronoun
conversation: none
description: "Maybe 2.5 carats, it's a beautiful gem, if you're into diamonds."
initial appearance: none
third-plural-pronoun: They-pronoun

* * *

>gonear 100th hall
Galaxy Jones is in the 100th floor elevator hall. The luxury is staggering.  The walls are made of polished black marble, and the floors are covered in plush black carpeting that muffles the sound of footsteps. The ceiling is high and adorned with a crystal chandelier. The elevator doors to the west are gold-plated. Sumptuous living quarters are visible to the north and south.

>e
Jones can't go that way.

>n
Galaxy Jones is in the northern corner of the penthouse. This is Thallium's bedroom. Apart from the expansive round bed in the center of the room, notable features include the line of dummies displaying his various suits of clothes, a large vanity table, and the complete lack of mirrors on the ceiling, thankfully. One may leave the room to the southwest, south, and southeast.

>s
Galaxy Jones is in the 100th floor elevator hall. The luxury is staggering.  The walls are made of polished black marble, and the floors are covered in plush black carpeting that muffles the sound of footsteps. The ceiling is high and adorned with a crystal chandelier. The elevator doors to the west are gold-plated. Sumptuous living quarters are visible to the north and south.

>s
Galaxy Jones is in the southern corner of the penthouse. This must be Thallium's "treasure room", to go by the obscene display of wealth. The most notable feature is the array of diamonds lining the walls. Everything else here pales in comparison. The penthouse continues to the northwest, north, and northeast.

Thallium seems to speak from all around Jones. "You like diamonds, Jones? Of course you do -- they're a girl's best friend, after all."

Jones snorts, "Sure, Thallium."

>x diamonds
So many of them, from the tiny to the obscenely large. It looks like it wouldn't be hard to pry one out.

>x diamond
So many of them, from the tiny to the obscenely large. It looks like it wouldn't be hard to pry one out.

>take diamond
Taken.

Thallium giggles. "Oh, I hope you're not disappointed, Jones."

>pry diamond
(the diamond)
That can't be pried out.

>x diamond
(the diamond)

Jones: "Hmm. This is made of glass."

Thallium: "Poor, sad Jones. But here's the thing. There is a real diamond in there; it's just you'll never find it before the building's defenses flood the whole floor with poisonous gas. Or maybe I'm bluffing. Maybe I'm not. Can you afford to gamble?"

Jones tosses the fake away.

>undo
Galaxy Jones is in the southern corner of the penthouse.
[Previous turn undone.]

>x diamonds
(the diamond)

Jones: "Hmm. This is made of glass."

Thallium: "Poor, sad Jones. But here's the thing. There is a real diamond in there; it's just you'll never find it before the building's defenses flood the whole floor with poisonous gas. Or maybe I'm bluffing. Maybe I'm not. Can you afford to gamble?"

Jones tosses the fake away.

>x diamond
So many of them, from the tiny to the obscenely large. It looks like it wouldn't be hard to pry one out.

>purloin hammer
[Purloined.]

* * *

>smash diamonds
(with the hammer)
Jones commences to smash all of the diamonds. After destroying several dozen fraudulent gems, she finds one that won't break. She takes the real diamond.

Thallium: "Wow, clever solution. Be careful you don't cut yourself."

Jones: "I appreciate your concern."

>se
Jones can't go that way.

>nw
Galaxy Jones is in the western corner of the penthouse. The purpose of this room is unclear. Instead of the black carpet that plagues the rest of the penthouse, the floor is fashioned from a striking polished red granite. Instead of windows, there are walls. Thallium's personal insignia, the ten planets in order overlaid with the motto "Planetas Vincam", is carved into the deep red wood outer wall, and inlaid with ebony. In the center of the room is a thin metal pillar ending in a claw, which looks like it's meant to hold something. Finally, there is something that looks like an electronic eye set into the inner wall. One may leave to the northeast or southeast.

>put pistol in claw
That won't fit in the claw.

>put diamond in claw
As soon as insert the real diamond into the claw, laser beams spring from five emitters on the walls. They hit the diamond and join into a single more powerful beam that strikes the electronic eye on the wall. A sound like a sliding door comes from behind Jones, and she spins around to see the red wall slide down into the floor. It exposes a control panel of sorts, featuring a large red button labeled "Press Me".

* * *

>press black button
Somewhere beyond this room comes the sound of something heavy being moved.

>e
Jones can't go that way.

>ne
Galaxy Jones is in the northern corner of the penthouse. This is Thallium's bedroom. Apart from the expansive round bed in the center of the room, notable features include the line of dummies displaying his various suits of clothes, a large vanity table, and the complete lack of mirrors on the ceiling, thankfully. One may leave the room to the southwest, south, and southeast.

* * *

>e
Galaxy Jones is on the roof stairs. Thick slabs of marble lead from the hall to the west to the rooftop door above.

>u
(first opening the roof access door)
Jones opens the door and steps through onto the roof. The door crashes shut, and a lock audibly clicks.
 _________      __                     _____                     
 __/ ____/___ _/ /___ __  ____  __     __/ /___  ____  ___  _____
 _/ / __/ __ `/ / __ `/ |/ / / / /____ _/ / __ \/ __ \/ _ \/ ___/
 / /_/ / /_/ / / /_/ />  </ /_/ / _/ /_/ / /_/ / / / /  __(__  ) 
 \____/\__,_/_/\__,_/_/|_|\__, /  _\____/\____/_/ /_/\___/____/  
 _____________________________/ 

[Your score has just gone up by one point.]

Jones walks out onto the luxurious penthouse roof. Admiral Thallium turns from the railing to face her. He is dressed in an absurd elaboration of a Martian Admiral's uniform. He looks Jones up and down with a lecherous leer. "Ah, Galaxy Jones, as lovely as ever. If it weren't so unbearably cliché I'd ask you to join me in my rise to greatness. But alas, you are too habituated to the smug high of 'goodness'." He sighs dramatically. "We've trodden similar ground before; no need to discuss it further. Although I would challenge any of your various amoureux to conjugate 'tread' correctly.

"Anyway, I guess this is the time where you do something predictably undignified and violent. Before you do I feel I should inform you that your sidearm has been rendered quite ineffective by my personal security field. But do go ahead and try it."

Jones sneers. "I wouldn't give you the satisfaction," she says, looking around. "I see you don't have any of your robot pets up here. How are you going to stop me from rescuing Europa?"

"Oh please, while we're trying things, try that too. I wish you luck breaking the silnium bars of the cage."

"What's silnium?"

"A superstrong material invented here in my Martian Chemical laboratory. We had a press conference for it -- weren't you watching?"

"Couldn't be bothered."

"Oh for frotz sake, Jones, you're so frustrating!"

Thallium turns his back on Jones and stares out over the city.

Galaxy Jones is on the penthouse roof. It is an extravagant and opulent space, designed to showcase Thallium's wealth and power. Much of the rooftop is devoted to an outdoor lounge area, with comfortable seating and a fire pit, centered around a hot tub and flanked by a bar. All around is the city of New Reykjavik, and beyond that the red Martian landscape. Around the entirety of the roof is an electrostatic field designed to keep air in and particulates out. To the north is a large cage, and to the west is a landing pad. Jones can distantly see a woman lying on the floor of the cage. A green and black flyer sits on the landing pad.

Admiral Thallium is sulking.

* * *

>smash diamonds
(with the hammer)
Jones commences to smash all of the diamonds. After destroying several dozen fraudulent gems, she finds one that won't break. She takes the real diamond.

Thallium: "Wow, clever solution. Be careful you don't cut yourself."

Jones: "I appreciate your concern."

>smash diamonds
(with the hammer)
Whoa, that's enough.

>undo
Galaxy Jones is in the southern corner of the penthouse.
[Previous turn undone.]

>undo
Galaxy Jones is in the southern corner of the penthouse.
[Previous turn undone.]

>l
Galaxy Jones is in the southern corner of the penthouse. This must be Thallium's "treasure room", to go by the obscene display of wealth. The most notable feature is the array of diamonds lining the walls. Everything else here pales in comparison. The penthouse continues to the northwest, north, and northeast.

>i
Jones is carrying:
  a hammer
  a disruptor pistol

>hit diamonds with pistol
That doesn't accomplish much.

>actions
Actions listing on.

>hit diamonds with pistol
[attacking the real diamond with the disruptor pistol]
Violence isn't the answer to this one.
[attacking the real diamond with the disruptor pistol - failed the Check attacking something with something]

* * *

>hit diamonds with pistol
That doesn't accomplish much.

>hit diamonds
(with the hammer)
Jones commences to smash all of the diamonds. After destroying several dozen fraudulent gems, she finds one that won't break. She takes the real diamond.

Thallium: "Wow, clever solution. Be careful you don't cut yourself."

Jones: "I appreciate your concern."

* * *

>gonear air
(the air handling room)
Galaxy Jones is in the air handling room. There is a good number of loud fans and other air handling machinery here. A small hinged vent opening leads into some ductwork, and from there to the outside. A door leads west.

>e
The atmosphere is too thin out there. Jones needs protective gear.

>purloin atmo
[Purloined.]

>e
Jones puts on the Atmo-Suit.

The scaffold is not at this floor.

>gonear scaffold
Which do you mean, the window washing scaffold, the scaffold control panel, the scaffold up button, or the scaffold down button?

>window
Galaxy Jones is on a window washing scaffold. It's lined up with the eighth floor window. There doesn't seem to be any way to get into the building here. Mounted on the scaffold is a control panel with two buttons: one indicating up and one indicating down.

>push up
(the scaffold up button)
Jones presses the button, and the scaffold begins to rise.

Galaxy Jones is on a window washing scaffold. It's lined up with the ninth floor window. She could climb back into the building through the window here. Mounted on the scaffold is a control panel with two buttons: one indicating up and one indicating down.

Jones: "Beck?"

Beck: "Yes?"

Jones: "I hate it out here."

Beck: "Well, there's the open window right next to you."

>push up
(the scaffold up button)
Jones presses the button, and the scaffold begins to rise.

Galaxy Jones is on a window washing scaffold. It's lined up with the tenth floor. Instead of a window, there's what appears to be an exhaust vent. If it's for forced air, though, the fan is currently not running. Mounted on the scaffold is a control panel with two buttons: one indicating up and one indicating down.

Jones: "Alright, I'm by the tenth floor now. What's this grill thing here?"

Beck: "That's an exhaust vent. There's an air handling room on this floor which it leads into. If you can get the cover off you should be able to access the whole floor from here."

>gonear rir
There seems to be no such object anywhere in the model world.

>gonear air
(the air handling room)
Galaxy Jones is in the air handling room. There is a good number of loud fans and other air handling machinery here. A small hinged vent opening leads into some ductwork, and from there to the outside. A door leads west.

>e
Jones's already wearing that!

Galaxy Jones is on a window washing scaffold. It's lined up with the tenth floor. Instead of a window, there's what appears to be an exhaust vent. If it's for forced air, though, the fan is currently not running. Mounted on the scaffold is a control panel with two buttons: one indicating up and one indicating down.

>w
That's not something Jones can enter.

>gonear air
(the air handling room)
Galaxy Jones is in the air handling room. There is a good number of loud fans and other air handling machinery here. A small hinged vent opening leads into some ductwork, and from there to the outside. A door leads west.

>i
Jones is carrying:
  an Atmo-Suit
  a disruptor pistol

* * *

>gonear air
(the air handling room)
Galaxy Jones is in the air handling room. There is a good number of loud fans and other air handling machinery here. A small hinged vent opening leads into some ductwork, and from there to the outside. A door leads west.

>purloin gel
(the bottle of Electrofil quick-setting conductive polymer gel)
[Purloined.]

>w
(first opening the air handling door)

Galaxy Jones is on the north side of the Consolidated Microthings office. This is the company cafeteria. The elevator is south, the air handling room is to the east, and the office continues to the west and southeast.

>s
Galaxy Jones is in the tenth floor elevator hall. The elevator car to the west stands open. There is a stairwell to the east. The hall runs north and south into a sumptuous corporate office.

>s
Galaxy Jones is on the south side of the Consolidated Microthings office. This is reception. It has a great view of the New Reykjavik Botanic Dome. Couches are lined up to take advantage. The floor east and west, and north to the elevator

Jones sees the mauve guard robot to the west.

>n
Galaxy Jones is in the tenth floor elevator hall. The elevator car to the west stands open. There is a stairwell to the east. The hall runs north and south into a sumptuous corporate office.

The mauve guard robot appears to the south, coming from the west.

>w
Galaxy Jones is in the elevator car. It's luxurious, with gold-plated walls and crystal lighting on the ceiling. The button panel is lacquered dark mahogany with what looks like real ivory buttons. The carpeting is soft and plush. A golden keyhole sits above the buttons.

One of the ceiling panels looks loose.

Admiral Thallium's voice oozes from concealed speakers: "Yes, Jones, that is real ivory. I imported the elephant here myself for a hunt on my estate. You have no idea how much money it takes to simulate an African jungle on Mars. In retrospect I should have gotten an Indian elephant."

The mauve guard robot appears to the east, coming from the south.

>u
Jones can't go that way.

The mauve guard robot approaches from the east.

The robot slaughters Jones.

    *** The End ***

In that game you scored 0 out of a possible 0, in 7 turns.

Would you like to RESTART, RESTORE a saved game, QUIT, or UNDO the last command?

* * *

>gonear air
(the air handling room)
Galaxy Jones is in the air handling room. There is a good number of loud fans and other air handling machinery here. A small hinged vent opening leads into some ductwork, and from there to the outside. A door leads west.

>w
(first opening the air handling door)

Galaxy Jones is on the north side of the Consolidated Microthings office. This is the company cafeteria. The elevator is south, the air handling room is to the east, and the office continues to the west and southeast.

* * *

>s
Galaxy Jones is in the tenth floor elevator hall. The elevator car to the west stands open. There is a stairwell to the east. The hall runs north and south into a sumptuous corporate office.

>w
Galaxy Jones is in the elevator car. It's luxurious, with gold-plated walls and crystal lighting on the ceiling. The button panel is lacquered dark mahogany with what looks like real ivory buttons. The carpeting is soft and plush. A golden keyhole sits above the buttons.

One of the ceiling panels looks loose.

Admiral Thallium's voice oozes from concealed speakers: "Yes, Jones, that is real ivory. I imported the elephant here myself for a hunt on my estate. You have no idea how much money it takes to simulate an African jungle on Mars. In retrospect I should have gotten an Indian elephant."

>take panel
(the ceiling panel)
Jones removes the ceiling panel, exposing a hole wide enough for her to climb through.

>e
Galaxy Jones is in the tenth floor elevator hall. The elevator car to the west stands open. There is a stairwell to the east. The hall runs north and south into a sumptuous corporate office.

>s
Galaxy Jones is on the south side of the Consolidated Microthings office. This is reception. It has a great view of the New Reykjavik Botanic Dome. Couches are lined up to take advantage. The floor east and west, and north to the elevator

Jones sees the mauve guard robot to the west.

* * *

>n
Galaxy Jones is in the tenth floor elevator hall. The elevator car to the west stands open. There is a stairwell to the east. The hall runs north and south into a sumptuous corporate office.

The mauve guard robot appears to the south, coming from the west.

>w
Galaxy Jones is in the elevator car. It's luxurious, with gold-plated walls and crystal lighting on the ceiling. The button panel is lacquered dark mahogany with what looks like real ivory buttons. The carpeting is soft and plush. A golden keyhole sits above the buttons.

The mauve guard robot appears to the east, coming from the south.

>u
Galaxy Jones is on the top of the elevator car. The elevator shaft extends many hundreds of feet above here. Jones can see down into the elevator car from here.

The mauve guard robot enters the elevator car below.

>jump on guard
Jones drops down through the ceiling and on to the guard robot. It swings around looking for her, obviously panicked that it can't bring its gun to bear on its attacker. Jones manages to hang on.

The mauve guard robot struggles against her hold on it, to no avail.

>pour gel on guard
There's nothing like that nearby.

>purloin gel
(the bottle of Electrofil quick-setting conductive polymer gel)
[Purloined.]

>pour gel on guard
Jones pours the gel into the vent on the robot's head. The robot flails around wildly and throws her from its back, then lets out a loud crackling sound and stops moving.
 _________      __                     _____                     
 __/ ____/___ _/ /___ __  ____  __     __/ /___  ____  ___  _____
 _/ / __/ __ `/ / __ `/ |/ / / / /____ _/ / __ \/ __ \/ _ \/ ___/
 / /_/ / /_/ / / /_/ />  </ /_/ / _/ /_/ / /_/ / / / /  __(__  ) 
 \____/\__,_/_/\__,_/_/|_|\__, /  _\____/\____/_/ /_/\___/____/  
 _____________________________/ 

[Your score has just gone up by one point.]

Galaxy Jones is in the elevator car. It's luxurious, with gold-plated walls and crystal lighting on the ceiling. The button panel is lacquered dark mahogany with what looks like real ivory buttons. The carpeting is soft and plush. A golden keyhole sits above the buttons.

The remains of the mauve guard robot are sprawled on the ground.

* * *

>gonear air
(the air handling room)
Galaxy Jones is in the air handling room. There is a good number of loud fans and other air handling machinery here. A small hinged vent opening leads into some ductwork, and from there to the outside. A door leads west.

>se
Jones can't go that way.

>s
Jones can't go that way.

>w
(first opening the air handling door)

Galaxy Jones is on the north side of the Consolidated Microthings office. This is the company cafeteria. The elevator is south, the air handling room is to the east, and the office continues to the west and southeast.

>se
Galaxy Jones is on the east side of the Consolidated Microthings office. This part of the office is currently unused. Jones can go northwest or south from here.

>s
Galaxy Jones is at the southeast corner of the Consolidated Microthings office. This corner of the floor contains the gym and other company amenities. Reception is to the west, and an empty area lies to the north.

Jones sees the mauve guard robot to the west.

>sneak up on robot
You can't reach the mauve guard robot.

To the west, the mauve guard robot heads east.

* * *

>s
Galaxy Jones is on the south side of the Consolidated Microthings office. This is reception. It has a great view of the New Reykjavik Botanic Dome. Couches are lined up to take advantage. The floor east and west, and north to the elevator

Jones sees the mauve guard robot to the west.

>e
Galaxy Jones is at the southeast corner of the Consolidated Microthings office. This corner of the floor contains the gym and other company amenities. Reception is to the west, and an empty area lies to the north.

To the west, the mauve guard robot heads east.

>n
Galaxy Jones is on the east side of the Consolidated Microthings office. This part of the office is currently unused. Jones can go northwest or south from here.

The mauve guard robot appears to the south, coming from the west.

>nw
Galaxy Jones is on the north side of the Consolidated Microthings office. This is the company cafeteria. The elevator is south, the air handling room is to the east, and the office continues to the west and southeast.

The mauve guard robot appears to the southeast, coming from the south.

>w
Galaxy Jones is at the northwest corner of the Consolidated Microthings office. Various executive offices line the north and west walls here. Jones can go east or south.

The mauve guard robot appears to the east, coming from the southeast.

Beck: "I don't think I like Thallium's choice of friends much."

>s
Galaxy Jones is on the west side of the Consolidated Microthings office. This ocean of desks looks out toward the Utopia Tower, twice the height of the Viking Building, where Jones is now. One can go north or south.

The mauve guard robot appears to the north, coming from the east.

>s
Galaxy Jones is at the southwest corner of the Consolidated Microthings office. This looks like the IT area of the office. Numerous desks and an abundance of computer parts are here. Jones can go north or east from here.

There is a present with a note attached sitting on a desk here.

To the north, the mauve guard robot heads south.

>e
Galaxy Jones is on the south side of the Consolidated Microthings office. This is reception. It has a great view of the New Reykjavik Botanic Dome. Couches are lined up to take advantage. The floor east and west, and north to the elevator

The mauve guard robot appears to the west, coming from the north.

>e
Galaxy Jones is at the southeast corner of the Consolidated Microthings office. This corner of the floor contains the gym and other company amenities. Reception is to the west, and an empty area lies to the north.

To the west, the mauve guard robot heads east.

* * *

>n
Galaxy Jones is on the east side of the Consolidated Microthings office. This part of the office is currently unused. Jones can go northwest or south from here.

The mauve guard robot appears to the south, coming from the west.

>nw
Galaxy Jones is on the north side of the Consolidated Microthings office. This is the company cafeteria. The elevator is south, the air handling room is to the east, and the office continues to the west and southeast.

The mauve guard robot appears to the southeast, coming from the south.

Beck: "I've seen more intimidating kitchen appliances!"

>w
Galaxy Jones is at the northwest corner of the Consolidated Microthings office. Various executive offices line the north and west walls here. Jones can go east or south.

The mauve guard robot appears to the east, coming from the southeast.

Beck: "I hope you have a warranty, because you're about to be seriously damaged!"

Jones: "Really, Beck? Is this your best material?"

>s
Galaxy Jones is on the west side of the Consolidated Microthings office. This ocean of desks looks out toward the Utopia Tower, twice the height of the Viking Building, where Jones is now. One can go north or south.

The mauve guard robot appears to the north, coming from the east.

* * *

>e
Galaxy Jones is on the south side of the Consolidated Microthings office. This is reception. It has a great view of the New Reykjavik Botanic Dome. Couches are lined up to take advantage. The floor east and west, and north to the elevator

The mauve guard robot appears to the west, coming from the north.

>n
Galaxy Jones is in the tenth floor elevator hall. The elevator car to the west stands open. There is a stairwell to the east. The hall runs north and south into a sumptuous corporate office.

The mauve guard robot appears to the south, coming from the west.

Beck: "I hope you have a warranty, because you're about to be seriously damaged!"

Jones: "Really, Beck? Is this your best material?"

>n
Galaxy Jones is on the north side of the Consolidated Microthings office. This is the company cafeteria. The elevator is south, the air handling room is to the east, and the office continues to the west and southeast.

To the south, the mauve guard robot heads north.

>e
Galaxy Jones is in the air handling room. There is a good number of loud fans and other air handling machinery here. A small hinged vent opening leads into some ductwork, and from there to the outside. A door leads west.

>z
Jones stands around and waits.

>z
Jones stands around and waits.

>w
Galaxy Jones is on the north side of the Consolidated Microthings office. This is the company cafeteria. The elevator is south, the air handling room is to the east, and the office continues to the west and southeast.

>s
Galaxy Jones is in the tenth floor elevator hall. The elevator car to the west stands open. There is a stairwell to the east. The hall runs north and south into a sumptuous corporate office.

>s
Galaxy Jones is on the south side of the Consolidated Microthings office. This is reception. It has a great view of the New Reykjavik Botanic Dome. Couches are lined up to take advantage. The floor east and west, and north to the elevator

Beck: "If I only had a heart, indeed."

Jones sees the mauve guard robot to the west.

>e
Galaxy Jones is at the southeast corner of the Consolidated Microthings office. This corner of the floor contains the gym and other company amenities. Reception is to the west, and an empty area lies to the north.

To the west, the mauve guard robot heads east.

* * *

>nw
Galaxy Jones is on the north side of the Consolidated Microthings office. This is the company cafeteria. The elevator is south, the air handling room is to the east, and the office continues to the west and southeast.

The mauve guard robot appears to the southeast, coming from the south.

>w
Galaxy Jones is at the northwest corner of the Consolidated Microthings office. Various executive offices line the north and west walls here. Jones can go east or south.

The mauve guard robot appears to the east, coming from the southeast.

Beck: "Come and get us, ugly!"

Jones: "'Us'? Seems like I'm the only one with her life on the line."

>s
Galaxy Jones is on the west side of the Consolidated Microthings office. This ocean of desks looks out toward the Utopia Tower, twice the height of the Viking Building, where Jones is now. One can go north or south.

The mauve guard robot appears to the north, coming from the east.

Beck: "You're programmed to kill, but I'm programmed to kick your metallic ass!"

Jones: "Ah, the bravery of being out of range."

>s
Galaxy Jones is at the southwest corner of the Consolidated Microthings office. This looks like the IT area of the office. Numerous desks and an abundance of computer parts are here. Jones can go north or east from here.

There is a present with a note attached sitting on a desk here.

To the north, the mauve guard robot heads south.

* * *

>nw
Galaxy Jones is on the north side of the Consolidated Microthings office. This is the company cafeteria. The elevator is south, the air handling room is to the east, and the office continues to the west and southeast.

The mauve guard robot appears to the southeast, coming from the south.

>w
Galaxy Jones is at the northwest corner of the Consolidated Microthings office. Various executive offices line the north and west walls here. Jones can go east or south.

The mauve guard robot appears to the east, coming from the southeast.

>s
Galaxy Jones is on the west side of the Consolidated Microthings office. This ocean of desks looks out toward the Utopia Tower, twice the height of the Viking Building, where Jones is now. One can go north or south.

The mauve guard robot appears to the north, coming from the east.

* * *

>e
Galaxy Jones is on the south side of the Consolidated Microthings office. This is reception. It has a great view of the New Reykjavik Botanic Dome. Couches are lined up to take advantage. The floor east and west, and north to the elevator

The mauve guard robot appears to the west, coming from the north.

>n
Galaxy Jones is in the tenth floor elevator hall. The elevator car to the west stands open. There is a stairwell to the east. The hall runs north and south into a sumptuous corporate office.

The mauve guard robot appears to the south, coming from the west.

>nw
Jones can't go that way.

The mauve guard robot approaches from the south.

The robot electrocutes Jones with its electro-darts.

    *** Jones was killed by the mauve guard robot ***

In that game you scored 0 out of a possible 10, in 37 turns.

Would you like to RESTART, RESTORE a saved game, QUIT, or UNDO the last command?

>undo
Galaxy Jones is in the tenth floor elevator hall.
[Previous turn undone.]

>n
Galaxy Jones is on the north side of the Consolidated Microthings office. This is the company cafeteria. The elevator is south, the air handling room is to the east, and the office continues to the west and southeast.

To the south, the mauve guard robot heads north.

>w
Galaxy Jones is at the northwest corner of the Consolidated Microthings office. Various executive offices line the north and west walls here. Jones can go east or south.

The mauve guard robot appears to the east, coming from the south.

Beck: "That's one ugly dude."

Jones: "I don't want to meet it up close."

>s
Galaxy Jones is on the west side of the Consolidated Microthings office. This ocean of desks looks out toward the Utopia Tower, twice the height of the Viking Building, where Jones is now. One can go north or south.

The mauve guard robot appears to the north, coming from the east.

* * *

>e
Galaxy Jones is in the tenth floor elevator hall. The elevator car to the west stands open. There is a stairwell to the east. The hall runs north and south into a sumptuous corporate office.

* * *

>open panel
(the ceiling panel)
Jones removes the ceiling panel, exposing a hole wide enough for her to climb through.

>e
Galaxy Jones is in the tenth floor elevator hall. The elevator car to the west stands open. There is a stairwell to the east. The hall runs north and south into a sumptuous corporate office.

* * *

>u
Galaxy Jones is on the top of the elevator car. The elevator shaft extends many hundreds of feet above here. Jones can see down into the elevator car from here.

The mauve guard robot enters the elevator car below.

>purloin gel
(the bottle of Electrofil quick-setting conductive polymer gel)
[Purloined.]

>d
Galaxy Jones is in the elevator car. It's luxurious, with gold-plated walls and crystal lighting on the ceiling. The button panel is lacquered dark mahogany with what looks like real ivory buttons. The carpeting is soft and plush. A golden keyhole sits above the buttons.

The robot slaughters Jones.

    *** Jones was killed by the mauve guard robot ***

In that game you scored 0 out of a possible 0, in 11 turns.

Would you like to RESTART, RESTORE a saved game, QUIT, or UNDO the last command?

>undo
Galaxy Jones is on the top of the elevator car.
[Previous turn undone.]

>jump on robot
Jones drops down through the ceiling and on to the guard robot. It swings around looking for her, obviously panicked that it can't bring its gun to bear on its attacker. Jones manages to hang on.

The mauve guard robot struggles against her hold on it, to no avail.

>put gel in robot
Jones pours the gel into the vent on the robot's head. The robot flails around wildly and throws her from its back, then lets out a loud crackling sound and stops moving.
 _________      __                     _____                     
 __/ ____/___ _/ /___ __  ____  __     __/ /___  ____  ___  _____
 _/ / __/ __ `/ / __ `/ |/ / / / /____ _/ / __ \/ __ \/ _ \/ ___/
 / /_/ / /_/ / / /_/ />  </ /_/ / _/ /_/ / /_/ / / / /  __(__  ) 
 \____/\__,_/_/\__,_/_/|_|\__, /  _\____/\____/_/ /_/\___/____/  
 _____________________________/ 

[Your score has just gone up by one point.]

Galaxy Jones is in the elevator car. It's luxurious, with gold-plated walls and crystal lighting on the ceiling. The button panel is lacquered dark mahogany with what looks like real ivory buttons. The carpeting is soft and plush. A golden keyhole sits above the buttons.

The remains of the mauve guard robot are sprawled on the ground.

>undo
Galaxy Jones is in the elevator car.
[Previous turn undone.]

>put gel into vent
Jones pours the gel into the vent on the robot's head. The robot flails around wildly and throws her from its back, then lets out a loud crackling sound and stops moving.
 _________      __                     _____                     
 __/ ____/___ _/ /___ __  ____  __     __/ /___  ____  ___  _____
 _/ / __/ __ `/ / __ `/ |/ / / / /____ _/ / __ \/ __ \/ _ \/ ___/
 / /_/ / /_/ / / /_/ />  </ /_/ / _/ /_/ / /_/ / / / /  __(__  ) 
 \____/\__,_/_/\__,_/_/|_|\__, /  _\____/\____/_/ /_/\___/____/  
 _____________________________/ 

[Your score has just gone up by one point.]

Galaxy Jones is in the elevator car. It's luxurious, with gold-plated walls and crystal lighting on the ceiling. The button panel is lacquered dark mahogany with what looks like real ivory buttons. The carpeting is soft and plush. A golden keyhole sits above the buttons.

The remains of the mauve guard robot are sprawled on the ground.

>undo
Galaxy Jones is in the elevator car.
[Previous turn undone.]

>put gel on vent
Jones pours the gel into the vent on the robot's head. The robot flails around wildly and throws her from its back, then lets out a loud crackling sound and stops moving.
 _________      __                     _____                     
 __/ ____/___ _/ /___ __  ____  __     __/ /___  ____  ___  _____
 _/ / __/ __ `/ / __ `/ |/ / / / /____ _/ / __ \/ __ \/ _ \/ ___/
 / /_/ / /_/ / / /_/ />  </ /_/ / _/ /_/ / /_/ / / / /  __(__  ) 
 \____/\__,_/_/\__,_/_/|_|\__, /  _\____/\____/_/ /_/\___/____/  
 _____________________________/ 

[Your score has just gone up by one point.]

Galaxy Jones is in the elevator car. It's luxurious, with gold-plated walls and crystal lighting on the ceiling. The button panel is lacquered dark mahogany with what looks like real ivory buttons. The carpeting is soft and plush. A golden keyhole sits above the buttons.

The remains of the mauve guard robot are sprawled on the ground.

>undo
Galaxy Jones is in the elevator car.
[Previous turn undone.]

>put gel on robot
Jones pours the gel into the vent on the robot's head. The robot flails around wildly and throws her from its back, then lets out a loud crackling sound and stops moving.
 _________      __                     _____                     
 __/ ____/___ _/ /___ __  ____  __     __/ /___  ____  ___  _____
 _/ / __/ __ `/ / __ `/ |/ / / / /____ _/ / __ \/ __ \/ _ \/ ___/
 / /_/ / /_/ / / /_/ />  </ /_/ / _/ /_/ / /_/ / / / /  __(__  ) 
 \____/\__,_/_/\__,_/_/|_|\__, /  _\____/\____/_/ /_/\___/____/  
 _____________________________/ 

[Your score has just gone up by one point.]

Galaxy Jones is in the elevator car. It's luxurious, with gold-plated walls and crystal lighting on the ceiling. The button panel is lacquered dark mahogany with what looks like real ivory buttons. The carpeting is soft and plush. A golden keyhole sits above the buttons.

The remains of the mauve guard robot are sprawled on the ground.

>purloin golden key
[Purloined.]

>put it in keyhole
Jones puts the key in the keyhole and turns. There is a pleasant chime, and some buttons light up.

Galaxy Jones is in the elevator car. It's luxurious, with gold-plated walls and crystal lighting on the ceiling. The button panel is lacquered dark mahogany with what looks like real ivory buttons. The carpeting is soft and plush. A golden key rests in a golden keyhole above the buttons. The buttons 1, 9, 10, and 100 are illuminated.

The remains of the mauve guard robot are sprawled on the ground.

>press 1
The elevator quickly arrives at its destination.

Galaxy Jones is in the elevator car. It's luxurious, with gold-plated walls and crystal lighting on the ceiling. The button panel is lacquered dark mahogany with what looks like real ivory buttons. The carpeting is soft and plush. A golden key rests in a golden keyhole above the buttons. The buttons 1, 9, 10, and 100 are illuminated.

The remains of the mauve guard robot are sprawled on the ground.

>u
Galaxy Jones is on the top of the elevator car. The elevator shaft extends many hundreds of feet above here. Jones can see down into the elevator car from here.

>d
Galaxy Jones is in the elevator car. It's luxurious, with gold-plated walls and crystal lighting on the ceiling. The button panel is lacquered dark mahogany with what looks like real ivory buttons. The carpeting is soft and plush. A golden key rests in a golden keyhole above the buttons. The buttons 1, 9, 10, and 100 are illuminated.

The remains of the mauve guard robot are sprawled on the ground.

>press 9
The elevator quickly arrives at its destination.

Galaxy Jones is in the elevator car. It's luxurious, with gold-plated walls and crystal lighting on the ceiling. The button panel is lacquered dark mahogany with what looks like real ivory buttons. The carpeting is soft and plush. A golden key rests in a golden keyhole above the buttons. The buttons 1, 9, 10, and 100 are illuminated.

The remains of the mauve guard robot are sprawled on the ground.

>u
Galaxy Jones is on the top of the elevator car. The elevator shaft extends many hundreds of feet above here. Jones can see down into the elevator car from here.

* * *

>d
Galaxy Jones is in the elevator car. It's luxurious, with gold-plated walls and crystal lighting on the ceiling. The button panel is lacquered dark mahogany with what looks like real ivory buttons. The carpeting is soft and plush. A golden key rests in a golden keyhole above the buttons. The buttons 1, 9, 10, and 100 are illuminated.

The remains of the mauve guard robot are sprawled on the ground.

>press 100
The elevator accelerates upwards at a frightening rate. The numbers cllimb towards 100. Soon the elevator slows, and the door opens on the 100th floor.

Galaxy Jones is in the elevator car. It's luxurious, with gold-plated walls and crystal lighting on the ceiling. The button panel is lacquered dark mahogany with what looks like real ivory buttons. The carpeting is soft and plush. A golden key rests in a golden keyhole above the buttons. The buttons 1, 9, 10, and 100 are illuminated.

The remains of the mauve guard robot are sprawled on the ground.

>u
Galaxy Jones is on the top of the elevator car. The elevator shaft extends many hundreds of feet above here. Jones can see down into the elevator car from here.

* * *

>undo
Galaxy Jones is in the elevator car.
[Previous turn undone.]

>actions
Actions listing on.

>put gel on robot
[putting the bottle of Electrofil quick-setting conductive polymer gel on the mauve guard robot]
Putting things on the mauve guard robot would achieve nothing.
[putting the bottle of Electrofil quick-setting conductive polymer gel on the mauve guard robot - failed the can't put onto what's not a supporter rule]

The mauve guard robot throws Jones from its back, and she goes sprawling into the corner of the elevator. The robot rotates its disruptor barrel to face her, and opens fire.

    *** The End ***

In that game you scored 0 out of a possible 0, in 13 turns.

Would you like to RESTART, RESTORE a saved game, QUIT, or UNDO the last command?

* * *

>purloin gel
(the bottle of Electrofil quick-setting conductive polymer gel)
[Purloined.]

>put it on robot
Putting things on the mauve guard robot would achieve nothing.

>jump down
You must name something more substantial.

The mauve guard robot exits the elevator car, out of sight.

>e
Jones can't go that way.

>s
Jones can't go that way.

>d
Galaxy Jones is in the elevator car. It's luxurious, with gold-plated walls and crystal lighting on the ceiling. The button panel is lacquered dark mahogany with what looks like real ivory buttons. The carpeting is soft and plush. A golden keyhole sits above the buttons.

>e
Galaxy Jones is in the tenth floor elevator hall. The elevator car to the west stands open. There is a stairwell to the east. The hall runs north and south into a sumptuous corporate office.

* * *

>u
Galaxy Jones is on the top of the elevator car. The elevator shaft extends many hundreds of feet above here. Jones can see down into the elevator car from here.

The mauve guard robot enters the elevator car below.

>jump on robot
Jones drops down through the ceiling and on to the guard robot. It swings around looking for her, obviously panicked that it can't bring its gun to bear on its attacker. Jones manages to hang on.

The mauve guard robot struggles against her hold on it, to no avail.

>put gel on robot
Putting things on the mauve guard robot would achieve nothing.

The mauve guard robot struggles against Jones's hold on it, to no avail.

* * *

>s
Galaxy Jones is at the southeast corner of the Consolidated Microthings office. This corner of the floor contains the gym and other company amenities. Reception is to the west, and an empty area lies to the north.

Jones sees the mauve guard robot to the west.

>sneak up on robot
The room is to open to sneak up effectively.

To the west, the mauve guard robot heads east.

>z
Jones stands around and waits.

The mauve guard robot approaches from the west.

The guard robot moves in on Jones with its slashing knife arms, slicing her to ribbons.

    *** Jones was killed by the mauve guard robot ***

In that game you scored 0 out of a possible 10, in 6 turns.

Would you like to RESTART, RESTORE a saved game, QUIT, or UNDO the last command?

>undo
Galaxy Jones is at the southeast corner of the Consolidated Microthings office.
[Previous turn undone.]

>ask beck for help
Beck: "Before we begin, save your game. This could get ugly."

The mauve guard robot approaches from the west.

The guard robot moves in on Jones with its slashing knife arms, slicing her to ribbons.

    *** Jones was killed by the mauve guard robot ***

In that game you scored 0 out of a possible 10, in 6 turns.

Would you like to RESTART, RESTORE a saved game, QUIT, or UNDO the last command?

* * *

>gonear cabinet
Which do you mean, the chemical cabinet or the filing cabinet?

>filing
Galaxy Jones is at the south end of the building management office. The building management office is a bunch of desks and task boards. There is a filing cabinet against the east wall. The office exit is to the east, and the office continues to the north.

A screwdriver sits atop the filing cabinet.

>ask for help
Beck: "If you haven't yet, get the screwdriver."

>ask for help
Beck: "Oops. That didn't turn out well. Look behind the cabinet to get the screwdriver."

>ask for help
Beck: "Looks like you'll need to get rid of the cat. What do cats like?"

>ask for help
Beck: "Give the shrimp tea sandwich to the cat."

>ask for help
Beck: "What? You don't have a shrimp tea sandwich? Didn't you examine the catering table on the ground floor. Time to go back there."

>ask for help
Beck: "What? You don't have a shrimp tea sandwich? Didn't you examine the catering table on the ground floor. Time to go back there."

* * *

>gonear catering
Galaxy Jones is on the east side of the ground floor. Apparently some kind of function was happening here before Admiral Thallium emptied the building, for there is an array of canapes on a catering table here. The floor stretches north and south, and there's a closet door to the west.

Beck: "Blueprints indicate a closet to the west of you. Might be useful."

>x table
The table is covered with a wide array of treats from the ridiculously expensive, such as shrimp tea sandwiches (where do you get shrimp on Mars?), to the just plain ridiculous, like poached ostrich eggs in jelly. A good number of forks are laid out to one side.

Jones: "What would you like me to bring you, Beck? Shrimp tea sandwiches, or poached ostrich eggs?"

Beck: "Oh, the shrimp. Definitely get the shrimp."

>x table
The table is covered with a wide array of treats from the ridiculously expensive, such as shrimp tea sandwiches (where do you get shrimp on Mars?), to the just plain ridiculous, like poached ostrich eggs in jelly. A good number of forks are laid out to one side.

Jones: "Well, at least the Admiral treats his guests right. Except me. And Europa."

>x table
The table is covered with a wide array of treats from the ridiculously expensive, such as shrimp tea sandwiches (where do you get shrimp on Mars?), to the just plain ridiculous, like poached ostrich eggs in jelly. A good number of forks are laid out to one side.

>purloin water
(the full water bottle)
[Purloined.]

>pour water
Why waste it?

>purloin gel
(the bottle of Electrofil quick-setting conductive polymer gel)
[Purloined.]

>pour it
That would just make a mess.

>pour it on table
That would just make a mess.

>purloin cable
[Purloined.]

>gonear cage
(the cage)
Galaxy Jones is next to the cage. The closely-set silnium bars seem to dash all hope of a rescue.

Europa Callisto is lying at the center of the cage, out of Jones's reach.

Jones tries the strength of the bars just in case. They don't budge.

South of the cage, Thallium crosses the roof to the flyer pad, where he boards the waiting flyer. The flyer lifts off and moves towards Jones.

>tie hook to cage
(the cage)
It doesn't seem useful to attach the cable to this part of the cage.

Thallium's flyer hovers over the rooftop. "Jones!"  he bellows. "Play time is over. I grow weary of your intransigence. In a moment this roof will be swarmed by guard robots -- of many different colors -- so many robots you couldn't possibly vandalize them all.  Say your prayers, Jones, or whatever you do when you're about to die."

Jones rolls her eyes.

A little ways off, a small red flyer aims for the rooftop and accelerates.

>up
Jones can't go that way.

>climb cage
(the cage)
Jones gets onto the cage.

* * *

>gonear chemical office
Galaxy Jones is in the martian chemical office. This seems like the business office of the chemical company rather than the lab. Most of the room is taken up by desks and other office stuff. There is a cabinet that looks intriguing, however.

>x desks
Seen one, seen 'em all. Except for the large desk across the hall, of course.

>x desk
Seen one, seen 'em all. Except for the large desk across the hall, of course.

>fly
Not even Galaxy Jones.

>jump
Jones jumps on the spot.

>gonear ledge
Galaxy Jones is on a ledge. She's plastered up against the wall, trying not to look down.

>jump
On a ledge? Are you crazy?

>fly
Tasteless.

>gonear ninth hall
Galaxy Jones is in the ninth floor elevator hall. The elevator is to the west, the stairwell is to the east, and a corridor leads north and south. There is a bottled water vending machine here.

>n
Galaxy Jones is in the ninth floor north hallway. This anonymous corporate hallway ends here at the north end of the building. An open doorway leads west. To the east is a door labeled "Cybernetica Inc."

>x door
A slick corporate office door lettered "Cybernetica". It has a swipe lock above the handle.

>s
Galaxy Jones is in the ninth floor elevator hall. The elevator is to the west, the stairwell is to the east, and a corridor leads north and south. There is a bottled water vending machine here.

>s
Galaxy Jones is in the ninth floor south hallway. This anonymous corporate hallway ends here at the south end of the building. An open doorway leads west. To the east is a door labeled "Martian Chemical"

>x door
A slick corporate office door with the fancy company logo of Martian Chemical. It has a swipe lock above the handle.

>x jones
Galaxy Jones stands at the ready.

* * *

>gonear cybernetica office
Galaxy Jones is in the cybernetica office. It's spacious and luxurious, designed to make developers forget how spent they are from months of overwork and abuse. Ergonomic desks and chairs fill space like a furniture fractal, before giving way to an open area, presumably for group activities.

As soon as Jones steps into the office, a shot zaps just past her nose. She dives to the ground, protected by the maze of desks and chairs. Peeking through the mesh back of one of the chairs, she takes notice of both the purple guard robot training its disruptor on the room, and the chair's fine construction and lumbar support.

Jones (whispering): "We've got another one! I'm out of sight for now, but it's going to be hard to get a shot off at this 'bot."

Beck: "What's the situation?"

Jones: "I'm on the floor with desks and chairs all around. The target is a few yards off, coming this way. I might get a shot in, but it might just absorb it anyway."

Beck: "Well, see if you can sneak up on it. Maybe close up you can find a way past its defenses."

>sneak up on robot
Jones creeps a little ways toward the guard robot.

>sneak up on robot
Slowly, slowly, Jones gets a little closer. Just a little more...

She must have poked up her shoulder or something, for the guard robot fires his disruptor. The shot takes out a window on the east side of the room. The electrostatic field around the building keeps the atmosphere from pouring out.

>sneak up on robot
Jones is right up next to the robot, crouched beneath a desk. She'll never get a better shot.

>shoot robot
Jones aims the pistol upward under the robot's enhanced armor and fires. She flinches back when the robot's innards explode downward in a shower of sparks. It topples over, dead.

 _________      __                     _____                     
 __/ ____/___ _/ /___ __  ____  __     __/ /___  ____  ___  _____
 _/ / __/ __ `/ / __ `/ |/ / / / /____ _/ / __ \/ __ \/ _ \/ ___/
 / /_/ / /_/ / / /_/ />  </ /_/ / _/ /_/ / /_/ / / / /  __(__  ) 
 \____/\__,_/_/\__,_/_/|_|\__, /  _\____/\____/_/ /_/\___/____/  
 _____________________________/ 

[Your score has just gone up by one point.]

Jones: "Better than a video game. "

Beck: "Nice, but don't forget to credit your handler."

Jones: "Yes, yes, thanks for helping me not get killed."

Beck: "You're welcome."

>x robot
The tattered guts of the purple guard robot spill out from it's armored carapace.

>gonear chemical office
Galaxy Jones is in the martian chemical office. This seems like the business office of the chemical company rather than the lab. Most of the room is taken up by desks and other office stuff. There is a cabinet that looks intriguing, however.

>x desks
There's nothing like that nearby.

>x cabinet
The cabinet is full of bottles of bottle of Electrofil quick-setting conductive polymer gel.

In the chemical cabinet is a bottle of Electrofil quick-setting conductive polymer gel.

>score
You have so far scored 1 out of a possible 0, in 9 turns.

* * *

>take robot
An interesting idea.

* * *

>gonear diamonds
Which do you mean, the real diamond or the diamond?

>real
Galaxy Jones is in the room of stuff. this is a secret message.

Also here is a real diamond.

>gonear 100th
Galaxy Jones is in the 100th floor elevator hall. The luxury is staggering.  The walls are made of polished black marble, and the floors are covered in plush black carpeting that muffles the sound of footsteps. The ceiling is high and adorned with a crystal chandelier. The elevator doors to the west are gold-plated. Sumptuous living quarters are visible to the north and south.

* * *

>s
Galaxy Jones is in the southern corner of the penthouse. This must be Thallium's "treasure room", to go by the obscene display of wealth. The most notable feature is the array of diamonds lining the walls. Everything else here pales in comparison. The penthouse continues to the northwest, north, and northeast.

Thallium seems to speak from all around Jones. "You like diamonds, Jones? Of course you do -- they're a girl's best friend, after all."

Jones snorts, "Sure, Thallium."

>pry diamond out
Taken.

Thallium giggles. "Oh, I hope you're not disappointed, Jones."

>x it
Jones: "Hmm. This is made of glass."

Thallium: "Poor, sad Jones. But here's the thing. There is a real diamond in there; it's just you'll never find it before the building's defenses flood the whole floor with poisonous gas. Or maybe I'm bluffing. Maybe I'm not. Can you afford to gamble?"

Jones tosses the fake away.

>pry out diamond
Jones will never find the real diamond this way.

* * *

>gonear elevator car
(the top of the elevator car)
Galaxy Jones is on the top of the elevator car. The elevator shaft extends many hundreds of feet above here. Jones can see down into the elevator car from here.

>d
Galaxy Jones is in the elevator car. It's luxurious, with gold-plated walls and crystal lighting on the ceiling. The button panel is lacquered dark mahogany with what looks like real ivory buttons. The carpeting is soft and plush. A golden keyhole sits above the buttons.

One of the ceiling panels looks loose.

Admiral Thallium's voice oozes from concealed speakers: "Yes, Jones, that is real ivory. I imported the elephant here myself for a hunt on my estate. You have no idea how much money it takes to simulate an African jungle on Mars. In retrospect I should have gotten an Indian elephant."

>take panel
(the ceiling panel)
Jones removes the ceiling panel, exposing a hole wide enough for her to climb through.

>purloin golden key
[Purloined.]

>put it in keyhole
Jones puts the key in the keyhole and turns. There is a pleasant chime, and some buttons light up.

Galaxy Jones is in the elevator car. It's luxurious, with gold-plated walls and crystal lighting on the ceiling. The button panel is lacquered dark mahogany with what looks like real ivory buttons. The carpeting is soft and plush. A golden key rests in a golden keyhole above the buttons. The buttons 1, 9, 10, and 100 are illuminated.

>u
Galaxy Jones is on the top of the elevator car. The elevator shaft extends many hundreds of feet above here. Jones can see down into the elevator car from here.

>d
Galaxy Jones is in the elevator car. It's luxurious, with gold-plated walls and crystal lighting on the ceiling. The button panel is lacquered dark mahogany with what looks like real ivory buttons. The carpeting is soft and plush. A golden key rests in a golden keyhole above the buttons. The buttons 1, 9, 10, and 100 are illuminated.

>press 100
The elevator accelerates upwards at a frightening rate. The numbers cllimb towards 100. Soon the elevator slows, and the door opens on the 100th floor.

Galaxy Jones is in the elevator car. It's luxurious, with gold-plated walls and crystal lighting on the ceiling. The button panel is lacquered dark mahogany with what looks like real ivory buttons. The carpeting is soft and plush. A golden key rests in a golden keyhole above the buttons. The buttons 1, 9, 10, and 100 are illuminated.

>u
Galaxy Jones is on the top of the elevator car. Jones is right at the top of the shaft. She can see down into the elevator car from here.

* * *

>gonear ledge
Galaxy Jones is on a ledge. She's plastered up against the wall, trying not to look down.

>x scaffold
There's nothing like that nearby.

>look d
Okay, fine. Jones look down, slowly, slowly... and there's a window cleaner's scaffold, about six feet below her.

Jones: "Okay, so. There's a window washing platform right below me. I might be able to drop down to it, but I won't be able to get back up."

Beck: "Take it easy, Jones."

>x scaffold
It certainly looks more inviting than this ledge.

>x window
It certainly looks more inviting than this ledge.

>x washing
It certainly looks more inviting than this ledge.

* * *

>gonear ledge
Galaxy Jones is on a ledge. She's plastered up against the wall, trying not to look down.

>x wall
Right now, it's Jones's only friend.

>x ledge
Galaxy Jones is on a ledge. She's plastered up against the wall, trying not to look down.

>x scenerty
There's nothing like that nearby.

>x outside
(the city)
From this perilous location, outside the comforting electrostatic field trapping the atmosphere of the building, one can see with striking clarity the lights of the city. The surrounding plains go on forever.

>x city
From this perilous location, outside the comforting electrostatic field trapping the atmosphere of the building, one can see with striking clarity the lights of the city. The surrounding plains go on forever.

>look down
Okay, fine. Jones look down, slowly, slowly... and there's a window cleaner's scaffold, about six feet below her.

Jones: "Okay, so. There's a window washing platform right below me. I might be able to drop down to it, but I won't be able to get back up."

Beck: "Take it easy, Jones."

>x scaffold
There's nothing like that nearby.

* * *

>gonear medals
Galaxy Jones is at the northeast corner of the ground floor. The area is dedicated to celebrating the military career of Admiral Thallium. Uniforms, medals, ribbons, and other miscellanea are mounted on the wall or in showcases. All this despite the fact that no one has turned up any evidence that Thallium served in any navy of any country on any planet. One can escape to the west or south.

Jones: "Now this is some choice bullshit here."

Beck: "Looks like the record of the good Admiral's long and dedicated service."

>s
Galaxy Jones is on the east side of the ground floor. Apparently some kind of function was happening here before Admiral Thallium emptied the building, for there is an array of canapes on a catering table here. The floor stretches north and south, and there's a closet door to the west.

Beck: "Blueprints indicate a closet to the west of you. Might be useful."

* * *

>gonear ninth hall
Galaxy Jones is in the ninth floor elevator hall. The elevator is to the west, the stairwell is to the east, and a corridor leads north and south. There is a bottled water vending machine here.

>ask for help
Beck: "Looks like you're managing okay."

>n
Galaxy Jones is in the ninth floor north hallway. This anonymous corporate hallway ends here at the north end of the building. An open doorway leads west. To the east is a door labeled "Cybernetica Inc."

>s
Galaxy Jones is in the ninth floor elevator hall. The elevator is to the west, the stairwell is to the east, and a corridor leads north and south. There is a bottled water vending machine here.

* * *

>s
Galaxy Jones is in the ninth floor south hallway. This anonymous corporate hallway ends here at the south end of the building. An open doorway leads west. To the east is a door labeled "Martian Chemical"

>ask for help
Beck: "You probably have noticed the two locked doors on this floor. You need to get them open."

>n
Galaxy Jones is in the ninth floor elevator hall. The elevator is to the west, the stairwell is to the east, and a corridor leads north and south. There is a bottled water vending machine here.

>n
Galaxy Jones is in the ninth floor north hallway. This anonymous corporate hallway ends here at the north end of the building. An open doorway leads west. To the east is a door labeled "Cybernetica Inc."

>w
Galaxy Jones is at the north end of the building management office. The building management office is a bunch of desks and task boards. There is a particularly large desk against the west window. The office exit is to the east, and the office continues to the south.

>s
Galaxy Jones is at the south end of the building management office. The building management office is a bunch of desks and task boards. There is a filing cabinet against the east wall. The office exit is to the east, and the office continues to the north.

A screwdriver sits atop the filing cabinet.

>ask for help
Beck: "The cardkey for both of them is in the large desk in the building management office."

>n
Galaxy Jones is at the north end of the building management office. The building management office is a bunch of desks and task boards. There is a particularly large desk against the west window. The office exit is to the east, and the office continues to the south.

>ask for help
Beck: "You don't have a key for the desk. Maybe you can pick the lock?"

>pick lock with pistol
Not likely.

>ask for help
Beck: "Pick the desk lock with the safety pin."

>ask for help
Beck: "Pick the desk lock with the safety pin."

>s
Galaxy Jones is at the south end of the building management office. The building management office is a bunch of desks and task boards. There is a filing cabinet against the east wall. The office exit is to the east, and the office continues to the north.

A screwdriver sits atop the filing cabinet.

>s
Jones can't go that way.

>ask for help
Beck: "Pick the desk lock with the safety pin."

>purloin black cardkey
[Purloined.]

>ask for help
Beck: "Pick the desk lock with the safety pin."

>x cardkey
Black like evil, or like secrets?

>ask for help
Beck: "If you haven't yet, get the screwdriver."

>get screwdriver
Jones reaches for the screwdriver, but she fumbles it and it rolls off the back of the filing cabinet.

Jones: "Damn."

Beck: "What? What's going on?"

Jones: "Just being clumsy is all."

>get screwdriver
Jones reaches behind the cabinet to retrieve the screwdriver. A swipe and a hiss make her recoil.

Jones: "Holy --!"

Beck: "What now?"

Jones: "There's a cat here! Behind a filing cabinet. Gotta get behind there to get a screwdriver, so I need a way to drive off the cat."

>ask for help
Beck: "Oops. Getting the screwdriver didn't turn out well. Look behind the cabinet to get the screwdriver."

>ask for help
Beck: "Looks like you'll need to get rid of the cat. What do cats like?"

* * *

>ask for help
Beck: "What? You don't have a shrimp tea sandwich? Didn't you examine the catering table on the ground floor. Time to go back there."

>reset help
Resetting all help messages.

>ask for help
Beck: "If you haven't yet, get the screwdriver."

>ask for help
Beck: "Oops. Getting the screwdriver didn't turn out well. Look behind the cabinet to get the screwdriver."

* * *

>ask for help
Beck: "Looks like you'll need to get rid of the cat. What do cats like?"

>e
Galaxy Jones is in the ninth floor south hallway. This anonymous corporate hallway ends here at the south end of the building. An open doorway leads west. To the east is a door labeled "Martian Chemical"

>e
(first opening the Martian Chemical door)
(first unlocking the Martian Chemical door)
(with the black cardkey)

Galaxy Jones is in the martian chemical office. This seems like the business office of the chemical company rather than the lab. Most of the room is taken up by desks and other office stuff. There is a cabinet that looks intriguing, however.

>ask for help
Beck: "Looks like you're managing okay."

>w
Galaxy Jones is in the ninth floor south hallway. This anonymous corporate hallway ends here at the south end of the building. An open doorway leads west. To the east is a door labeled "Martian Chemical"

>w
Galaxy Jones is at the south end of the building management office. The building management office is a bunch of desks and task boards. There is a filing cabinet against the east wall. The office exit is to the east, and the office continues to the north.

>ask for help
Beck: "Give the shrimp tea sandwich to the cat."

* * *

>gonear table
Which do you mean, the catering table or the vanity table?

>catering
Galaxy Jones is on the east side of the ground floor. Apparently some kind of function was happening here before Admiral Thallium emptied the building, for there is an array of canapes on a catering table here. The floor stretches north and south, and there's a closet door to the west.

Beck: "Blueprints indicate a closet to the west of you. Might be useful."

>x table
The table is covered with a wide array of treats from the ridiculously expensive, such as shrimp tea sandwiches (where do you get shrimp on Mars?), to the just plain ridiculous, like poached ostrich eggs in jelly. A good number of forks are laid out to one side.

Jones: "What would you like me to bring you, Beck? Shrimp tea sandwiches, or poached ostrich eggs?"

Beck: "Oh, the shrimp. Definitely get the shrimp."

>x table
The table is covered with a wide array of treats from the ridiculously expensive, such as shrimp tea sandwiches (where do you get shrimp on Mars?), to the just plain ridiculous, like poached ostrich eggs in jelly. A good number of forks are laid out to one side.

Jones: "What would you like me to bring you, Beck? Shrimp tea sandwiches, or poached ostrich eggs?"

Beck: "Oh, the shrimp. Definitely get the shrimp."

* * *

>gonear tenth
Which do you mean, the tenth floor elevator hall or the tenth floor stairwell?

>hall
Galaxy Jones is in the tenth floor elevator hall. The elevator car to the west stands open. There is a stairwell to the east. The hall runs north and south into a sumptuous corporate office.

>s
Galaxy Jones is on the south side of the Consolidated Microthings office. This is reception. It has a great view of the New Reykjavik Botanic Dome. Couches are lined up to take advantage. The floor east and west, and north to the elevator

Jones sees the mauve guard robot to the west.

>z
Jones stands around and waits.

The mauve guard robot approaches from the west.

Jones doesn't stand a chance against the mauve guard robot's terrible knives.

    *** Jones was killed by the mauve guard robot ***

In that game you scored 0 out of a possible 0, in 3 turns.

Would you like to RESTART, RESTORE a saved game, QUIT, or UNDO the last command?

* * *

>hall
Galaxy Jones is in the tenth floor elevator hall. The elevator car to the west stands open. There is a stairwell to the east. The hall runs north and south into a sumptuous corporate office.

>w
Galaxy Jones is in the elevator car. It's luxurious, with gold-plated walls and crystal lighting on the ceiling. The button panel is lacquered dark mahogany with what looks like real ivory buttons. The carpeting is soft and plush. A golden keyhole sits above the buttons.

One of the ceiling panels looks loose.

Admiral Thallium's voice oozes from concealed speakers: "Yes, Jones, that is real ivory. I imported the elephant here myself for a hunt on my estate. You have no idea how much money it takes to simulate an African jungle on Mars. In retrospect I should have gotten an Indian elephant."

>out
Galaxy Jones is in the tenth floor elevator hall. The elevator car to the west stands open. There is a stairwell to the east. The hall runs north and south into a sumptuous corporate office.

>in
Jones can't go that way.

>w
Galaxy Jones is in the elevator car. It's luxurious, with gold-plated walls and crystal lighting on the ceiling. The button panel is lacquered dark mahogany with what looks like real ivory buttons. The carpeting is soft and plush. A golden keyhole sits above the buttons.

One of the ceiling panels looks loose.

>exit
Galaxy Jones is in the tenth floor elevator hall. The elevator car to the west stands open. There is a stairwell to the east. The hall runs north and south into a sumptuous corporate office.

* * *

>gonear window washing scaffold
Galaxy Jones is on a window washing scaffold. It's lined up with the eighth floor window. There doesn't seem to be any way to get into the building here. Mounted on the scaffold is a control panel with two buttons: one indicating up and one indicating down.

>x window
Galaxy Jones is on a window washing scaffold. It's lined up with the eighth floor window. There doesn't seem to be any way to get into the building here. Mounted on the scaffold is a control panel with two buttons: one indicating up and one indicating down.

* * *

>n
Jones approaches the Viking Building entryway, the dramatic façade towering over her.

Galaxy Jones is at the entry doorway. A glass revolving door leads into a large open space north of here. The speeder dock is to the south.

Jones peers upwards at the 100 stories of glass and steel. "What do you want to bet Thallium's got Europa all the way at the top?"

Beck: "Oh, no doubt."

>mn
That's not a verb I recognise.

>n
Jones takes a deep breath. "I'm going in."

Beck replies, "You got this, Galaxy."

Jones passes through the revolving door and into the lobby, alert to any defenses.

Galaxy Jones is in the lobby. The ground floor of the Viking Building is breathtaking. Low-G architecture means more glass and thinner supports, and the building takes advantage of that. Four walls of glass surround a central pillar in which are set the utility rooms and elevators. In between is an expanse of plants, water features, and stylish seating. Near the entryway is a front desk. A giant crystal sculpture floats above the center of the area, suspended on almost invisible cables. She may go east and west from here, north to the elevators, or south out of the building.

Suddenly two robot guards, green and red, emerge from niches in the back wall! She dives behind the front desk and draws her disruptor pistol.

Jones shouts, "I'm under fire from two ugly robot things!"

Beck responds, "Monitoring your suit radar."

>shoot art
Jones fires the disruptor into the sculpture's main support cable, snapping it. The huge crystal blob starts to sag, straining the other cables. In quick succession they break as well, and the whole installation plummets to the ground, right on top of the hapless guard robots.
 _________      __                     _____                     
 __/ ____/___ _/ /___ __  ____  __     __/ /___  ____  ___  _____
 _/ / __/ __ `/ / __ `/ |/ / / / /____ _/ / __ \/ __ \/ _ \/ ___/
 / /_/ / /_/ / / /_/ />  </ /_/ / _/ /_/ / /_/ / / / /  __(__  ) 
 \____/\__,_/_/\__,_/_/|_|\__, /  _\____/\____/_/ /_/\___/____/  
 _____________________________/ 

[Your score has just gone up by one point.]

Beck: "What was that crash? What's going on?"

Jones: "That, my friend, was what you'd call a work of art. Targets terminated."

>w
Jones crosses the floor carefully, disruptor pistol at the ready.

Galaxy Jones is at the southwest corner of the ground floor. A lush waterfall here contrasts with the dusty red streets of New Reykjavik beyond the glass walls. The ground floor extends north and east.

>x water
The waterfall descends the length of an artificial rock formation fringed by wide-leaved Earth plants and ferns. The water collects in a basin at the bottom, where it begins its journey again. A single coin sits on the bottom of the basin.

Jones: "One coin? Not very generous people around here."

* * *

>ask for help
Beck: "I dunno, maybe shoot the robots?"

Jones: "I could use some ideas here!"

>ask for help
Beck: "I dunno, maybe shoot the robots?"

>z
Jones stands around and waits.

>z
Jones stands around and waits.

A robot fires a blistering shot into the front desk.

>z
Jones stands around and waits.

>z
Jones stands around and waits.

Zip! Disruptor fire scorches a nearby couch.

>z
Jones stands around and waits.

The robots intone "Destroy Jones" in an eerie drone.

>z
Jones stands around and waits.

One of the robots fires directly above her head.

>z
Jones stands around and waits.

>z
Jones stands around and waits.

Beck: "Robot on your right!"

One robot tries to flank her, but a shot from her disruptor sends it scurrying back.

>z
Jones stands around and waits.

>z
Jones stands around and waits.

One of the robots fires directly above her head.

>shoot robot
Oops! Jones misses.

Beck: "How's it going in there?"

"Jones: "You know -- like all art, it's hit or miss."

>shoot robot
Oof. Big miss.

>shoot robot
Jones's shot goes wide, reflecting off one of the building struts and into the suspended sculpture. The artwork begins to spin wildly, straining its cables.

The two robots coordinate fire over the desk, narrowly missing her.

>shoot art
Jones fires the disruptor into the sculpture's main support cable, snapping it. The huge crystal blob starts to sag, straining the other cables. In quick succession they break as well, and the whole installation plummets to the ground, right on top of the hapless guard robots.
 _________      __                     _____                     
 __/ ____/___ _/ /___ __  ____  __     __/ /___  ____  ___  _____
 _/ / __/ __ `/ / __ `/ |/ / / / /____ _/ / __ \/ __ \/ _ \/ ___/
 / /_/ / /_/ / / /_/ />  </ /_/ / _/ /_/ / /_/ / / / /  __(__  ) 
 \____/\__,_/_/\__,_/_/|_|\__, /  _\____/\____/_/ /_/\___/____/  
 _____________________________/ 

[Your score has just gone up by one point.]

Beck: "What was that crash? What's going on?"

Jones: "That, my friend, was what you'd call a work of art. Targets terminated."

>ask beck about game
Beck: "Well, you can ask about: INTERACTIVE FICTION, COMMANDS, or CREDITS."

>ask for help
Beck: "Looks like you're managing okay."

* * *

>ne
Trying to reach an exit would surely get Jones shot.

Jones: "I'm pinned down here!"

>shoot art
Jones fires the disruptor into the sculpture's main support cable, snapping it. The huge crystal blob starts to sag, straining the other cables. In quick succession they break as well, and the whole installation plummets to the ground, right on top of the hapless guard robots.
 _________      __                     _____                     
 __/ ____/___ _/ /___ __  ____  __     __/ /___  ____  ___  _____
 _/ / __/ __ `/ / __ `/ |/ / / / /____ _/ / __ \/ __ \/ _ \/ ___/
 / /_/ / /_/ / / /_/ />  </ /_/ / _/ /_/ / /_/ / / / /  __(__  ) 
 \____/\__,_/_/\__,_/_/|_|\__, /  _\____/\____/_/ /_/\___/____/  
 _____________________________/ 

[Your score has just gone up by one point.]

Beck: "What was that crash? What's going on?"

Jones: "That, my friend, was what you'd call a work of art. Targets terminated."

* * *

>w
Jones crosses the floor carefully, disruptor pistol at the ready.

Galaxy Jones is at the southwest corner of the ground floor. A lush waterfall here contrasts with the dusty red streets of New Reykjavik beyond the glass walls. The ground floor extends north and east.

>x waterfall
The waterfall descends the length of an artificial rock formation fringed by wide-leaved Earth plants and ferns. The water collects in a basin at the bottom, where it begins its journey again. A single coin sits on the bottom of the basin.

* * *

>ask for help
Beck: "Looks like you're managing okay."

>e
Jones crosses the floor carefully, disruptor pistol at the ready.

Galaxy Jones is at the southeast corner of the ground floor. The centerpiece of this area is the actual Viking 2 lander, which landed right here on Utopia Planitia. The glass walls look out onto the city. She can go north or west from here.

>n
Galaxy Jones is on the east side of the ground floor. Apparently some kind of function was happening here before Admiral Thallium emptied the building, for there is an array of canapes on a catering table here. The floor stretches north and south, and there's a closet door to the west.

Beck: "Blueprints indicate a closet to the west of you. Might be useful."

>ask for help
Beck: "You saw that utility door near the catering table, right?"

>ask for help
Beck: "It's got a numerical lock on it."

>ask for help
Beck: "The code should be around here somewhere."

>ask for help
Beck: "Check the front desk."

>ask for help
Beck: "Check the front desk."

>d
Jones can't go that way.

* * *

>e
Jones crosses the floor carefully, disruptor pistol at the ready.

Galaxy Jones is at the southeast corner of the ground floor. The centerpiece of this area is the actual Viking 2 lander, which landed right here on Utopia Planitia. The glass walls look out onto the city. She can go north or west from here.

* * *

>n
Galaxy Jones is on the east side of the ground floor. Apparently some kind of function was happening here before Admiral Thallium emptied the building, for there is an array of canapes on a catering table here. The floor stretches north and south, and there's a closet door to the west.

Beck: "Blueprints indicate a closet to the west of you. Might be useful."

>in
Galaxy Jones is in the maintenance closet. A bare, white-walled room containing various maintenance items.

There is an Atmo-Suit hanging from a hook here.

On the shelf is a red cardkey.

>e
(first opening the closet door)

Galaxy Jones is on the east side of the ground floor. Apparently some kind of function was happening here before Admiral Thallium emptied the building, for there is an array of canapes on a catering table here. The floor stretches north and south, and there's a closet door to the west.

>w
Galaxy Jones is in the maintenance closet. A bare, white-walled room containing various maintenance items.

There is an Atmo-Suit hanging from a hook here.

On the shelf is a red cardkey.

>restart
Are you sure you want to restart?

* * *

>n
Galaxy Jones is on the east side of the ground floor. Apparently some kind of function was happening here before Admiral Thallium emptied the building, for there is an array of canapes on a catering table here. The floor stretches north and south, and there's a closet door to the west.

Beck: "Blueprints indicate a closet to the west of you. Might be useful."

>w
(first opening the closet door)
(first unlocking the closet door)
Jones will have to enter the correct code on the keypad.

Jones: "Door on the east side has a keypad lock."

>in
Galaxy Jones is in the maintenance closet. A bare, white-walled room containing various maintenance items.

There is an Atmo-Suit hanging from a hook here.

On the shelf is a red cardkey.

>out
(first opening the closet door)

Galaxy Jones is on the east side of the ground floor. Apparently some kind of function was happening here before Admiral Thallium emptied the building, for there is an array of canapes on a catering table here. The floor stretches north and south, and there's a closet door to the west.

>w
Galaxy Jones is in the maintenance closet. A bare, white-walled room containing various maintenance items.

There is an Atmo-Suit hanging from a hook here.

On the shelf is a red cardkey.

* * *

>n
Galaxy Jones is on the east side of the ground floor. Apparently some kind of function was happening here before Admiral Thallium emptied the building, for there is an array of canapes on a catering table here. The floor stretches north and south, and there's a closet door to the west.

Beck: "Blueprints indicate a closet to the west of you. Might be useful."

>type 0
(on the keypad)
An indicator light glows green.

Jones: "I've unlocked the east side utility door."

>w
(first opening the closet door)

Galaxy Jones is in the maintenance closet. A bare, white-walled room containing various maintenance items.

There is an Atmo-Suit hanging from a hook here.

On the shelf is a red cardkey.

>out
Galaxy Jones is on the east side of the ground floor. Apparently some kind of function was happening here before Admiral Thallium emptied the building, for there is an array of canapes on a catering table here. The floor stretches north and south, and there's a closet door to the west.

>w
Galaxy Jones is in the maintenance closet. A bare, white-walled room containing various maintenance items.

There is an Atmo-Suit hanging from a hook here.

On the shelf is a red cardkey.

>exit
Galaxy Jones is on the east side of the ground floor. Apparently some kind of function was happening here before Admiral Thallium emptied the building, for there is an array of canapes on a catering table here. The floor stretches north and south, and there's a closet door to the west.

>in
Galaxy Jones is in the maintenance closet. A bare, white-walled room containing various maintenance items.

There is an Atmo-Suit hanging from a hook here.

On the shelf is a red cardkey.

>e
Galaxy Jones is on the east side of the ground floor. Apparently some kind of function was happening here before Admiral Thallium emptied the building, for there is an array of canapes on a catering table here. The floor stretches north and south, and there's a closet door to the west.

>e
Jones can't go that way.

>s
Galaxy Jones is at the southeast corner of the ground floor. The centerpiece of this area is the actual Viking 2 lander, which landed right here on Utopia Planitia. The glass walls look out onto the city. Jones can go north or west from here.

>w
Galaxy Jones is in the lobby. The ground floor of the Viking Building is breathtaking. Low-G architecture means more glass and thinner supports, and the building takes advantage of that. Four walls of glass surround a central pillar in which are set the utility rooms and elevators. In between is an expanse of plants, water features, and stylish seating. Near the entryway is a front desk. Jones may go east and west from here, north to the elevators, or south out of the building. There are two niches in the central wall from which the guard robots emerged.

Spread across the floor in a tangled ruin are the remains of a giant crystal sculpture and two guard robots.

>w
Jones crosses the floor carefully, disruptor pistol at the ready.

Galaxy Jones is at the southwest corner of the ground floor. A lush waterfall here contrasts with the dusty red streets of New Reykjavik beyond the glass walls. The ground floor extends north and east.

>n
Galaxy Jones is on the west side of the ground floor. Semicircular couches open on either side of a central carpeted path leading north and south. Set in the central pillar of the building to the east is a utility door. The city looms beyond the glass wall to the west.

>in
Galaxy Jones is in the elevator room. This is a utility room related to the operation of the elevator, on the other side of the east wall here. There is a control panel on the wall, and a door leading west.

Hanging from a hook here is an elevator drop key.

Lying discarded on a table here is a hammer.

* * *

>w
(first opening the closet door)
(first unlocking the closet door)
Jones will have to enter the correct code on the keypad.

Jones: "Door on the east side has a keypad lock."

>in
Jones can't go that way.

>type 0
(on the keypad)
An indicator light glows green.

Jones: "I've unlocked the east side utility door."

* * *

>out
Galaxy Jones is on the east side of the ground floor. Apparently some kind of function was happening here before Admiral Thallium emptied the building, for there is an array of canapes on a catering table here. The floor stretches north and south, and there's a closet door to the west.

>s
Galaxy Jones is at the southeast corner of the ground floor. The centerpiece of this area is the actual Viking 2 lander, which landed right here on Utopia Planitia. The glass walls look out onto the city. Jones can go north or west from here.

* * *

>n
Galaxy Jones is on the west side of the ground floor. Semicircular couches open on either side of a central carpeted path leading north and south. Set in the central pillar of the building to the east is a utility door. The city looms beyond the glass wall to the west.

>e
(first opening the utility door)
(first unlocking the utility door)
Jones lacks a key that fits the utility door.

>purloin red
Which do you mean, the guard robots, the red cardkey, outside, outside, outside, the tangled ruin, the scaffold down button, the large red button, or the red flyer?

>cardkey
[Purloined.]

>e
(first opening the utility door)
(first unlocking the utility door)
(with the red cardkey)

Galaxy Jones is in the elevator room. This is a utility room related to the operation of the elevator, on the other side of the east wall here. There is a control panel on the wall, and a door leading west.

Hanging from a hook here is an elevator drop key.

Lying discarded on a table here is a hammer.

>out
Galaxy Jones is on the west side of the ground floor. Semicircular couches open on either side of a central carpeted path leading north and south. Set in the central pillar of the building to the east is a utility door. The city looms beyond the glass wall to the west.

>in
Jones can't go that way.

* * *

>w
(first opening the closet door)
(first unlocking the closet door)
Jones will have to enter the correct code on the keypad.

Jones: "Door on the east side has a keypad lock."

>s
Galaxy Jones is at the southeast corner of the ground floor. The centerpiece of this area is the actual Viking 2 lander, which landed right here on Utopia Planitia. The glass walls look out onto the city. Jones can go north or west from here.

* * *

>gonear ninth floor
Which do you mean, the ninth floor elevator shaft, the ninth floor stairwell, the ninth floor north hallway, the ninth floor south hallway, the ninth floor elevator door, or the ninth floor elevator hall?

>shaft
Galaxy Jones is in the ninth floor elevator shaft. The door here is closed.

>e
(first opening the ninth floor elevator door)
 _________      __                     _____                     
 __/ ____/___ _/ /___ __  ____  __     __/ /___  ____  ___  _____
 _/ / __/ __ `/ / __ `/ |/ / / / /____ _/ / __ \/ __ \/ _ \/ ___/
 / /_/ / /_/ / / /_/ />  </ /_/ / _/ /_/ / /_/ / / / /  __(__  ) 
 \____/\__,_/_/\__,_/_/|_|\__, /  _\____/\____/_/ /_/\___/____/  
 _____________________________/ 

[Your score has just gone up by one point.]

Jones: "Finally out of the shaft. That was quite a climb."

Beck: "This floor is just offices. Check the building management office to the west. It might have some useful stuff."

Galaxy Jones is in the ninth floor elevator hall. The elevator is to the west, the stairwell is to the east, and a corridor leads north and south. There is a bottled water vending machine here.

* * *

>x water
The waterfall descends the length of an artificial rock formation fringed by wide-leaved Earth plants and ferns. The water collects in a basin at the bottom, where it begins its journey again. A single coin sits on the bottom of the basin.

Jones: "One coin? Not very generous people around here."

>n
Galaxy Jones is on the west side of the ground floor. Semicircular couches open on either side of a central carpeted path leading north and south. Set in the central pillar of the building to the east is a utility door. The city looms beyond the glass wall to the west.

>n
Galaxy Jones is at the northwest corner of the ground floor. A large relief map of mars is mounted on the north wall here. One can leave here to the south or east.

>x map
The map is crafted of bronze and sports a star at the site of New Reykjavik.

>x star
Ah, New Reykjavik! Even colder than Old Reykjavik!

>e
Galaxy Jones is on the north side of the ground floor. The area is dominated by a towering statue of Admiral Thallium against the north wall. The ground floor extends west and east from here. The elevator is to the south.

>x statue
His nauseating visage seems to leer at Jones, and she suppresses a shiver of disgust.

Jones groans. "Be glad you're not here, Beck. This is revolting."

Beck chuckles. "I won't ask."

>e
Galaxy Jones is at the northeast corner of the ground floor. The area is dedicated to celebrating the military career of Admiral Thallium. Uniforms, medals, ribbons, and other miscellanea are mounted on the wall or in showcases. All this despite the fact that no one has turned up any evidence that Thallium served in any navy of any country on any planet. One can escape to the west or south.

>x medals
Jones yawns looking over the assortment of faux honors. They're all behind glass, but one of the display cases is partly open, leaving the rather garish medal inside unprotected.

>ask beck about medal
Beck: "Might as well take a look at it."

>take it
Jones can't see 'it' (nothing) at the moment.

>take medal
Taken.

>x it
While the front looks authentic, the reverse is engraved with Thallium's personal motto "Planetas Vincam". The ribbon conceals a safety pin. It looks like it could be removed.

>take pin
Taken.

>ask beck about it
Beck: "You never know when you might need something that can get in a very small space."

* * *

>shoot robot
Oops! Jones misses.

The two robots coordinate fire over the desk, narrowly missing her.
Jones: "I could use some ideas here!"

>shoot robot
Jones's shot hits the guard robots dead on, but nothing happens, almost as if the robot had absorbed the energy.

Jones: "Target seems to be absorbing disruptor fire. This will make things a little harder."

A robot fires a blistering shot into the front desk.

>ask for help
Beck: "Well, if your energy weapon won't hurt them, maybe direct physical force will?"

>ask for help
Beck: "It would have to be something large. Throwing your shoe at them isn't going to cut it."

* * *

>ask for help
Beck: "Well, if your energy weapon won't hurt them, maybe direct physical force will?"

* * *

>purloin atmo-suit
[Purloined.]

>purloin screwdriver
[Purloined.]

>gonear cybernetica office
Galaxy Jones is in the cybernetica office. It's spacious and luxurious, designed to make developers forget how spent they are from months of overwork and abuse. Ergonomic desks and chairs fill space like a furniture fractal, before giving way to an open area, presumably for group activities.

As soon as Jones steps into the office, a shot zaps just past her nose. She dives to the ground, protected by the maze of desks and chairs. Peeking through the mesh back of one of the chairs, she takes notice of both the purple guard robot training its disruptor on the room, and the chair's fine construction and lumbar support.

Jones (whispering): "We've got another one! I'm out of sight for now, but it's going to be hard to get a shot off at this 'bot."

Beck: "What's the situation?"

Jones: "I'm on the floor with desks and chairs all around. The target is a few yards off, coming this way. I might get a shot in, but it might just absorb it anyway."

Beck: "Well, see if you can sneak up on it. Maybe close up you can find a way past its defenses."

* * *

>e
Jones: "I'm going out the window to see if I can find a way to get up to the tenth floor."

Beck: "Whoa whoa whoa, Jones. You know you're not good with heights."

Jones: "Ask Thallium how how much that matters once I've kicked his ass. Watch me, I'll look down and not even flinch."

Jones puts on the Atmo-Suit.

Galaxy Jones is on a ledge. She's plastered up against the wall, trying not to look down.

>d
Jones can't go that way.

>w
Galaxy Jones is in the cybernetica office. It's spacious and luxurious, designed to make developers forget how spent they are from months of overwork and abuse. Ergonomic desks and chairs fill space like a furniture fractal, before giving way to an open area, presumably for group activities. One of the windows along the east side of the office is broken.

The remains of the purple guard robot are sprawled on the ground.

Jones takes off the Atmo-Suit.

>e
Jones puts on the Atmo-Suit.

Galaxy Jones is on a ledge. She's plastered up against the wall, trying not to look down.

>in
Galaxy Jones is in the cybernetica office. It's spacious and luxurious, designed to make developers forget how spent they are from months of overwork and abuse. Ergonomic desks and chairs fill space like a furniture fractal, before giving way to an open area, presumably for group activities. One of the windows along the east side of the office is broken.

The remains of the purple guard robot are sprawled on the ground.

Jones takes off the Atmo-Suit.

>out
Jones puts on the Atmo-Suit.

Galaxy Jones is on a ledge. She's plastered up against the wall, trying not to look down.

>look down
Okay, fine. Jones look down, slowly, slowly... and there's a window cleaner's scaffold, about six feet below her.

Jones: "Okay, so. There's a window washing platform right below me. I might be able to drop down to it, but I won't be able to get back up."

Beck: "Take it easy, Jones."

>d
Jones drops off the ledge onto the scaffold. It rocks unnervingly for a moment.

Galaxy Jones is on a window washing scaffold. It's lined up with the eighth floor window. There doesn't seem to be any way to get into the building here. Mounted on the scaffold is a control panel with two buttons: one indicating up and one indicating down.

>push up
(the scaffold up button)
Jones presses the button, and the scaffold begins to rise.

Galaxy Jones is on a window washing scaffold. It's lined up with the ninth floor window. She could climb back into the building through the window here. Mounted on the scaffold is a control panel with two buttons: one indicating up and one indicating down.

Jones: "Beck?"

Beck: "Yes?"

Jones: "I hate it out here."

Beck: "Well, there's the open window right next to you."

>w
Galaxy Jones is in the cybernetica office. It's spacious and luxurious, designed to make developers forget how spent they are from months of overwork and abuse. Ergonomic desks and chairs fill space like a furniture fractal, before giving way to an open area, presumably for group activities. One of the windows along the east side of the office is broken.

The remains of the purple guard robot are sprawled on the ground.

Jones takes off the Atmo-Suit.

>e
Jones puts on the Atmo-Suit.

Galaxy Jones is on a window washing scaffold. It's lined up with the ninth floor window. She could climb back into the building through the window here. Mounted on the scaffold is a control panel with two buttons: one indicating up and one indicating down.

>in
Galaxy Jones is in the cybernetica office. It's spacious and luxurious, designed to make developers forget how spent they are from months of overwork and abuse. Ergonomic desks and chairs fill space like a furniture fractal, before giving way to an open area, presumably for group activities. One of the windows along the east side of the office is broken.

The remains of the purple guard robot are sprawled on the ground.

Jones takes off the Atmo-Suit.

>out
Jones puts on the Atmo-Suit.

Galaxy Jones is on a window washing scaffold. It's lined up with the ninth floor window. She could climb back into the building through the window here. Mounted on the scaffold is a control panel with two buttons: one indicating up and one indicating down.

>push up
(the scaffold up button)
Jones presses the button, and the scaffold begins to rise.

Galaxy Jones is on a window washing scaffold. It's lined up with the tenth floor. Instead of a window, there's what appears to be an exhaust vent. If it's for forced air, though, the fan is currently not running. Mounted on the scaffold is a control panel with two buttons: one indicating up and one indicating down.

Jones: "Alright, I'm by the tenth floor now. What's this grill thing here?"

Beck: "That's an exhaust vent. There's an air handling room on this floor which it leads into. If you can get the cover off you should be able to access the whole floor from here."

>open vent
Jones loosens the screws with the screwdriver and removes the grill from the vent.

>in
Jones climbs inside the vent, crawls along a short length of duct work, and emerges through another, hinged grill, into the air handling room.
 _________      __                     _____                     
 __/ ____/___ _/ /___ __  ____  __     __/ /___  ____  ___  _____
 _/ / __/ __ `/ / __ `/ |/ / / / /____ _/ / __ \/ __ \/ _ \/ ___/
 / /_/ / /_/ / / /_/ />  </ /_/ / _/ /_/ / /_/ / / / /  __(__  ) 
 \____/\__,_/_/\__,_/_/|_|\__, /  _\____/\____/_/ /_/\___/____/  
 _____________________________/ 

[Your score has just gone up by one point.]

Galaxy Jones is in the air handling room. There is a good number of loud fans and other air handling machinery here. A small hinged vent opening leads into some ductwork, and from there to the outside. A door leads west.

She takes off the Atmo-Suit.

Jones: "Ha! I'm in!"

Beck: "Be careful, you're likely to run into more resistance here. The floor is all one open office, so any guard robots will have good line of sight."

Jones: "Got it."

Beck: "And Jones? Save your game."

>out
Jones puts on the Atmo-Suit.

Galaxy Jones is on a window washing scaffold. It's lined up with the tenth floor. Instead of a window, there's what appears to be an exhaust vent. If it's for forced air, though, the fan is currently not running. Mounted on the scaffold is a control panel with two buttons: one indicating up and one indicating down.

>enter vent
Jones climbs inside the vent, crawls along a short length of duct work, and emerges through another, hinged grill, into the air handling room.

Galaxy Jones is in the air handling room. There is a good number of loud fans and other air handling machinery here. A small hinged vent opening leads into some ductwork, and from there to the outside. A door leads west.

She takes off the Atmo-Suit.

>out
Jones puts on the Atmo-Suit.

Galaxy Jones is on a window washing scaffold. It's lined up with the tenth floor. Instead of a window, there's what appears to be an exhaust vent. If it's for forced air, though, the fan is currently not running. Mounted on the scaffold is a control panel with two buttons: one indicating up and one indicating down.

>w
Jones climbs inside the vent, crawls along a short length of duct work, and emerges through another, hinged grill, into the air handling room.

Galaxy Jones is in the air handling room. There is a good number of loud fans and other air handling machinery here. A small hinged vent opening leads into some ductwork, and from there to the outside. A door leads west.

She takes off the Atmo-Suit.

>in
(first opening the vent access door)
Jones puts on the Atmo-Suit.

Galaxy Jones is on a window washing scaffold. It's lined up with the tenth floor. Instead of a window, there's what appears to be an exhaust vent. If it's for forced air, though, the fan is currently not running. Mounted on the scaffold is a control panel with two buttons: one indicating up and one indicating down.

>w
Jones climbs inside the vent, crawls along a short length of duct work, and emerges through another, hinged grill, into the air handling room.

Galaxy Jones is in the air handling room. There is a good number of loud fans and other air handling machinery here. A small hinged vent opening leads into some ductwork, and from there to the outside. A door leads west.

She takes off the Atmo-Suit.

>put on suit
Jones needs to be able to move around quickly. Better not wear the Atmo-Suit.

>e
Jones puts on the Atmo-Suit.

Galaxy Jones is on a window washing scaffold. It's lined up with the tenth floor. Instead of a window, there's what appears to be an exhaust vent. If it's for forced air, though, the fan is currently not running. Mounted on the scaffold is a control panel with two buttons: one indicating up and one indicating down.

>push down
(the scaffold down button)
Jones presses the button, and the scaffold begins to descend.

Galaxy Jones is on a window washing scaffold. It's lined up with the ninth floor window. She could climb back into the building through the window here. Mounted on the scaffold is a control panel with two buttons: one indicating up and one indicating down.

>w
Galaxy Jones is in the cybernetica office. It's spacious and luxurious, designed to make developers forget how spent they are from months of overwork and abuse. Ergonomic desks and chairs fill space like a furniture fractal, before giving way to an open area, presumably for group activities. One of the windows along the east side of the office is broken.

The remains of the purple guard robot are sprawled on the ground.

Jones takes off the Atmo-Suit.

>put on suit
Jones needs to be able to move around quickly. Better not wear the Atmo-Suit.

* * *

>w
Galaxy Jones is in the cybernetica office. It's spacious and luxurious, designed to make developers forget how spent they are from months of overwork and abuse. Ergonomic desks and chairs fill space like a furniture fractal, before giving way to an open area, presumably for group activities. One of the windows along the east side of the office is broken.

The remains of the purple guard robot are sprawled on the ground.

Jones takes off the Atmo-Suit.

>i
Jones is carrying:
  a screwdriver
  an Atmo-Suit (being worn)
  a disruptor pistol

* * *

>purloin cable
[Purloined.]

* * *

>gonear cage
(the cage)
Galaxy Jones is next to the cage. The closely-set silnium bars seem to dash all hope of a rescue.

Europa Callisto is lying at the center of the cage, out of Jones's reach.

Jones tries the strength of the bars just in case. They don't budge.

South of the cage, Thallium crosses the roof to the flyer pad, where he boards the waiting flyer. The flyer lifts off and moves towards Jones.

>u
Jones gets onto the cage.

Galaxy Jones is standing on the cage. The closely-set silnium bars seem to dash all hope of a rescue.

Europa Callisto is lying at the center of the cage, out of Jones's reach.

Thallium's flyer hovers over the rooftop. "Jones!"  he bellows. "Play time is over. I grow weary of your intransigence. In a moment this roof will be swarmed by guard robots -- of many different colors -- so many robots you couldn't possibly vandalize them all.  Say your prayers, Jones, or whatever you do when you're about to die."

Jones rolls her eyes.

A little ways off, a small red flyer aims for the rooftop and accelerates.

>d
Jones gets off the cage.

Galaxy Jones is next to the cage. The closely-set silnium bars seem to dash all hope of a rescue.

Europa Callisto is lying at the center of the cage, out of Jones's reach.

>throw cable at rails
Jones throws the cable, but it comes up short. She gathers it up again.

>x rails
There's nothing like that nearby.

>x flyer
Hovering above Jones, it's distinctly menacing. It's not visibly armed, but it conveys the impression of a beast about to strike. It's flying low, the rails of its landing gear just a few feet above Jones's head.

* * *

>d
Jones gets off the cage.

Galaxy Jones is next to the cage. The closely-set silnium bars seem to dash all hope of a rescue.

Europa Callisto is lying at the center of the cage, out of Jones's reach.

>u
Jones gets onto the cage.

Galaxy Jones is standing on the cage. The closely-set silnium bars seem to dash all hope of a rescue.

Europa Callisto is lying at the center of the cage, out of Jones's reach.

>tie hooks to cage
(the cage)

Jones attaches one end of the cable to the cage, and throws the other end up to the flyer where it hooks around the rail, then jumps off the cage to escape the aftermath. Seeing his flyer's predicament, Thallium jumps out of the flyer and disappears below the edge of the roof. The flyer reaches the end of its tether and slingshots downwards, slamming into side of the building.

The cage has tilted to the side, one attachment torn loose from the rooftop. Jones crawls into the cage to see to Europa Callisto.

"Europa! Can you hear me? I need you to move to get out of this cage. I can't carry you through that small opening. Europa!"

Europa moans but doesn't show any signs of having understood Jones.

Galaxy Jones is in the cage. The whole structure is tilted, leaving a hole at the eastern end.

Jones is kneeling at Europa Callisto's side, trying to rouse her.

The red flyer, now recognizable as Galaxy's own, settles down onto the landing pad.

>ask beck about europa
Beck: "You'll need to revive her if you want to get her out of there."

>ask beck for help
Beck: "Congratulations! You made it this far."

Beck sticks his head out of the door of the flyer and yells "C'mon Jones, get Europa and get in the flyer!"

>ask beck for help
Beck: "You need to break Europa out of the cage and get her to a rescue flyer."

>ask beck for help
Beck: "Don't worry, the rescue flyer will show up on time."

>ask beck for help
Beck: "To break open the cage, you'll need to find some way to apply a great force to it."

>ask beck for help
Beck: "Hook the cable to the flyer and the cage by saying THROW CABLE AT FLYER."

>ask beck for help
Beck: "Come up short? Get higher."

>ask beck for help
Beck: "Climb the cage."

>ask beck for help
Beck: "Now throw the cable."

>ask beck for help
Beck: "Now you're in the cage but Europa is unresponsive. How do you revive her?"

>ask beck for help
Beck: "The water of course!"

>give water to europa
There's nothing like that nearby.

* * *

>purloin cable and water
[Purloined.]
[Purloined.]

>gonear cage
(the cage)
Galaxy Jones is next to the cage. The closely-set silnium bars seem to dash all hope of a rescue.

Europa Callisto is lying at the center of the cage, out of Jones's reach.

Jones tries the strength of the bars just in case. They don't budge.

South of the cage, Thallium crosses the roof to the flyer pad, where he boards the waiting flyer. The flyer lifts off and moves towards Jones.

* * *

>restart
Are you sure you want to restart?

* * *

>throw cable at flyer
Jones throws the cable up to the flyer where it hooks around the rail, and attaches the other end to the cage, then jumps off the cage to escape the aftermath. Seeing his flyer's predicament, Thallium jumps out of the flyer and disappears below the edge of the roof. The flyer reaches the end of its tether and slingshots downwards, slamming into side of the building.

The cage has tilted to the side, one attachment torn loose from the rooftop. Jones crawls into the cage to see to Europa Callisto.

"Europa! Can you hear me? I need you to move to get out of this cage. I can't carry you through that small opening. Europa!"

Europa moans but doesn't show any signs of having understood Jones.

Galaxy Jones is in the cage. The whole structure is tilted, leaving a hole at the eastern end.

Jones is kneeling at Europa Callisto's side, trying to rouse her.

The red flyer, now recognizable as Galaxy's own, settles down onto the landing pad.

>ask europa about thallium
There is no reply.

>talk to europa
Jones is already talking to Europa Callisto.

Beck sticks his head out of the door of the flyer and yells "C'mon Jones, get Europa and get in the flyer!"

>europa, help
There is no reply.

>ask europa for help
Jones is more than capable of acquiring things by herself.

>ask beck for help
Beck: "Congratulations! You made it this far."

* * *

>showme elevator door
Which do you mean, the elevator door, the elevator door, the utility door, the elevator room door, the ninth floor elevator door, the elevator car door, or the elevator doors?

* * *

>e
Galaxy Jones is on the roof stairs. Thick slabs of marble lead from the hall to the west to the rooftop door above.

* * *

>w
(first opening the air handling door)

Galaxy Jones is on the north side of the Consolidated Microthings office. This is the company cafeteria. The elevator is south, the air handling room is to the east, and the office continues to the west and southeast.

* * *

>e
Jones puts on the Atmo-Suit.

Galaxy Jones is on a window washing scaffold. It's lined up with the tenth floor. Instead of a window, there's what appears to be an exhaust vent. If it's for forced air, though, the fan is currently not running. Mounted on the scaffold is a control panel with two buttons: one indicating up and one indicating down.

>w
Jones climbs inside the vent, crawls along a short length of duct work, and emerges through another, hinged grill, into the air handling room.

Galaxy Jones is in the air handling room. There is a good number of loud fans and other air handling machinery here. A small hinged vent opening leads into some ductwork, and from there to the outside. A door leads west.

She takes off the Atmo-Suit.

* * *

>sneak up on robot
You can't reach the mauve guard robot.

To the west, the mauve guard robot heads east.

>sneak up on robot
Jones can't reach into the south side of the Consolidated Microthings office.

The mauve guard robot approaches from the west.

The robot electrocutes Jones with its electro-darts.

    *** Jones was killed by the mauve guard robot ***

In that game you scored 6 out of a possible 10, in 69 turns.

Would you like to RESTART, RESTORE a saved game, QUIT, or UNDO the last command?

* * *

>e
(first opening the Martian Chemical door)
(first unlocking the Martian Chemical door)
(with the black cardkey)

Galaxy Jones is in the martian chemical office. This seems like the business office of the chemical company rather than the lab. Most of the room is taken up by desks and other office stuff. There is a cabinet that looks intriguing, however.

>x cabinet
The cabinet is full of bottles of bottle of Electrofil quick-setting conductive polymer gel.

>take bottle
(the full water bottle)
Jones already has that.

>take gel
Jones has already taken one bottle of Electrofil from the cabinet. She should use it before taking another.

* * *

>e
(first opening the Martian Chemical door)
(first unlocking the Martian Chemical door)
(with the black cardkey)

Galaxy Jones is in the martian chemical office. This seems like the business office of the chemical company rather than the lab. Most of the room is taken up by desks and other office stuff. There is a cabinet that looks intriguing, however.

>open cabinet
The cabinet is full of bottles of bottle of Electrofil quick-setting conductive polymer gel.

>x it
The cabinet is full of bottles of bottle of Electrofil quick-setting conductive polymer gel.

>take bottle
(the full water bottle)
Jones already has that.

>take gel
Taken.

>take gel
Jones already has that.

>i
Jones is carrying:
  a bottle of Electrofil quick-setting conductive polymer gel
  a screwdriver
  a black cardkey
  a full water bottle
  a hammer
  an elevator drop key
  a safety pin
  a garish medal
  a fork
  a red cardkey
  an Atmo-Suit
  a cable with hooks at either end
  a disruptor pistol

* * *

>take gel
Jones already has that.

>x cabinet
The cabinet is full of bottles of bottle of Electrofil quick-setting conductive polymer gel.

>w
Galaxy Jones is in the ninth floor south hallway. This anonymous corporate hallway ends here at the south end of the building. An open doorway leads west. To the east is a door with a swipe lock, labeled "Martian Chemical."

>drop gel
Dropped.

>e
Galaxy Jones is in the martian chemical office. This seems like the business office of the chemical company rather than the lab. Most of the room is taken up by desks and other office stuff. There is a cabinet that looks intriguing, however.

>take gel
Jones has already taken one bottle of Electrofil from the cabinet. She should use it before taking another.

>w
Galaxy Jones is in the ninth floor south hallway. This anonymous corporate hallway ends here at the south end of the building. An open doorway leads west. To the east is a door with a swipe lock, labeled "Martian Chemical."

Also here is a bottle of Electrofil quick-setting conductive polymer gel.

>take bottle
(the bottle of Electrofil quick-setting conductive polymer gel)
Taken.

* * *

>u
Jones can't reach into the cage.

>throw cable at flyer
There's nothing like that nearby.

>pour water on europa
There's nothing like that nearby.