>dock
That's not a verb I recognise.

>x dock
Galaxy Jones is in the speeder dock. A safe harbor from the periodic dust storms of Utopia Planitia, the dock features several dozen speeder bays. Only a few are filled right now. The building entryway is to the north, under a red stone façade carved into the likeness of a fearsome Viking.

Jones's speeder, Galaxy One, sits in one of the parking bays.

>gonear map
That's not a verb I recognise.

>gonear map
That's not a verb I recognise.

* * *

>ask beck about me
Beck: "Hmm. Don't have much to say about that right now."

>x beck
You can't see Beck

* * *

>gonear catering
Galaxy Jones is on the east side of the ground floor. Apparently some kind of function was happening here before Admiral Thallium emptied the building, for there is an array of canapes on a catering table here. The floor stretches north and south, and there's a closet door to the west.

Beck: "Blueprints indicate a closet to the west of you. Might be useful."

>eat canapes
Jones is not hungry.

>take canapes
The catering table isn't open.

>take all from table
The catering table isn't open.

* * *

>gonear catering
Galaxy Jones is on the east side of the ground floor. Apparently some kind of function was happening here before Admiral Thallium emptied the building, for there is an array of canapes on a catering table here. The floor stretches north and south, and there's a closet door to the west.

Beck: "Blueprints indicate a closet to the west of you. Might be useful."

>take canape
Taken.

>i
Jones is carrying:
  a shrimp tea sandwich
  a disruptor pistol

>take eggs
There's nothing like that nearby.

>x table
The table is covered with a wide array of treats from the ridiculously expensive, such as shrimp tea sandwiches (where do you get shrimp on Mars?), to the just plain ridiculous, like poached ostrich eggs in jelly. A good number of forks are laid out to one side.

Jones: "What would you like me to bring you, Beck? Shrimp tea sandwiches, or poached ostrich eggs?"

Beck: "Oh, the shrimp. Definitely get the shrimp."

>take eggs
Don't even.

* * *

>gonear elevator room
(the elevator room)
Galaxy Jones is in the elevator room. This is a utility room related to the operation of the elevator, on the other side of the east wall here. There is a control panel on the wall, and a door leading west.

Hanging from a hook here is an elevator drop key.

Lying discarded on a table here is a hammer.

>x controls
There's nothing like that nearby.

>x control
From the looks of it, elevator technology hasn't evolved much since it was first developed. This control panel is a primitive collection of wires, circuit boards, indicator lights, and other components. It also seems to be completely inactive -- none of the lights are on.

>touch control
Playing with the controls for a dangerous piece of equipment she doesn't understand is not something Jones would do.

>press control
Playing with the controls for a dangerous piece of equipment she doesn't understand is not something Jones would do.

>take control
Playing with the controls for a dangerous piece of equipment she doesn't understand is not something Jones would do.

>drop control
Playing with the controls for a dangerous piece of equipment she doesn't understand is not something Jones would do.

>hit control
Playing with the controls for a dangerous piece of equipment she doesn't understand is not something Jones would do.

* * *

>gonear elevator room
(the elevator room)
Galaxy Jones is in the elevator room. This is a utility room related to the operation of the elevator, on the other side of the east wall here. There is a control panel on the wall, and a door leading west.

Hanging from a hook here is an elevator drop key.

Lying discarded on a table here is a hammer.

>x panel
From the looks of it, elevator technology hasn't evolved much since it was first developed. This control panel is a primitive collection of wires, circuit boards, indicator lights, and other components. It also seems to be completely inactive -- none of the lights are on.

>touch panel
Playing with the controls for a dangerous piece of equipment she doesn't understand is not something Jones would do.

>use panel
You'll have to be more specific.

>move panel
It is fixed in place.

>press panel
It is fixed in place.

>press button
There's nothing like that nearby.

* * *

>gonear europa
Galaxy Jones is next to the cage. The closely-set silnium bars seem to dash all hope of a rescue.

Europa Callisto is lying at the center of the cage, out of Jones's reach.

Jones tries the strength of the bars just in case. They don't budge.

South of the cage, Thallium crosses the roof to the flyer pad, where he boards the waiting flyer. The flyer lifts off and moves towards Jones.

>hit europa
Violence isn't the answer to this one.

Thallium's flyer hovers over the rooftop. "Jones!"  he bellows. "Play time is over. I grow weary of your intransigence. In a moment this roof will be swarmed by guard robots -- of many different colors -- so many robots you couldn't possibly vandalize them all.  Say your prayers, Jones, or whatever you do when you're about to die."

Jones rolls her eyes.

A little ways off, a small red flyer aims for the rooftop and accelerates.

>i
Jones is carrying:
  a disruptor pistol

>shoot europa
Shooting her would accomplish nothing.

>take europa
I don't suppose Europa Callisto would care for that.

* * *

>gonear europa
Galaxy Jones is next to the cage. The closely-set silnium bars seem to dash all hope of a rescue.

Europa Callisto is lying at the center of the cage, out of Jones's reach.

Jones tries the strength of the bars just in case. They don't budge.

South of the cage, Thallium crosses the roof to the flyer pad, where he boards the waiting flyer. The flyer lifts off and moves towards Jones.

>purloin water
(the full water bottle)
[Purloined.]

>give water to europa
You can't reach Europa inside the cage.

Thallium's flyer hovers over the rooftop. "Jones!"  he bellows. "Play time is over. I grow weary of your intransigence. In a moment this roof will be swarmed by guard robots -- of many different colors -- so many robots you couldn't possibly vandalize them all.  Say your prayers, Jones, or whatever you do when you're about to die."

Jones rolls her eyes.

A little ways off, a small red flyer aims for the rooftop and accelerates.

>climb cage
(the cage)
Jones gets onto the cage.

>purloin hook
[Purloined.]

>throw hook at flyer
Jones throws the cable up to the flyer where it hooks around the rail, and attaches the other end to the cage, then jumps off the cage to escape the aftermath. Seeing his flyer's predicament, Thallium jumps through the door and disappears below the edge of the roof. The flyer reaches the end of its tether and slingshots downwards, slamming into side of the building.

The cage has tilted to the side, one attachment torn loose from the rooftop. Jones crawls into the cage to see to Europa Callisto.

"Europa! Can you hear me? I need you to move to get out of this cage. I can't carry you through that small opening. Europa!"

Europa moans but doesn't show any signs of having understood Jones.

Galaxy Jones is in the cage. The whole structure is tilted, leaving a hole at the eastern end.

Jones is kneeling at Europa Callisto's side, trying to rouse her.

The red flyer, now recognizable as Galaxy's own, settles down onto the landing pad.

* * *

>undo
Galaxy Jones is in the cage. 
[Previous turn undone.]

>undo
Galaxy Jones is standing on the cage. 
[Previous turn undone.]

>undo
Galaxy Jones is standing on the cage. 
[Previous turn undone.]

>undo
Galaxy Jones is next to the cage. 
[Previous turn undone.]

>europa, hello
Jones is already talking to Europa Callisto.

>ask europa about europa
There is no reply.

* * *

>gonear fakeroom10
Galaxy Jones is in fakeroom10.

* * *

>gonear maintenance closet
Galaxy Jones is in the maintenance closet. 

There is an Atmo-Suit hanging from a hook here.

On the shelf is a red cardkey.

* * *

>gonear map
Galaxy Jones is at the northwest corner of the ground floor. A large relief map of mars is mounted on the north wall here. One can leave here to the south or east.

>take star
That seems to be a part of the large relief map of mars.

>x it
Ah, New Reykjavik! Even colder than Old Reykjavik!

>s
Galaxy Jones is on the west side of the ground floor. Semicircular couches open on either side of a central carpeted path leading north and south. Set in the central pillar of the building to the east is a utility door. The city looms beyond the glass wall to the west.

>s
Galaxy Jones is at the southwest corner of the ground floor. A lush waterfall here contrasts with the dusty red streets of New Reykjavik beyond the glass walls. The ground floor extends north and east.

>x waterfall
The waterfall descends the length of an artificial rock formation fringed by wide-leaved Earth plants and ferns. The water collects in a basin at the bottom, where it begins its journey again. A single coin sits on the bottom of the basin.

>x new reyjavik
There's nothing like that nearby.

>x new reykjavik
Outside the building are the red-dusted streets of New Reykjavik.

>x floor
Yards and yards of white and grey marble, rare for Mars.

* * *

>gonear map
Galaxy Jones is at the northwest corner of the ground floor. A large relief map of mars is mounted on the north wall here. One can leave here to the south or east.

>x map
The map is crafted of bronze and sports a star at the site of New Reykjavik.

>x star
There's nothing like that nearby.

* * *

>gonear north
Which do you mean, the north, the ninth floor north hallway, the north end of the building management office, or the northern corner of the penthouse?

>end
Galaxy Jones is at the north end of the building management office. The building management office is a bunch of desks and task boards. There is a particularly large desk against the west window. The office exit is to the east, and the office continues to the south.

>x task
The writing on the most interesting board is a list of inscrutable tasks:
 1. Describe scenery objects on Engineering Deck
 2. Fix check rule when installing new engine component
 3. Add more facts to computer database
 4. Fix Arvax response to rebooting the ship computer

and etc.

* * *

>gonear north end
Galaxy Jones is at the north end of the building management office. The building management office is a bunch of desks and task boards. There is a particularly large desk against the west window. The office exit is to the east, and the office continues to the south.

>read board
The board says " 1. Describe scenery objects on Engineering Deck
 2. Fix check rule when installing new engine component
 3. Add more facts to computer database
 4. Fix Arvax response to rebooting the ship computer

and etc."

>write hello
There's nothing to write on here.

Now the board says " 1. Describe scenery objects on Engineering Deck
 2. Fix check rule when installing new engine component
 3. Add more facts to computer database
 4. Fix Arvax response to rebooting the ship computer

and etc. hello"

>erase board
That's not a verb I recognise.

* * *

>gonear north end
Galaxy Jones is at the north end of the building management office. The building management office is a bunch of desks and task boards. There is a particularly large desk against the west window. The office exit is to the east, and the office continues to the south.

>x board
There's nothing like that nearby.

>x boards
The writing on the most interesting board is a list of inscrutable tasks:
 1. Describe scenery objects on Engineering Deck
 2. Fix check rule when installing new engine component
 3. Add more facts to computer database
 4. Fix Arvax response to rebooting the ship computer.

and etc.

* * *

>gonear penthouse roof
Galaxy Jones is on the penthouse roof. It is an extravagant and opulent space, designed to showcase Thallium's wealth and power. Much of the rooftop is devoted to an outdoor lounge area, with comfortable seating and a fire pit, centered around a hot tub and flanked by a bar. All around is the city of New Reykjavik, and beyond that the red Martian landscape. Around the entirety of the roof is an electrostatic field designed to keep air in and particulates out. To the north is a large cage, and to the west is a landing pad. Jones can distantly see a woman lying on the floor of the cage. A green and black flyer sits on the landing pad.

Admiral Thallium is sulking.

>b
That's not a verb I recognise.

>n
Galaxy Jones is next to the cage. The closely-set silnium bars seem to dash all hope of a rescue.

Europa Callisto is lying at the center of the cage, out of Jones's reach.

Jones tries the strength of the bars just in case. They don't budge.

South of the cage, Thallium crosses the roof to the flyer pad, where he boards the waiting flyer. The flyer lifts off and moves towards Jones.

>climb cage
(the cage)
Jones gets onto the cage.

Thallium's flyer hovers over the rooftop. "Jones!"  he bellows. "Play time is over. I grow weary of your intransigence. In a moment this roof will be swarmed by guard robots -- of many different colors -- so many robots you couldn't possibly vandalize them all.  Say your prayers, Jones, or whatever you do when you're about to die."

Jones rolls her eyes.

A little ways off, a small red flyer aims for the rooftop and accelerates.

>purloin cbale
There seems to be no such object anywhere in the model world.

>purloin cable
[Purloined.]

>throw cable at flyer
Jones throws the cable up to the flyer where it hooks around the rail, and attaches the other end to the cage, then jumps off the cage to escape the aftermath. Seeing his flyer's predicament, Thallium jumps through the door and disappears below the edge of the roof. The flyer reaches the end of its tether and slingshots downwards, slamming into side of the building.

The cage has tilted to the side, one attachment torn loose from the rooftop. Jones crawls into the cage to see to Europa Callisto.

"Europa! Can you hear me? I need you to move to get out of this cage. I can't carry you through that small opening. Europa!"

Europa moans but doesn't show any signs of having understood Jones.

Galaxy Jones is in the cage. The whole structure is tilted, leaving a hole at the eastern end.

Jones is kneeling at Europa Callisto's side, trying to rouse her.

The red flyer, now recognizable as Galaxy's own, settles down onto the landing pad.

>x flyer
There's nothing like that nearby.

* * *

>n
Galaxy Jones is next to the cage. The closely-set silnium bars seem to dash all hope of a rescue.

Europa Callisto is lying at the center of the cage, out of Jones's reach.

Jones tries the strength of the bars just in case. They don't budge.

South of the cage, Thallium crosses the roof to the flyer pad, where he boards the waiting flyer. The flyer lifts off and moves towards Jones.

>purloin cable
[Purloined.]

>z
Jones stands around and waits.

Thallium's flyer hovers over the rooftop. "Jones!"  he bellows. "Play time is over. I grow weary of your intransigence. In a moment this roof will be swarmed by guard robots -- of many different colors -- so many robots you couldn't possibly vandalize them all.  Say your prayers, Jones, or whatever you do when you're about to die."

Jones rolls her eyes.

A little ways off, a small red flyer aims for the rooftop and accelerates.

>get on cage
(the cage)
Jones gets onto the cage.

>throw cable at flyer
Jones throws the cable up to the flyer where it hooks around the rail, and attaches the other end to the cage, then jumps off the cage to escape the aftermath. Seeing his flyer's predicament, Thallium jumps out of the flyer and disappears below the edge of the roof. The flyer reaches the end of its tether and slingshots downwards, slamming into side of the building.

The cage has tilted to the side, one attachment torn loose from the rooftop. Jones crawls into the cage to see to Europa Callisto.

"Europa! Can you hear me? I need you to move to get out of this cage. I can't carry you through that small opening. Europa!"

Europa moans but doesn't show any signs of having understood Jones.

Galaxy Jones is in the cage. The whole structure is tilted, leaving a hole at the eastern end.

Jones is kneeling at Europa Callisto's side, trying to rouse her.

The red flyer, now recognizable as Galaxy's own, settles down onto the landing pad.

* * *

>z
Jones stands around and waits.

Thallium's flyer hovers over the rooftop. "Jones!"  he bellows. "Play time is over. I grow weary of your intransigence. In a moment this roof will be swarmed by guard robots -- of many different colors -- so many robots you couldn't possibly vandalize them all.  Say your prayers, Jones, or whatever you do when you're about to die."

Jones rolls her eyes.

A little ways off, a small red flyer aims for the rooftop and accelerates.

>throw cable at flyer
Jones throws the cable, but it comes up short. She gathers it up again.

>attach cable to cage
(the cage)
It doesn't seem useful to attach the cable to this part of the cage.

>actions
Actions listing on.

>attach cable to cage
(the cage)
[tying the cable with hooks at either end to the cage]
Jones would achieve nothing by this.
[tying the cable with hooks at either end to the cage - failed the block tying rule]

* * *

>attach cable to cage
(the cage)
It doesn't seem useful to attach the cable to this part of the cage.

>get on cage
(the cage)
Jones gets onto the cage.

>attach hook to cage
(the cage)

Jones attaches one end of the cable to the cage, and throws the other end up to the flyer where it hooks around the rail, then jumps off the cage to escape the aftermath. Seeing his flyer's predicament, Thallium jumps out of the flyer and disappears below the edge of the roof. The flyer reaches the end of its tether and slingshots downwards, slamming into side of the building.

The cage has tilted to the side, one attachment torn loose from the rooftop. Jones crawls into the cage to see to Europa Callisto.

"Europa! Can you hear me? I need you to move to get out of this cage. I can't carry you through that small opening. Europa!"

Europa moans but doesn't show any signs of having understood Jones.

Galaxy Jones is in the cage. The whole structure is tilted, leaving a hole at the eastern end.

Jones is kneeling at Europa Callisto's side, trying to rouse her.

The red flyer, now recognizable as Galaxy's own, settles down onto the landing pad.

>x flyer
There's nothing like that nearby.

>z
Jones stands around and waits.

>z
Jones stands around and waits.

Beck sticks his head out of the door of the flyer and yells "C'mon Jones, get Europa and get in the flyer!"

* * *

>throw cable at flyer
Jones throws the cable, but it comes up short. She gathers it up again.

>i
Jones is carrying:
  a cable with hooks at either end
  a disruptor pistol

* * *

>throw cable at flyer
Jones throws the cable, but it comes up short. She gathers it up again.

>throw hook at flyer
Jones throws the cable, but it comes up short. She gathers it up again.

>get on cage
(the cage)
Jones gets onto the cage.

>hook cable to cage
That's not a verb I recognise.

>attach cable to cage
(the cage)
Jones would achieve nothing by this.

* * *

>z
Jones stands around and waits.

Thallium's flyer hovers over the rooftop. "Jones!"  he bellows. "Play time is over. I grow weary of your intransigence. In a moment this roof will be swarmed by guard robots -- of many different colors -- so many robots you couldn't possibly vandalize them all.  Say your prayers, Jones, or whatever you do when you're about to die."

Jones rolls her eyes.

A little ways off, a small red flyer aims for the rooftop and accelerates.

>x red flyer
There's nothing like that nearby.

>x flyer
Hovering above Jones, it's distinctly menacing. It's not visibly armed, but it conveys the impression of a beast about to strike. It's flying low, the rails of its landing gear just a few feet above Jones's head.

>get on cage
(the cage)
Jones gets onto the cage.

* * *

>x flyer
Jones's little red flyer, Galaxy Two.

* * *

>gonear south end
Galaxy Jones is at the south end of the building management office. The building management office is a bunch of desks and task boards. There is a filing cabinet against the east wall. The office exit is to the east, and the office continues to the north.

A screwdriver sits atop the filing cabinet.

>open files
Jones has better things to do but look through reams of personnel records.

* * *

>gonear south end
Galaxy Jones is at the south end of the building management office. The building management office is a bunch of desks and task boards. There is a filing cabinet against the east wall. The office exit is to the east, and the office continues to the north.

A screwdriver sits atop the filing cabinet.

>read board
The board says "Jones is coming, surprise day off!".

>erase board
Now the board is blank.

>write foo
Now the board says " foo".

>read board
The board says " foo".

>n
Galaxy Jones is at the north end of the building management office. The building management office is a bunch of desks and task boards. There is a particularly large desk against the west window. The office exit is to the east, and the office continues to the south.

>read board
The board says "1. Describe scenery objects on Engineering Deck
 2. Fix check rule when installing new engine component
 3. Add more facts to computer database
 4. Fix Arvax response to rebooting the ship computer

and etc.".

>s
Galaxy Jones is at the south end of the building management office. The building management office is a bunch of desks and task boards. There is a filing cabinet against the east wall. The office exit is to the east, and the office continues to the north.

A screwdriver sits atop the filing cabinet.

>read board
The board says " foo".

>open cabinet
Jones has better things to do than look through reams of personnel records.

>e
Galaxy Jones is in the ninth floor south hallway. This anonymous corporate hallway ends here at the south end of the building. An open doorway leads west. To the east is a door labeled "Martian Chemical"

* * *

>e
(first opening the Martian Chemical door)
(first unlocking the Martian Chemical door)
Jones lacks a key that fits the Martian Chemical door.

>gonear elevator room
(the elevator room)
Galaxy Jones is in the elevator room. This is a utility room related to the operation of the elevator, on the other side of the east wall here. There is a control panel on the wall, and a door leading west.

Hanging from a hook here is an elevator drop key.

Lying discarded on a table here is a hammer.

>x control panel
From the looks of it, elevator technology hasn't evolved much since it was first developed. This control panel is a primitive collection of wires, circuit boards, indicator lights, and other components. It also seems to be completely inactive -- none of the lights are on.

>x wires
From the looks of it, elevator technology hasn't evolved much since it was first developed. This control panel is a primitive collection of wires, circuit boards, indicator lights, and other components. It also seems to be completely inactive -- none of the lights are on.

>x boards
From the looks of it, elevator technology hasn't evolved much since it was first developed. This control panel is a primitive collection of wires, circuit boards, indicator lights, and other components. It also seems to be completely inactive -- none of the lights are on.

>x lights
From the looks of it, elevator technology hasn't evolved much since it was first developed. This control panel is a primitive collection of wires, circuit boards, indicator lights, and other components. It also seems to be completely inactive -- none of the lights are on.

>x components
From the looks of it, elevator technology hasn't evolved much since it was first developed. This control panel is a primitive collection of wires, circuit boards, indicator lights, and other components. It also seems to be completely inactive -- none of the lights are on.

>touch it
Playing with the controls for a dangerous piece of equipment she doesn't understand is not something Jones would do.

>take it
Playing with the controls for a dangerous piece of equipment she doesn't understand is not something Jones would do.

>cut wires
Playing with the controls for a dangerous piece of equipment she doesn't understand is not something Jones would do.

>purloin cable
[Purloined.]

>attach cable to e
You must name something more substantial.

>attach cable to me
Jones would achieve nothing by this.

>purloin fork
[Purloined.]

>gonear diamond
Which do you mean, the real diamond or the diamond?

>real
Galaxy Jones is in the room of stuff. 

Also here is a real diamond.

>gonear 100th
Galaxy Jones is in the 100th floor elevator hall. The luxury is staggering.  The walls are made of polished black marble, and the floors are covered in plush black carpeting that muffles the sound of footsteps. The ceiling is high and adorned with a crystal chandelier. The elevator doors to the west are gold-plated. Sumptuous living quarters are visible to the north and south.

>s
Galaxy Jones is in the southern corner of the penthouse. This must be Thallium's "treasure room", to go by the obscene display of wealth. The most notable feature is the array of diamonds lining the walls. Everything else here pales in comparison. The penthouse continues to the northwest, north, and northeast.

Thallium seems to speak from all around you. "You like diamonds, Jones? Of course you do -- they're a girl's best friend, after all."

Jones snorts, "Sure, Thallium."

>hit diamonds with fork
Violence isn't the answer to this one.

>purloin hammer
[Purloined.]

>hit diamonds with fork
Violence isn't the answer to this one.

>hit diamonds
(with the hammer)
Jones commences to smash all of the diamonds. After destroying several dozen fraudulent gems, she finds one that won't break. She takes the real diamond.

Thallium: "Wow, clever solution. Be careful you don't cut yourself."

Jones: "I appreciate your concern."

>sw
Jones can't go that way. The obvious exits are north (to the 100th floor elevator hall), northeast and northwest.

>nw
Galaxy Jones is in the western corner of the penthouse. The purpose of this room is unclear. Instead of the black carpet that plagues the rest of the penthouse, the floor is fashioned from a striking polished red granite. Instead of windows, there are walls. Thallium's personal insignia, the nine planets in order overlaid with the motto "Planetas Vincam", is carved into the deep red wood outer wall, and inlaid with ebony. In the center of the room is a thin metal pillar ending in a claw, which looks like it's meant to hold something. Finally, there is something that looks like an electronic eye set into the inner wall. One may leave to the northeast or southeast.

* * *

>x panel
Jones discovers a secret panel, which when opened exposes a small black button.

>ne
Galaxy Jones is in the northern corner of the penthouse. This is Thallium's bedroom. Apart from the expansive round bed in the center of the room, notable features include the line of dummies displaying his various suits of clothes, a large vanity table, and the complete lack of mirrors on the ceiling, thankfully. One may leave the room to the southwest, south, and southeast.

>s
Galaxy Jones is in the 100th floor elevator hall. The luxury is staggering.  The walls are made of polished black marble, and the floors are covered in plush black carpeting that muffles the sound of footsteps. The ceiling is high and adorned with a crystal chandelier. The elevator doors to the west are gold-plated. Sumptuous living quarters are visible to the north and south.

>e
Galaxy Jones is on the roof stairs. Thick slabs of marble lead from the hall to the west to the rooftop door above.

>w
Galaxy Jones is in the 100th floor elevator hall. The luxury is staggering.  The walls are made of polished black marble, and the floors are covered in plush black carpeting that muffles the sound of footsteps. The ceiling is high and adorned with a crystal chandelier. The elevator doors to the west are gold-plated. Sumptuous living quarters are visible to the north and south.

>w
Galaxy Jones is in the placeholder room.

>e
Galaxy Jones is in the 100th floor elevator hall. The luxury is staggering.  The walls are made of polished black marble, and the floors are covered in plush black carpeting that muffles the sound of footsteps. The ceiling is high and adorned with a crystal chandelier. The elevator doors to the west are gold-plated. Sumptuous living quarters are visible to the north and south.

>w
Galaxy Jones is in the placeholder room.

* * *

>e
Galaxy Jones is in the 100th floor elevator hall. The luxury is staggering.  The walls are made of polished black marble, and the floors are covered in plush black carpeting that muffles the sound of footsteps. The ceiling is high and adorned with a crystal chandelier. The elevator doors to the west are gold-plated. Sumptuous living quarters are visible to the north and south.

>e
Galaxy Jones is on the roof stairs. Thick slabs of marble lead from the hall to the west to the rooftop door above.

* * *

>read board
The board says "Jones is coming, surprise day off!".

>write goo
There's nothing to write on here.

That can't be erased
Now the board says "Jones is coming, surprise day off! goo"

>x board
The board says "Jones is coming, surprise day off! goo".

>erase board
Now the board is blank.

>x board
The board is blank.

>write aldhfasldf
There's nothing to write on here.

That can't be erased
Now the board says " aldhfasldf"

>read board
The board says " aldhfasldf".

* * *

>read board
The board says "Jones is coming, surprise day off!".

>write hello
There's nothing to write on here.

Now the board says " hello"

>actions
Actions listing on.

>write hello
[writing "hello"]
[writing "hello" - succeeded]

* * *

>write hello
There's nothing to write on here.

Now the board says " hello"

>read board
Someone has scrawled on the board in green marker, "Jones is coming, surprise day off!"

* * *

>gonear south end
Galaxy Jones is at the south end of the building management office. The building management office is a bunch of desks and task boards. There is a filing cabinet against the east wall. The office exit is to the east, and the office continues to the north.

A screwdriver sits atop the filing cabinet.

>write asdfasdf
Now the board says "Jones is coming, surprise day off! asdfasdf"

* * *

>gonear south end
Galaxy Jones is at the south end of the building management office. The building management office is a bunch of desks and task boards. There is a filing cabinet against the east wall. The office exit is to the east, and the office continues to the north.

A screwdriver sits atop the filing cabinet.

>x board
Someone has scrawled on the board in green marker, "Jones is coming, surprise day off!"

>x files
An ordinary filing cabinet, with five drawers. The label on the front says "Personnel Records".

>open it
Jones has better things to do than look through reams of personnel records.

>erase board
That's not a verb I recognise.

>write
That's not a verb I recognise.

* * *

>gonear south end
Galaxy Jones is at the south end of the building management office. The building management office is a bunch of desks and task boards. There is a filing cabinet against the east wall. The office exit is to the east, and the office continues to the north.

A screwdriver sits atop the filing cabinet.

>x files
An ordinary filing cabinet, with five drawers. The label on the front say "Personnel Records".

>open it
Jones has better things to do but look through reams of personnel records.

She opens the filing cabinet.

* * *

>gonear table
Galaxy Jones is on the east side of the ground floor. Apparently some kind of function was happening here before Admiral Thallium emptied the building, for there is an array of canapes on a catering table here. The floor stretches north and south, and there's a closet door to the west.

Beck: "Blueprints indicate a closet to the west of you. Might be useful."

>eat canape
Jones is not hungry.

>eat canapes
Jones is not hungry.

>take canape
The table is covered with a wide array of treats from the ridiculously expensive, such as shrimp tea sandwiches (where do you get shrimp on Mars?), to the just plain ridiculous, like poached ostrich eggs in jelly. A good number of forks are laid out to one side.

Jones: "What would you like me to bring you, Beck? Shrimp tea sandwiches, or poached ostrich eggs?"

Beck: "Oh, the shrimp. Definitely get the shrimp."

* * *

>gonear table
Galaxy Jones is on the east side of the ground floor. Apparently some kind of function was happening here before Admiral Thallium emptied the building, for there is an array of canapes on a catering table here. The floor stretches north and south, and there's a closet door to the west.

Beck: "Blueprints indicate a closet to the west of you. Might be useful."

>take canapes
The catering table isn't open.

>open canapes
It isn't something Jones can open.

>x canapes
The table is covered with a wide array of treats from the ridiculously expensive, such as shrimp tea sandwiches (where do you get shrimp on Mars?), to the just plain ridiculous, like poached ostrich eggs in jelly. A good number of forks are laid out to one side.

Jones: "What would you like me to bring you, Beck? Shrimp tea sandwiches, or poached ostrich eggs?"

Beck: "Oh, the shrimp. Definitely get the shrimp."

* * *

>gonear table
Galaxy Jones is on the east side of the ground floor. Apparently some kind of function was happening here before Admiral Thallium emptied the building, for there is an array of canapes on a catering table here. The floor stretches north and south, and there's a closet door to the west.

Beck: "Blueprints indicate a closet to the west of you. Might be useful."

>take fork
There's nothing like that nearby.

>x table
The table is covered with a wide array of treats from the ridiculously expensive, such as shrimp tea sandwiches (where do you get shrimp on Mars?), to the just plain ridiculous, like poached ostrich eggs in jelly. A good number of forks are laid out to one side.

Jones: "What would you like me to bring you, Beck? Shrimp tea sandwiches, or poached ostrich eggs?"

Beck: "Oh, the shrimp. Definitely get the shrimp."

>x eggs
Definitely not to Jones's taste.

Jones: "You ever have poached ostrich eggs, Beck?"

Beck: "No, but I'll take you for some when you're done there."

Jones: "Oh, thanks."

>x fork
A very stylish silver-plated fork.

>take it
Taken.

>take canape
Taken.

>take canapes
Jones already has that.

>i
Jones is carrying:
  a shrimp tea sandwich
  a fork
  a disruptor pistol

>eat table
Jones is not hungry.

* * *

>gonear table
Galaxy Jones is on the east side of the ground floor. Apparently some kind of function was happening here before Admiral Thallium emptied the building, for there is an array of canapes on a catering table here. The floor stretches north and south, and there's a closet door to the west.

Beck: "Blueprints indicate a closet to the west of you. Might be useful."

>take shrimp
There's nothing like that nearby.

>x table
The table is covered with a wide array of treats from the ridiculously expensive, such as shrimp tea sandwiches (where do you get shrimp on Mars?), to the just plain ridiculous, like poached ostrich eggs in jelly. A good number of forks are laid out to one side.

Jones: "What would you like me to bring you, Beck? Shrimp tea sandwiches, or poached ostrich eggs?"

Beck: "Oh, the shrimp. Definitely get the shrimp."

>take shrimp
Taken.

>x eggs
Definitely not to Jones's taste.

Jones: "You ever have poached ostrich eggs, Beck?"

Beck: "No, but I'll take you for some when you're done there."

Jones: "Oh, thanks."

>take it
Don't even.

>eat it
Sorry, no.

>purloin hammer
[Purloined.]

* * *

>actions
Actions listing on.

>hit table with hammer
[attacking the catering table with the hammer]
[attacking the catering table with the hammer - succeeded]

* * *

>gonear table
Galaxy Jones is on the east side of the ground floor. Apparently some kind of function was happening here before Admiral Thallium emptied the building, for there is an array of canapes on a catering table here. The floor stretches north and south, and there's a closet door to the west.

Beck: "Blueprints indicate a closet to the west of you. Might be useful."

>take table
There are so many things on the table. You might want to look at them and decide what you want
That's hardly portable.

>look at canapes
The table is covered with a wide array of treats from the ridiculously expensive, such as shrimp tea sandwiches (where do you get shrimp on Mars?), to the just plain ridiculous, like poached ostrich eggs in jelly. A good number of forks are laid out to one side.

Jones: "What would you like me to bring you, Beck? Shrimp tea sandwiches, or poached ostrich eggs?"

Beck: "Oh, the shrimp. Definitely get the shrimp."

>take all from table
fork: Taken.
shrimp tea sandwich: Taken.
poached ostrich eggs in jelly: Don't even.

* * *

>gonear waterfall
Galaxy Jones is at the southwest corner of the ground floor. A lush waterfall here contrasts with the dusty red streets of New Reykjavik beyond the glass walls. The ground floor extends north and east.

>x waterfall
The waterfall descends the length of an artificial rock formation fringed by wide-leaved Earth plants and ferns. The water collects in a basin at the bottom, where it begins its journey again. A single coin sits on the bottom of the basin.

>x plants
Imported plants are a must on Mars, to relieve the stress of living on a lifeless world.

>x ferns
Imported plants are a must on Mars, to relieve the stress of living on a lifeless world.

>look up
The whole ground floor is bright and airy, its ceiling covered with reflective pyramids. Supporting struts criss-cross the area, from which sparkling crystal chandeliers are suspended.

* * *

>hit beck
Beck is just a voice in your ear.

>hit beck with hammer
There's nothing like that nearby.

>purloin hammer
[Purloined.]

>hit beck with hammer
Beck is just a voice in your ear.

>touch beck
Beck is just a voice in your ear.

* * *

>hit beck
Beck is just a voice in your ear.

>touch beck
Beck is just a voice in your ear.

>take beck
Beck is just a voice in your ear.

>gonear elevator room
(the elevator room)
Galaxy Jones is in the elevator room. This is a utility room related to the operation of the elevator, on the other side of the east wall here. There is a control panel on the wall, and a door leading west.

Hanging from a hook here is an elevator drop key.

Lying discarded on a table here is a hammer.

* * *

>l
Galaxy Jones is in the speeder dock. A safe harbor from the periodic dust storms of Utopia Planitia, the dock features several dozen speeder bays. Only a few are filled right now. The building entryway is to the north, under a red stone façade carved into the likeness of a fearsome Viking.

Jones's speeder, Galaxy One, sits in one of the parking bays.

>;
That's not a verb I recognise.

>l
Galaxy Jones is in the speeder dock. A safe harbor from the periodic dust storms of Utopia Planitia, the dock features several dozen speeder bays. Only a few are filled right now. The building entryway is to the north, under a red stone façade carved into the likeness of a fearsome Viking.

Jones's speeder, Galaxy One, sits in one of the parking bays.

>s
Jones can't go that way. The only obvious exit is north.

>n
Jones approaches the Viking Building entryway, the dramatic façade towering over her.

Galaxy Jones is at the entry doorway. A glass revolving door leads into a large open space north of here. The speeder dock is to the south.

>s
Jones slinks back to the speeder dock.

Galaxy Jones is in the speeder dock. A safe harbor from the periodic dust storms of Utopia Planitia, the dock features several dozen speeder bays. Only a few are filled right now. The building entryway is to the north, under a red stone façade carved into the likeness of a fearsome Viking.

Her speeder, Galaxy One, sits in one of the parking bays.

* * *

>n
Jones approaches the Viking Building entryway, the dramatic façade towering over her.

Galaxy Jones is at the entry doorway. A glass revolving door leads into a large open space north of here. The speeder dock is to the south.

Jones peers upwards at the 100 stories of glass and steel. "What do you want to bet Thallium's got Europa all the way at the top?"

Beck: "Oh, no doubt."

I beg your pardon?

>n
Jones takes a deep breath. "I'm going in."

Beck replies, "You got this, Galaxy."

Jones passes through the revolving door and into the lobby, alert to any defenses.

Galaxy Jones is in the lobby. The ground floor of the Viking Building is breathtaking. Low-G architecture means more glass and thinner supports, and the building takes advantage of that. Four walls of glass surround a central pillar in which are set the utility rooms and elevators. In between is an expanse of plants, water installations, and stylish seating. Near the entryway is a front desk. A giant crystal sculpture floats above the center of the area, suspended on almost invisible cables. She may go east and west from here, north to the elevators, or south out of the building.

Suddenly two robot guards, green and red, emerge from niches in the back wall! She dives behind the front desk and draws her disruptor pistol.

Jones shouts, "I'm under fire from two ugly robot things!"

Beck responds, "Monitoring your suit radar."

>shoot art
Jones fires the disruptor into the sculpture's main support cable, snapping it. The huge crystal blob starts to sag, straining the other cables. In quick succession they break as well, and the whole installation plummets to the ground, right on top of the hapless guard robots.
 _________      __                     _____                     
 __/ ____/___ _/ /___ __  ____  __     __/ /___  ____  ___  _____
 _/ / __/ __ `/ / __ `/ |/ / / / /____ _/ / __ \/ __ \/ _ \/ ___/
 / /_/ / /_/ / / /_/ />  </ /_/ / _/ /_/ / /_/ / / / /  __(__  ) 
 \____/\__,_/_/\__,_/_/|_|\__, /  _\____/\____/_/ /_/\___/____/  
 _____________________________/ 

[Your score has just gone up by one point.]

Beck: "What was that crash? What's going on?"

Jones: "That, my friend, was what you'd call a work of art. Targets terminated."

>purloin drop key
Which do you mean, the elevator drop key or the drop key hole?

* * *

>elevator
Which do you mean, the elevator drop key or the drop key hole?

>gonear elevator room
(the elevator room)
Galaxy Jones is in the elevator room. This is a utility room related to the operation of the elevator, on the other side of the east wall here. There is a control panel on the wall, and a door leading west.

Hanging from a hook here is an elevator drop key.

Lying discarded on a table here is a hammer.

>take all
elevator drop key: Taken.
hammer: Taken.
elevator room: That doesn't make sense.

>w
(first opening the elevator room door)

Galaxy Jones is on the west side of the ground floor. Semicircular couches open on either side of a central carpeted path leading north and south. Set in the central pillar of the building to the east is a utility door. The city looms beyond the glass wall to the west.

>s
Galaxy Jones is at the southwest corner of the ground floor. A lush waterfall here contrasts with the dusty red streets of New Reykjavik beyond the glass walls. The ground floor extends north and east.

* * *

>w
(first opening the elevator door)
Jones can't just open the elevator with her hands.

>open door with drop key
(the elevator drop key)
Jones inserts the elevator drop key into the drop key hole and turns it, disengaging the lock mechanism. Then she slides the door open.

>w
Jones climbs into the elevator shaft

Galaxy Jones is in the ground floor elevator shaft. She is at the bottom of a dark well. Shining her suit light up, she can see that the elevator car is several floors up, unmoving. There is a ladder running up the wall next to the door.

>u
Jones climbs up the shaft, stopping at each floor to test each door. She gets all the way to ninth floor, directly below the elevator car, before finding one that opens.

Galaxy Jones is in the ninth floor elevator shaft. The door here is closed.

>e
(first opening the ninth floor elevator door)
 _________      __                     _____                     
 __/ ____/___ _/ /___ __  ____  __     __/ /___  ____  ___  _____
 _/ / __/ __ `/ / __ `/ |/ / / / /____ _/ / __ \/ __ \/ _ \/ ___/
 / /_/ / /_/ / / /_/ />  </ /_/ / _/ /_/ / /_/ / / / /  __(__  ) 
 \____/\__,_/_/\__,_/_/|_|\__, /  _\____/\____/_/ /_/\___/____/  
 _____________________________/ 

[Your score has just gone up by one point.]

Jones: "Finally out of the shaft. That was quite a climb."

Beck: "This floor is just offices. Check the building management office to the west. It might have some useful stuff."

Galaxy Jones is in the ninth floor elevator hall. The elevator is to the west, the stairwell is to the east, and a corridor leads north and south. There is a bottled water vending machine here.

>w
(first opening the ninth floor elevator door)

Galaxy Jones is in the ninth floor elevator shaft. The door here is closed.

>d
Galaxy Jones is in the ground floor elevator shaft. Jones is at the bottom of a dark well. Shining her suit light up, she can see that the elevator car is several floors up, unmoving. There is a ladder running up the wall next to the door.

* * *

>e
Jones crosses the floor carefully, disruptor pistol at the ready.

Galaxy Jones is at the southeast corner of the ground floor. The centerpiece of this area is the actual Viking 2 lander, which landed right here on Utopia Planitia. The glass walls look out onto the city. She can go north or west from here.

>x city
There's nothing like that nearby.

>x streets
There's nothing like that nearby.

>n
Galaxy Jones is on the east side of the ground floor. Apparently some kind of function was happening here before Admiral Thallium emptied the building, for there is an array of canapes on a catering table here. The floor stretches north and south, and there's a closet door to the west.

Beck: "Blueprints indicate a closet to the west of you. Might be useful."

>x streets
There's nothing like that nearby.

>x city
There's nothing like that nearby.

>showme
the east side of the ground floor - ground-floor
    central pillar - backdrop
        claw (part of central pillar) - open container
    ceiling - backdrop
    floor - backdrop
    outside - backdrop
    Jones - person
        disruptor pistol
    closet door - locked door
        keypad (part of closet door)
    catering table - pseudocontainer
        *fork
        *shrimp tea sandwich
        *poached ostrich eggs in jelly
* denotes things which are not in scope

>x outside
Jones can't look outside here.

>restart
Are you sure you want to restart?

* * *

>x outside
Jones can't look outside here.

>n
Jones approaches the Viking Building entryway, the dramatic façade towering over her.

Galaxy Jones is at the entry doorway. A glass revolving door leads into a large open space north of here. The speeder dock is to the south.

Jones peers upwards at the 100 stories of glass and steel. "What do you want to bet Thallium's got Europa all the way at the top?"

Beck: "Oh, no doubt."

>x outside
Jones can't look outside here.

>n
Jones takes a deep breath. "I'm going in."

Beck replies, "You got this, Galaxy."

Jones passes through the revolving door and into the lobby, alert to any defenses.

Galaxy Jones is in the lobby. The ground floor of the Viking Building is breathtaking. Low-G architecture means more glass and thinner supports, and the building takes advantage of that. Four walls of glass surround a central pillar in which are set the utility rooms and elevators. In between is an expanse of plants, water features, and stylish seating. Near the entryway is a front desk. A giant crystal sculpture floats above the center of the area, suspended on almost invisible cables. She may go east and west from here, north to the elevators, or south out of the building.

Suddenly two robot guards, green and red, emerge from niches in the back wall! She dives behind the front desk and draws her disruptor pistol.

Jones shouts, "I'm under fire from two ugly robot things!"

Beck responds, "Monitoring your suit radar."

>x outside
Jones can't look outside here.

Beck: "Robot on your right!"

One robot tries to flank her, but a shot from her disruptor sends it scurrying back.

>shoot art
Jones fires the disruptor into the sculpture's main support cable, snapping it. The huge crystal blob starts to sag, straining the other cables. In quick succession they break as well, and the whole installation plummets to the ground, right on top of the hapless guard robots.
 _________      __                     _____                     
 __/ ____/___ _/ /___ __  ____  __     __/ /___  ____  ___  _____
 _/ / __/ __ `/ / __ `/ |/ / / / /____ _/ / __ \/ __ \/ _ \/ ___/
 / /_/ / /_/ / / /_/ />  </ /_/ / _/ /_/ / /_/ / / / /  __(__  ) 
 \____/\__,_/_/\__,_/_/|_|\__, /  _\____/\____/_/ /_/\___/____/  
 _____________________________/ 

[Your score has just gone up by one point.]

Beck: "What was that crash? What's going on?"

Jones: "That, my friend, was what you'd call a work of art. Targets terminated."

* * *

>w
Jones crosses the floor carefully, disruptor pistol at the ready.

Galaxy Jones is at the southwest corner of the ground floor. A lush waterfall here contrasts with the dusty red streets of New Reykjavik beyond the glass walls. The ground floor extends north and east.

>x outside
Jones can't look outside here.

>x city
There's nothing like that nearby.

* * *

>n
Galaxy Jones is on the west side of the ground floor. Semicircular couches open on either side of a central carpeted path leading north and south. Set in the central pillar of the building to the east is a utility door. The city looms beyond the glass wall to the west.

>purloin red cardkey
[Purloined.]

>swipe cardkey
What should Jones swipe the red cardkey in?

>door
She unlocks the utility door.

>swipe pistol
There's nothing like that nearby.

>i
Jones is carrying:
  a red cardkey
  a disruptor pistol

>swipe cardkey
What should Jones swipe the red cardkey in?

>trace 5
[Parser tracing set to level 5.]

>swipe pistol
[ "swipe" swipe / "pistol" pistol ]
[Parsing for the verb 'swipe' (1 lines)]

[line 0 * noun=Routine(529766) 'in' / 'through' noun -> Unlock reverse]
 [line 0 token 1 word 2 : noun=Routine(529766)]
  [Object list from word 2]
  [Calling NounDomain on location and actor]
   [NounDomain called at word 2
   seeking definite object
    Trying the red cardkey (942689) at word 2
Parse_name called
Pass 1: 0 Pass 2: 0 Pass 3: 0
    Trying the red cardkey (942689) at word 2
Parse_name called
Pass 1: 0 Pass 2: 0 Pass 3: 0
   [ND made 0 matches]
  [token resulted in failure with error type 5]
There's nothing like that nearby.

* * *

>purloin red cardkey
[Purloined.]

>swipe pistol
What should Jones swipe the disruptor pistol through?

>door
That can't be swiped.

>swipe cardkey
What should Jones swipe the red cardkey through?

>door
She unlocks the utility door.

* * *

>purloin red cardkey
[Purloined.]

>swipe red
What should Jones swipe the red cardkey through?

>swipe pistol
There's nothing like that nearby.

>swipe pistol
There's nothing like that nearby.

* * *

>x seating
The ground is floor is huge and made for holding people comfortably. Thus the hundreds of seats amidst Earth pleasures such as water and living green plants.

>x plants
The ground is floor is huge and made for holding people comfortably. Thus the hundreds of seats amidst Earth pleasures such as water and living green plants.

>x water
The ground is floor is huge and made for holding people comfortably. Thus the hundreds of seats amidst Earth pleasures such as water and living green plants.

>restart
Are you sure you want to restart?

* * *

>n
Jones approaches the Viking Building entryway, the dramatic façade towering over her.

Galaxy Jones is at the entry doorway. A glass revolving door leads into a large open space north of here. The speeder dock is to the south.

Jones peers upwards at the 100 stories of glass and steel. "What do you want to bet Thallium's got Europa all the way at the top?"

Beck: "Oh, no doubt."

>n
Jones takes a deep breath. "I'm going in."

Beck replies, "You got this, Galaxy."

Jones passes through the revolving door and into the lobby, alert to any defenses.

Galaxy Jones is in the lobby. The ground floor of the Viking Building is breathtaking. Low-G architecture means more glass and thinner supports, and the building takes advantage of that. Four walls of glass surround a central pillar in which are set the utility rooms and elevators. In between is an expanse of plants, water installations, and stylish seating. Near the entryway is a front desk. A giant crystal sculpture floats above the center of the area, suspended on almost invisible cables. She may go east and west from here, north to the elevators, or south out of the building.

Suddenly two robot guards, green and red, emerge from niches in the back wall! She dives behind the front desk and draws her disruptor pistol.

Jones shouts, "I'm under fire from two ugly robot things!"

Beck responds, "Monitoring your suit radar."

>x installation
Which do you mean, the lobby-background or the giant sculpture?

* * *

>x first floor
Outside the building are the red-dusted streets of New Reykjavik.

Beck: "Robot on your right!"

One robot tries to flank Jones, but a shot from her disruptor sends it scurrying back.
Beck: "How's it going in there?"

"Jones: "You know -- like all art, it's hit or miss."

>showme first floor
outside - backdrop
location: in the lobby
singular-named, proper-named, unused; unlit, inedible, fixed in place, scenery, neuter, seen, familiar, non-pourable
list grouping key: none
printed name: "outside"
printed plural name: "backdrops"
indefinite article: none
most recent reference: nominal
third singular pronoun: It-pronoun
conversation: none
description: "Outside the building are the red-dusted streets of New Reykjavik."
initial appearance: none
third-plural-pronoun: They-pronoun

>w
Trying to reach an exit would surely get Jones shot.

Jones: "I'm pinned down here!"

>shoot art
Jones fires the disruptor into the sculpture's main support cable, snapping it. The huge crystal blob starts to sag, straining the other cables. In quick succession they break as well, and the whole installation plummets to the ground, right on top of the hapless guard robots.
 _________      __                     _____                     
 __/ ____/___ _/ /___ __  ____  __     __/ /___  ____  ___  _____
 _/ / __/ __ `/ / __ `/ |/ / / / /____ _/ / __ \/ __ \/ _ \/ ___/
 / /_/ / /_/ / / /_/ />  </ /_/ / _/ /_/ / /_/ / / / /  __(__  ) 
 \____/\__,_/_/\__,_/_/|_|\__, /  _\____/\____/_/ /_/\___/____/  
 _____________________________/ 

[Your score has just gone up by one point.]

Beck: "What was that crash? What's going on?"

Jones: "That, my friend, was what you'd call a work of art. Targets terminated."

* * *

>w
Jones crosses the floor carefully, disruptor pistol at the ready.

Galaxy Jones is at the southwest corner of the ground floor. A lush waterfall here contrasts with the dusty red streets of New Reykjavik beyond the glass walls. The ground floor extends north and east.

>x glass walls
There's nothing like that nearby.

>x first
Outside the building are the red-dusted streets of New Reykjavik.

>x first floor view
Outside the building are the red-dusted streets of New Reykjavik.

>showme first floor view
outside - backdrop
location: in the southwest corner of the ground floor
singular-named, proper-named, unused; unlit, inedible, fixed in place, scenery, neuter, seen, familiar, non-pourable
list grouping key: none
printed name: "outside"
printed plural name: "backdrops"
indefinite article: none
most recent reference: nominal
third singular pronoun: It-pronoun
conversation: none
description: "Outside the building are the red-dusted streets of New Reykjavik."
initial appearance: none
third-plural-pronoun: They-pronoun

>showme first floor view of New Reykjavik
outside - backdrop
location: in the southwest corner of the ground floor
singular-named, proper-named, unused; unlit, inedible, fixed in place, scenery, neuter, seen, familiar, non-pourable
list grouping key: none
printed name: "outside"
printed plural name: "backdrops"
indefinite article: none
most recent reference: nominal
third singular pronoun: It-pronoun
conversation: none
description: "Outside the building are the red-dusted streets of New Reykjavik."
initial appearance: none
third-plural-pronoun: They-pronoun

>x glass wall
Outside the building are the red-dusted streets of New Reykjavik.

>x streets
There's nothing like that nearby.

* * *

>x new reykjavik
Outside the building are the red-dusted streets of New Reykjavik.

The robots intone "Destroy Jones" in an eerie drone.

>shoot art
Jones fires the disruptor into the sculpture's main support cable, snapping it. The huge crystal blob starts to sag, straining the other cables. In quick succession they break as well, and the whole installation plummets to the ground, right on top of the hapless guard robots.
 _________      __                     _____                     
 __/ ____/___ _/ /___ __  ____  __     __/ /___  ____  ___  _____
 _/ / __/ __ `/ / __ `/ |/ / / / /____ _/ / __ \/ __ \/ _ \/ ___/
 / /_/ / /_/ / / /_/ />  </ /_/ / _/ /_/ / /_/ / / / /  __(__  ) 
 \____/\__,_/_/\__,_/_/|_|\__, /  _\____/\____/_/ /_/\___/____/  
 _____________________________/ 

[Your score has just gone up by one point.]

Beck: "What was that crash? What's going on?"

Jones: "That, my friend, was what you'd call a work of art. Targets terminated."

* * *

>x lander
The lander is such a big, ungainly object it's hard to imagine it was once a pinnacle of human achievement.

>x viking 2
The lander is such a big, ungainly object it's hard to imagine it was once a pinnacle of human achievement.

>x glass
Outside the building are the red-dusted streets of New Reykjavik.

>n
Galaxy Jones is on the east side of the ground floor. Apparently some kind of function was happening here before Admiral Thallium emptied the building, for there is an array of canapes on a catering table here. The floor stretches north and south, and there's a closet door to the west.

Beck: "Blueprints indicate a closet to the west of you. Might be useful."

>x table
The table is covered with a wide array of treats from the ridiculously expensive, such as shrimp tea sandwiches (where do you get shrimp on Mars?), to the just plain ridiculous, like poached ostrich eggs in jelly. A good number of forks are laid out to one side.

Jones: "What would you like me to bring you, Beck? Shrimp tea sandwiches, or poached ostrich eggs?"

Beck: "Oh, the shrimp. Definitely get the shrimp."

>take all
fork: Taken.
shrimp tea sandwich: Taken.
poached ostrich eggs in jelly: Don't even.
the east side of the ground floor: That doesn't make sense.

* * *

>x water features
The ground is floor is huge and made for holding people comfortably. Thus the hundreds of seats amidst Earth pleasures such as water and living green plants.

Beck: "Robot on your right!"

One robot tries to flank Jones, but a shot from her disruptor sends it scurrying back.

>shoot robot
Jones sticks her head out from behind the desk and squeezes off a shot at the guard robots. In Jones's haste it goes wide of the target.

>shoot robot
Oops! Jones misses.

Beck: "How's it going in there?"

"Jones: "You know -- like all art, it's hit or miss."

>shoot robot
Jones's shot goes wide, reflecting off one of the building struts and into the suspended sculpture. The artwork begins to spin wildly, straining its cables.

>shoot artwork
Jones fires the disruptor into the sculpture's main support cable, snapping it. The huge crystal blob starts to sag, straining the other cables. In quick succession they break as well, and the whole installation plummets to the ground, right on top of the hapless guard robots.
 _________      __                     _____                     
 __/ ____/___ _/ /___ __  ____  __     __/ /___  ____  ___  _____
 _/ / __/ __ `/ / __ `/ |/ / / / /____ _/ / __ \/ __ \/ _ \/ ___/
 / /_/ / /_/ / / /_/ />  </ /_/ / _/ /_/ / /_/ / / / /  __(__  ) 
 \____/\__,_/_/\__,_/_/|_|\__, /  _\____/\____/_/ /_/\___/____/  
 _____________________________/ 

[Your score has just gone up by one point.]

Beck: "What was that crash? What's going on?"

Jones: "That, my friend, was what you'd call a work of art. Targets terminated."

* * *

>n
Jones approaches the Viking Building entryway, the dramatic façade towering over her.

Galaxy Jones is at the entry doorway. A glass revolving door leads into a large open space north of here. The speeder dock is to the south.

Jones peers upwards at the 100 stories of glass and steel. "What do you want to bet Thallium's got Europa all the way at the top?"

Beck: "Oh, no doubt."

>open door
It isn't something Jones can open.

>n
Jones takes a deep breath. "I'm going in."

Beck replies, "You got this, Galaxy."

Jones passes through the revolving door and into the lobby, alert to any defenses.

Galaxy Jones is in the lobby. The ground floor of the Viking Building is breathtaking. Low-G architecture means more glass and thinner supports, and the building takes advantage of that. Four walls of glass surround a central pillar in which are set the utility rooms and elevators. In between is an expanse of plants, water features, and stylish seating. Near the entryway is a front desk. A giant crystal sculpture floats above the center of the area, suspended on almost invisible cables. She may go east and west from here, north to the elevators, or south out of the building.

Suddenly two robot guards, green and red, emerge from niches in the back wall! She dives behind the front desk and draws her disruptor pistol.

Jones shouts, "I'm under fire from two ugly robot things!"

Beck responds, "Monitoring your suit radar."

>x glass
It's a huge crystal abstraction, provocative in its arrogance but evocative of nothing. A typical public installation by the artist Rambutan. It's held up by metal cables.

Zip! Disruptor fire scorches a nearby couch.
Jones: "I could use some ideas here!"

>x supports
There's nothing like that nearby.

>x elevators
There's nothing like that nearby.

>x front desk
There's not much on the desk other than a note that says "0".

The two robots coordinate fire over the desk, narrowly missing Jones.

>shoot art
Jones fires the disruptor into the sculpture's main support cable, snapping it. The huge crystal blob starts to sag, straining the other cables. In quick succession they break as well, and the whole installation plummets to the ground, right on top of the hapless guard robots.
 _________      __                     _____                     
 __/ ____/___ _/ /___ __  ____  __     __/ /___  ____  ___  _____
 _/ / __/ __ `/ / __ `/ |/ / / / /____ _/ / __ \/ __ \/ _ \/ ___/
 / /_/ / /_/ / / /_/ />  </ /_/ / _/ /_/ / /_/ / / / /  __(__  ) 
 \____/\__,_/_/\__,_/_/|_|\__, /  _\____/\____/_/ /_/\___/____/  
 _____________________________/ 

[Your score has just gone up by one point.]

Beck: "What was that crash? What's going on?"

Jones: "That, my friend, was what you'd call a work of art. Targets terminated."

>x ruin
Jones digs through the ruins and finds a cable with hooks at either end, which she takes.

>w
Jones crosses the floor carefully, disruptor pistol at the ready.

Galaxy Jones is at the southwest corner of the ground floor. A lush waterfall here contrasts with the dusty red streets of New Reykjavik beyond the glass walls. The ground floor extends north and east.

>x streets
There's nothing like that nearby.

>x waterfall
The waterfall descends the length of an artificial rock formation fringed by wide-leaved Earth plants and ferns. The water collects in a basin at the bottom, where it begins its journey again. A single coin sits on the bottom of the basin.

* * *

>x water
The waterfall descends the length of an artificial rock formation fringed by wide-leaved Earth plants and ferns. The water collects in a basin at the bottom, where it begins its journey again. A single coin sits on the bottom of the basin.

>take coin
Taken.

>n
Galaxy Jones is on the west side of the ground floor. Semicircular couches open on either side of a central carpeted path leading north and south. Set in the central pillar of the building to the east is a utility door. The city looms beyond the glass wall to the west.

>x path
A strip of grey carpet running north to south, in the midst of the marble floor. (Incidentally, the massive expense of moving real marble from Earth to the Mars is just further proof of Thallium's madness, seriously.)

>x carpet
There's nothing like that nearby.

>look down
Yards and yards of white and grey marble, rare for Mars.

>n
Galaxy Jones is at the northwest corner of the ground floor. A large relief map of mars is mounted on the north wall here. One can leave here to the south or east.

* * *

>x map
The map is crafted of bronze and sports a star at the site of New Reykjavik.

>x new reykjavik
Outside the building are the red-dusted streets of New Reykjavik.

>x star
Ah, New Reykjavik! Even colder than Old Reykjavik!

>x relief
The map is crafted of bronze and sports a star at the site of New Reykjavik.

>x bronze
There's nothing like that nearby.

>e
Galaxy Jones is on the north side of the ground floor. The area is dominated by a towering statue of Admiral Thallium against the north wall. The ground floor extends west and east from here. The elevator is to the south.

* * *

>x statue
His nauseating visage seems to leer at Jones, and she suppresses a shiver of disgust.

Jones groans. "Be glad you're not here, Beck. This is revolting."

Beck chuckles. "I won't ask."

>x thallium
His nauseating visage seems to leer at Jones, and she suppresses a shiver of disgust.

>x elevator
There's nothing like that nearby.

>x pillar
The central area where the elevators and utility rooms are.

>e
Galaxy Jones is at the northeast corner of the ground floor. The area is dedicated to celebrating the military career of Admiral Thallium. Uniforms, medals, ribbons, and other miscellanea are mounted on the wall or in showcases. All this despite the fact that no one has turned up any evidence that Thallium served in any navy of any country on any planet. One can escape to the west or south.

>x pillar
The central area where the elevators and utility rooms are.

>x elevators
There's nothing like that nearby.

>x uniforms
Jones yawns looking over the assortment of faux honors. They're all behind glass, but one of the display cases is partly open, leaving the rather garish medal inside unprotected.

>x medal
While the front looks authentic, the reverse is engraved with Thallium's personal motto "Planetas Vincam". The ribbon conceals a safety pin. It looks like it could be removed.

>take it
Taken.

>take pin
Taken.

>wear medal
Jones declines to wear a fake medal from a fake Admiral.

>s
Galaxy Jones is on the east side of the ground floor. Apparently some kind of function was happening here before Admiral Thallium emptied the building, for there is an array of canapes on a catering table here. The floor stretches north and south, and there's a closet door to the west.

Beck: "Blueprints indicate a closet to the west of you. Might be useful."

>ask beck about table
Beck: "Hmm. Don't have much to say about that right now."

>x table
The table is covered with a wide array of treats from the ridiculously expensive, such as shrimp tea sandwiches (where do you get shrimp on Mars?), to the just plain ridiculous, like poached ostrich eggs in jelly. A good number of forks are laid out to one side.

Jones: "What would you like me to bring you, Beck? Shrimp tea sandwiches, or poached ostrich eggs?"

Beck: "Oh, the shrimp. Definitely get the shrimp."

>x treats
There's nothing like that nearby.

>x arraay
There's nothing like that nearby.

>x canape
The table is covered with a wide array of treats from the ridiculously expensive, such as shrimp tea sandwiches (where do you get shrimp on Mars?), to the just plain ridiculous, like poached ostrich eggs in jelly. A good number of forks are laid out to one side.

Jones: "What would you like me to bring you, Beck? Shrimp tea sandwiches, or poached ostrich eggs?"

Beck: "Oh, the shrimp. Definitely get the shrimp."

>l
Galaxy Jones is on the east side of the ground floor. Apparently some kind of function was happening here before Admiral Thallium emptied the building, for there is an array of canapes on a catering table here. The floor stretches north and south, and there's a closet door to the west.

>i
Jones is carrying:
  a safety pin
  a garish medal
  a coin
  a cable with hooks at either end
  a disruptor pistol

>s
Galaxy Jones is at the southeast corner of the ground floor. The centerpiece of this area is the actual Viking 2 lander, which landed right here on Utopia Planitia. The glass walls look out onto the city. Jones can go north or west from here.

>x wakks
There's nothing like that nearby.

>x walls
There's nothing like that nearby.

>x glass
There's nothing like that nearby.

>x city
There's nothing like that nearby.

>showme first floor view
There seems to be no such object anywhere in the model world.

>showme outside
Which do you mean, the outside, outside, or outside?

>outside
Which do you mean, the outside, outside, or outside?

>showme all outside
outside - backdrop
location: out of play
singular-named, proper-named, unused; unlit, inedible, fixed in place, scenery, neuter, unseen, unfamiliar, non-pourable
list grouping key: none
printed name: "outside"
printed plural name: "backdrops"
indefinite article: none
most recent reference: nominal
third singular pronoun: It-pronoun
conversation: none
description: "Looking down at New Reykjavik, one can trace the history of the city, as it expanded radially from its original domes, the multiple frontiers colliding and interfering like ripples in a pond, until eventually, the map gave way to rectangular regularity. The Viking Building stands near the periphery, overlooking the vast red plain of Utopia Planitia."
initial appearance: none
third-plural-pronoun: They-pronoun
outside - backdrop
location: out of play
singular-named, proper-named, unused; unlit, inedible, fixed in place, scenery, neuter, unseen, unfamiliar, non-pourable
list grouping key: none
printed name: "outside"
printed plural name: "backdrops"
indefinite article: none
most recent reference: nominal
third singular pronoun: It-pronoun
conversation: none
description: "Looking down at New Reykjavik, one can trace the history of the city, as it expanded radially from its original domes, the multiple frontiers colliding and interfering like ripples in a pond, until eventually, the map gave way to rectangular regularity. The Viking building stands near the periphery, overlooking the vast red plain of Utopia Planitia."
initial appearance: none
third-plural-pronoun: They-pronoun
outside - direction
singular-named, improper-named, unused; list grouping key: none
printed name: "outside"
printed plural name: "directions"
indefinite article: "the"
most recent reference: nominal
third singular pronoun: It-pronoun
conversation: none
opposite: inside

>showme streets
There seems to be no such object anywhere in the model world.

>showme glass wall
outside - backdrop
location: in the southeast corner of the ground floor
singular-named, proper-named, unused; unlit, inedible, fixed in place, scenery, neuter, seen, familiar, non-pourable
list grouping key: none
printed name: "outside"
printed plural name: "backdrops"
indefinite article: none
most recent reference: nominal
third singular pronoun: It-pronoun
conversation: none
description: "Outside the building are the red-dusted streets of New Reykjavik."
initial appearance: none
third-plural-pronoun: They-pronoun

>x glass wall
Outside the building are the red-dusted streets of New Reykjavik.

>x glass
There's nothing like that nearby.

>x streets
There's nothing like that nearby.

>x reykjavik
There's nothing like that nearby.

>x city
There's nothing like that nearby.

* * *

>purloin atmo-suit
[Purloined.]

>gonear cybernetica
(the Cybernetica office)
Galaxy Jones is in the Cybernetica office. It's spacious and luxurious, designed to make developers forget how spent they are from months of overwork and abuse. Ergonomic desks and chairs fill space like a furniture fractal, before giving way to an open area, presumably for group activities. At the south end of the room is a door labeled "Inspiration Chamber".

As soon as Jones steps into the office, a shot zaps just past her nose. She dives to the ground, protected by the maze of desks and chairs. Peeking through the mesh back of one of the chairs, she takes notice of both the purple guard robot training its disruptor on the room, and the chair's fine construction and lumbar support.

Jones (whispering): "We've got another one! I'm out of sight for now, but it's going to be hard to get a shot off at this 'bot."

Beck: "What's the situation?"

Jones: "I'm on the floor with desks and chairs all around. The target is a few yards off, coming this way. I might get a shot in, but it might just absorb it anyway."

Beck: "Well, see if you can sneak up on it. Maybe close up you can find a way past its defenses."

>sneak up on robot
Jones creeps a little ways toward the guard robot.

* * *

>e
Jones: "I'm going out the window to see if I can find a way to get up to the tenth floor."

Beck: "Whoa whoa whoa, Jones. You know you're not good with heights."

Jones: "Ask Thallium how how much that matters once I've kicked his ass. Watch me, I'll look down and not even flinch."

Jones puts on the Atmo-Suit.

Galaxy Jones is on a ledge. She's plastered up against the wall, trying not to look down.

>w
Galaxy Jones is in the Cybernetica office. It's spacious and luxurious, designed to make developers forget how spent they are from months of overwork and abuse. Ergonomic desks and chairs fill space like a furniture fractal, before giving way to an open area, presumably for group activities. At the south end of the room is a door labeled "Inspiration Chamber". One of the windows along the east side of the office is broken.

The remains of the purple guard robot are sprawled on the ground.

Jones doffs the Atmo-Suit.

>l
Galaxy Jones is in the Cybernetica office. It's spacious and luxurious, designed to make developers forget how spent they are from months of overwork and abuse. Ergonomic desks and chairs fill space like a furniture fractal, before giving way to an open area, presumably for group activities. At the south end of the room is a door labeled "Inspiration Chamber". One of the windows along the east side of the office is broken.

The remains of the purple guard robot are sprawled on the ground.

>wear suit
Jones needs to be able to move around quickly. Better not wear the Atmo-Suit.

>w
(first opening the Cybernetica door)

Galaxy Jones is in the ninth floor north hallway. This anonymous corporate hallway ends here at the north end of the building. An open doorway leads west. To the east is a door labeled "Cybernetica Inc."

>wear suit
Jones needs to be able to move around quickly. Better not wear the Atmo-Suit.

>e
Galaxy Jones is in the Cybernetica office. It's spacious and luxurious, designed to make developers forget how spent they are from months of overwork and abuse. Ergonomic desks and chairs fill space like a furniture fractal, before giving way to an open area, presumably for group activities. At the south end of the room is a door labeled "Inspiration Chamber". One of the windows along the east side of the office is broken.

The remains of the purple guard robot are sprawled on the ground.

>e
Jones puts on the Atmo-Suit.

Galaxy Jones is on a ledge. She's plastered up against the wall, trying not to look down.

>remove suit
That would be inadvisable in the thin Martian atmosphere.

>u
Jones can't go that way. The obvious exits are west (to the cybernetica office) and inside (to the cybernetica office).

>d
Jones can't go that way. The obvious exits are west (to the cybernetica office) and inside (to the cybernetica office).

>d
Jones can't go that way. The obvious exits are west (to the cybernetica office) and inside (to the cybernetica office).

>look do
There's nothing like that nearby.

>look d
Jones is afraid of heights.

>look d
Really, really afraid of heights.

>look d
Okay, fine. Jones look down, slowly, slowly... and there's a window cleaner's scaffold, about six feet below her.

Jones: "Okay, so. There's a window washing platform right below me. I might be able to drop down to it, but I won't be able to get back up."

Beck: "Take it easy, Jones."

* * *

>purloin hammer
[Purloined.]

>hit beck with hammer
Violence isn't the answer to this one.

>touch beck
Beck might not like that.

>hit beck
Violence isn't the answer to this one.

* * *

>purloin shrimp sandwich
[Purloined.]

>gonear ninth floor hall
Galaxy Jones is in the ninth floor elevator hall. The elevator is to the west, the stairwell is to the east, and a corridor leads north and south. There is a bottled water vending machine here.

>s
Galaxy Jones is in the ninth floor south hallway. This anonymous corporate hallway ends here at the south end of the building. An open doorway leads west. To the east is a door labeled "Martian Chemical"

>w
Galaxy Jones is at the south end of the building management office. The building management office is a bunch of desks and task boards. There is a filing cabinet against the east wall. The office exit is to the east, and the office continues to the north.

A screwdriver sits atop the filing cabinet.

* * *

>take screwdriver
Jones reaches for the screwdriver, but she fumbles it and it rolls off the back of the filing cabinet.

Jones: "Damn."

Beck: "What? What's going on?"

Jones: "Just being clumsy is all."

>l
Galaxy Jones is at the south end of the building management office. The building management office is a bunch of desks and task boards. There is a filing cabinet against the east wall. The office exit is to the east, and the office continues to the north.

>drop shrimp
Dropped.

>take it
Taken.

>look behind cabinet
(taking the screwdriver)
Jones reaches behind the cabinet to retrieve the screwdriver. A swipe and a hiss make her recoil.

Jones: "Holy --!"

Beck: "What now?"

Jones: "There's a cat here! Behind a filing cabinet. Gotta get behind there to get a screwdriver, so I need a way to drive off the cat."

>drop shrimp
Sensing food, the black cat pokes its head out, grabs the shrimp in its jaws, and races off.

 _________      __                     _____                     
 __/ ____/___ _/ /___ __  ____  __     __/ /___  ____  ___  _____
 _/ / __/ __ `/ / __ `/ |/ / / / /____ _/ / __ \/ __ \/ _ \/ ___/
 / /_/ / /_/ / / /_/ />  </ /_/ / _/ /_/ / /_/ / / / /  __(__  ) 
 \____/\__,_/_/\__,_/_/|_|\__, /  _\____/\____/_/ /_/\___/____/  
 _____________________________/ 

[Your score has just gone up by one point.]

Jones: "Aha! No creature is too fearsome for Galaxy Jones!"

Beck: "Congratulations on your victory."

>take screwdriver
Taken.

>drop it
Dropped.

>l
Galaxy Jones is at the south end of the building management office. The building management office is a bunch of desks and task boards. There is a filing cabinet against the east wall. The office exit is to the east, and the office continues to the north.

Also here is a screwdriver.

>undo
Galaxy Jones is at the south end of the building management office.
[Previous turn undone.]

>und
That's not a verb I recognise.

>undo
Galaxy Jones is at the south end of the building management office.
[Previous turn undone.]

>l
Galaxy Jones is at the south end of the building management office. The building management office is a bunch of desks and task boards. There is a filing cabinet against the east wall. The office exit is to the east, and the office continues to the north.

Also here is a screwdriver.

>look behind cbinet
There's nothing like that nearby.

>look behind cabinet
Jones finds nothing of note.

>restart
Are you sure you want to restart?

* * *

>l
Galaxy Jones is at the south end of the building management office. The building management office is a bunch of desks and task boards. There is a filing cabinet against the east wall. The office exit is to the east, and the office continues to the north.

>look behind cabinet
(taking the screwdriver)
Jones reaches behind the cabinet to retrieve the screwdriver. A swipe and a hiss make her recoil.

Jones: "Holy --!"

Beck: "What now?"

Jones: "There's a cat here! Behind a filing cabinet. Gotta get behind there to get a screwdriver, so I need a way to drive off the cat."

>l
Galaxy Jones is at the south end of the building management office. The building management office is a bunch of desks and task boards. There is a filing cabinet against the east wall. The office exit is to the east, and the office continues to the north.

>drop shrimp
Sensing food, the black cat pokes its head out, grabs the shrimp in its jaws, and races off. Jones takes the screwdriver.

 _________      __                     _____                     
 __/ ____/___ _/ /___ __  ____  __     __/ /___  ____  ___  _____
 _/ / __/ __ `/ / __ `/ |/ / / / /____ _/ / __ \/ __ \/ _ \/ ___/
 / /_/ / /_/ / / /_/ />  </ /_/ / _/ /_/ / /_/ / / / /  __(__  ) 
 \____/\__,_/_/\__,_/_/|_|\__, /  _\____/\____/_/ /_/\___/____/  
 _____________________________/ 

[Your score has just gone up by one point.]

Jones: "Aha! No creature is too fearsome for Galaxy Jones!"

Beck: "Congratulations on your victory."

>i
Jones is carrying:
  a screwdriver
  a disruptor pistol

>l
Galaxy Jones is at the south end of the building management office. The building management office is a bunch of desks and task boards. There is a filing cabinet against the east wall. The office exit is to the east, and the office continues to the north.

>drop screwdriver
Dropped.

>l
Galaxy Jones is at the south end of the building management office. The building management office is a bunch of desks and task boards. There is a filing cabinet against the east wall. The office exit is to the east, and the office continues to the north.

Also here is a screwdriver.

* * *

>l
Galaxy Jones is at the south end of the building management office. The building management office is a bunch of desks and task boards. There is a filing cabinet against the east wall. The office exit is to the east, and the office continues to the north.

>i
Jones is carrying:
  a shrimp tea sandwich
  a disruptor pistol

>drop shrimp
Sensing food, the black cat pokes its head out, grabs the shrimp in its jaws, and races off.

 _________      __                     _____                     
 __/ ____/___ _/ /___ __  ____  __     __/ /___  ____  ___  _____
 _/ / __/ __ `/ / __ `/ |/ / / / /____ _/ / __ \/ __ \/ _ \/ ___/
 / /_/ / /_/ / / /_/ />  </ /_/ / _/ /_/ / /_/ / / / /  __(__  ) 
 \____/\__,_/_/\__,_/_/|_|\__, /  _\____/\____/_/ /_/\___/____/  
 _____________________________/ 

[Your score has just gone up by one point.]

Jones: "Aha! No creature is too fearsome for Galaxy Jones!"

Beck: "Congratulations on your victory."

>l
Galaxy Jones is at the south end of the building management office. The building management office is a bunch of desks and task boards. There is a filing cabinet against the east wall. The office exit is to the east, and the office continues to the north.

* * *

>purloin water
(the full water bottle)
[Purloined.]

>drink it
Jones isn't thirsty.

>eat it
That's plainly inedible.

>pour water
That can't be poured.

* * *

>purloin water
(the full water bottle)
[Purloined.]

>pour it
Why waste it?

>pour it on speeder
(the speeder)
Why waste it?

>gonear europa
Galaxy Jones is next to the cage. The closely-set silnium bars seem to dash all hope of a rescue.

Europa Callisto is lying at the center of the cage, out of Jones's reach.

Jones tries the strength of the bars just in case. They don't budge.

South of the cage, Thallium crosses the roof to the flyer pad, where he boards the waiting flyer. The flyer lifts off and moves towards Jones.

>pout water on europa
That's not a verb I recognise.

>pour water on europa
Why waste it?

Thallium's flyer hovers over the rooftop. "Jones!"  he bellows. "Play time is over. I grow weary of your intransigence. In a moment this roof will be swarmed by guard robots -- of many different colors -- so many robots you couldn't possibly vandalize them all.  Say your prayers, Jones, or whatever you do when you're about to die."

Jones rolls her eyes.

A little ways off, a small red flyer aims for the rooftop and accelerates.

* * *

>showme elevator shaft
Which do you mean, the elevator shaft, the ground floor elevator shaft, the ninth floor elevator shaft, second floor elevator shaft, third floor elevator shaft, fourth floor elevator shaft, fifth floor elevator shaft, sixth floor elevator shaft, seventh floor elevator shaft, or eighth floor elevator shaft?

* * *

>take all
I'm not sure what you're referring to.

>n
Jones approaches the Viking Building entryway, the dramatic façade towering over her.

Galaxy Jones is at the entry doorway. A glass revolving door leads into a large open space north of here. The speeder dock is to the south.

Jones peers upwards at the 100 stories of glass and steel. "What do you want to bet Thallium's got Europa all the way at the top?"

Beck: "Oh, no doubt."

* * *

>take all
fork: Taken.
shrimp tea sandwich: Taken.
poached ostrich eggs in jelly: Don't even.

>d
Jones can't go that way. The obvious exits are north, south (to the southeast corner of the ground floor) and west.

>w
(first opening the closet door)
(first unlocking the closet door)
Jones will have to enter the correct code on the keypad.

Jones: "Door on the east side has a keypad lock."

* * *

>take aart
There's nothing like that nearby.

>take art
That can't be taken.

>x it
Jones digs through the ruins and finds a cable with hooks at either end, which she takes.

>w
Jones crosses the floor carefully, disruptor pistol at the ready.

Galaxy Jones is at the southwest corner of the ground floor. A lush waterfall here contrasts with the dusty red streets of New Reykjavik beyond the glass walls. The ground floor extends north and east.

* * *

>put drop key in hole
(the elevator drop key in the drop key hole)
Jones inserts the elevator drop key into the drop key hole and turns it, disengaging the lock mechanism. Then she slides the door open.

>l
Galaxy Jones is in the ground floor elevator hall. This hallway between the north and south ends of the ground floor is home to the elevator to the west. To the east is the entrance to a stairwell. The elevator door is open, revealing the bottom of the elevator shaft. Jones could climb into it, if she wished.

>x hallway
Galaxy Jones is in the ground floor elevator hall. This hallway between the north and south ends of the ground floor is home to the elevator to the west. To the east is the entrance to a stairwell. The elevator door is open, revealing the bottom of the elevator shaft. Jones could climb into it, if she wished.

>x hall
Galaxy Jones is in the ground floor elevator hall. This hallway between the north and south ends of the ground floor is home to the elevator to the west. To the east is the entrance to a stairwell. The elevator door is open, revealing the bottom of the elevator shaft. Jones could climb into it, if she wished.

>x stairwell
Which do you mean, the stairwell or the stairwell?

>press button
Jones presses the call button, but nothing happens.

>i
Jones is carrying:
  a hammer
  an elevator drop key
  a coin
  a cable with hooks at either end
  a red cardkey
  an Atmo-Suit
  a shrimp tea sandwich
  a fork
  a disruptor pistol

>w
Jones climbs into the elevator shaft

Galaxy Jones is in the ground floor elevator shaft. She is at the bottom of a dark well. Shining her suit light up, she can see that the elevator car is several floors up, unmoving. There is a ladder running up the wall next to the door.

>u
Jones climbs up the shaft, stopping at each floor to test each door. She gets all the way to the ninth floor, directly below the elevator car, before finding one that opens.

Galaxy Jones is in the ninth floor elevator shaft. The door here is closed.

>e
(first opening the ninth floor elevator door)
 _________      __                     _____                     
 __/ ____/___ _/ /___ __  ____  __     __/ /___  ____  ___  _____
 _/ / __/ __ `/ / __ `/ |/ / / / /____ _/ / __ \/ __ \/ _ \/ ___/
 / /_/ / /_/ / / /_/ />  </ /_/ / _/ /_/ / /_/ / / / /  __(__  ) 
 \____/\__,_/_/\__,_/_/|_|\__, /  _\____/\____/_/ /_/\___/____/  
 _____________________________/ 

[Your score has just gone up by one point.]

Jones: "Finally out of the shaft. That was quite a climb."

Beck: "This floor is just offices. Check the building management office to the west. It might have some useful stuff."

Galaxy Jones is in the ninth floor elevator hall. The elevator is to the west, the stairwell is to the east, and a corridor leads north and south. There is a bottled water vending machine here.

* * *

>w
(first opening the ninth floor elevator door)

Galaxy Jones is in the ninth floor elevator shaft. The door here is closed.

>look down
Jones is afraid of heights.

>look up
The elevator car is just above Jones's head.

>look down
Jones is afraid of heights.

>look down
Jones is afraid of heights.

>x car
The elevator car is just above Jones's head.

>u
Jones can't go that way. The obvious exits are east (to the ninth floor elevator hall) and down (to the ground floor elevator shaft).

>e
(first opening the ninth floor elevator door)

Galaxy Jones is in the ninth floor elevator hall. The elevator is to the west, the stairwell is to the east, and a corridor leads north and south. There is a bottled water vending machine here.

>x elevator
Galaxy Jones is in the ninth floor elevator hall. The elevator is to the west, the stairwell is to the east, and a corridor leads north and south. There is a bottled water vending machine here.

>w
(first opening the ninth floor elevator door)

Galaxy Jones is in the ninth floor elevator shaft. The door here is closed.

* * *

>d
Galaxy Jones is in the ground floor elevator shaft. Jones is at the bottom of a dark well. Shining her suit light up, she can see that the elevator car is several floors up, unmoving. There is a ladder running up the wall next to the door.

>d
Jones can't go that way. The obvious exits are east (to the ground floor elevator hall) and up (to the ninth floor elevator shaft).

>e
Galaxy Jones is in the ground floor elevator hall. This hallway between the north and south ends of the ground floor is home to the elevator to the west. To the east is the entrance to a stairwell. The elevator door is open, revealing the bottom of the elevator shaft. Jones could climb into it, if she wished.

>x elevator
Galaxy Jones is in the ground floor elevator hall. This hallway between the north and south ends of the ground floor is home to the elevator to the west. To the east is the entrance to a stairwell. The elevator door is open, revealing the bottom of the elevator shaft. Jones could climb into it, if she wished.

>w
Galaxy Jones is in the ground floor elevator shaft. Jones is at the bottom of a dark well. Shining her suit light up, she can see that the elevator car is several floors up, unmoving. There is a ladder running up the wall next to the door.

>u
Galaxy Jones is in the ninth floor elevator shaft. The door here is closed.

* * *

>e
(first opening the ninth floor elevator door)

Galaxy Jones is in the ninth floor elevator hall. The elevator is to the west, the stairwell is to the east, and a corridor leads north and south. There is a bottled water vending machine here.

>x elevator door
A golden sliding door, opening in the middle.

>x machine
There is one bottle left.

>buy bottle with coin
Jones inserts the coin in the machine and takes the bottle that appears a few seconds later.

>x stairs
There's nothing like that nearby.

>x corridor
Galaxy Jones is in the ninth floor elevator hall. The elevator is to the west, the stairwell is to the east, and a corridor leads north and south. There is a bottled water vending machine here.

>x machine
The machine is empty.

>s
Galaxy Jones is in the ninth floor south hallway. This anonymous corporate hallway ends here at the south end of the building. An open doorway leads west. To the east is a door labeled "Martian Chemical"

>x hallway
Galaxy Jones is in the ninth floor south hallway. This anonymous corporate hallway ends here at the south end of the building. An open doorway leads west. To the east is a door labeled "Martian Chemical"

>x doorway
There's nothing like that nearby.

>x door
A slick corporate office door with the fancy company logo of Martian Chemical. It has a swipe lock above the handle.

>x logo
The figure of a beaker holding a red liquid against the backdrop of the planet Mars.

>x swipe lock
A slick corporate office door with the fancy company logo of Martian Chemical. It has a swipe lock above the handle.

>nn
That's not a verb I recognise.

>n
Galaxy Jones is in the ninth floor elevator hall. The elevator is to the west, the stairwell is to the east, and a corridor leads north and south. There is a bottled water vending machine here.

* * *

>x door
A slick corporate office door lettered "Cybernetica". It has a swipe lock above the handle.

>w
Galaxy Jones is at the north end of the building management office. The building management office is a bunch of desks and task boards. There is a particularly large desk against the west window. The office exit is to the east, and the office continues to the south.

>x desks
There are lots of them, none of which are particularly interesting.

>x desk
It's a pretty utilitarian desk of some plastic material. It has a single drawer with a lock.

>large
That's not a verb I recognise.

>x drawer
It's a pretty utilitarian desk of some plastic material. It has a single drawer with a lock.

>x lock
It's a pretty utilitarian desk of some plastic material. It has a single drawer with a lock.

>unlock desk with pin
There's nothing like that nearby.

>large
That's not a verb I recognise.

>unlock large desk with pin
There's nothing like that nearby.

>i
Jones is carrying:
  a full water bottle
  a hammer
  an elevator drop key
  a cable with hooks at either end
  a red cardkey
  an Atmo-Suit
  a shrimp tea sandwich
  a fork
  a disruptor pistol

>purloin safety pin
[Purloined.]

>unlock large desk with pin
Jones pushes the pin into the keyhole and wiggles it around. After a few seconds of this the desk drawer pops open. It contains a black cardkey.

>take cardkey
(the black cardkey)
Taken.

* * *

>look behind cabinet
(taking the screwdriver)
Jones reaches behind the cabinet to retrieve the screwdriver. A swipe and a hiss make her recoil.

Jones: "Holy --!"

Beck: "What now?"

Jones: "There's a cat here! Behind a filing cabinet. Gotta get behind there to get a screwdriver, so I need a way to drive off the cat."

>drop shrimp
Sensing food, the black cat pokes its head out, grabs the shrimp in its jaws, and races off. Jones takes the screwdriver.

 _________      __                     _____                     
 __/ ____/___ _/ /___ __  ____  __     __/ /___  ____  ___  _____
 _/ / __/ __ `/ / __ `/ |/ / / / /____ _/ / __ \/ __ \/ _ \/ ___/
 / /_/ / /_/ / / /_/ />  </ /_/ / _/ /_/ / /_/ / / / /  __(__  ) 
 \____/\__,_/_/\__,_/_/|_|\__, /  _\____/\____/_/ /_/\___/____/  
 _____________________________/ 

[Your score has just gone up by one point.]

Jones: "Aha! No creature is too fearsome for Galaxy Jones!"

Beck: "Congratulations on your victory."

>e
Galaxy Jones is in the ninth floor south hallway. This anonymous corporate hallway ends here at the south end of the building. An open doorway leads west. To the east is a door labeled "Martian Chemical"

* * *

>e
(first opening the Martian Chemical door)
(first unlocking the Martian Chemical door)
(with the black cardkey)

Galaxy Jones is in the Martian Chemical office. This seems like the business office of the chemical company rather than the lab. Most of the room is taken up by desks and other office stuff. There is a cabinet that looks intriguing, however.

>take gel
Taken.

>x cabinet
The cabinet is full of bottles of bottle of Electrofil quick-setting conductive polymer gel.

>x cabinetundo
There's nothing like that nearby.

>undo
Galaxy Jones is in the Martian Chemical office.
[Previous turn undone.]

>undo
Galaxy Jones is in the Martian Chemical office.
[Previous turn undone.]

>x cabinet
The cabinet is full of bottles of bottle of Electrofil quick-setting conductive polymer gel.

>take gel
Jones already has that.

>undo
Galaxy Jones is in the Martian Chemical office.
[Previous turn undone.]

>x cabinet
The cabinet is full of bottles of bottle of Electrofil quick-setting conductive polymer gel.

In the chemical cabinet is a bottle of Electrofil quick-setting conductive polymer gel.

>take gel
Taken.

* * *

>take gel
Jones already has that.

>w
Galaxy Jones is in the ninth floor south hallway. This anonymous corporate hallway ends here at the south end of the building. An open doorway leads west. To the east is a door labeled "Martian Chemical"

* * *

>n
Galaxy Jones is in the ninth floor elevator hall. The elevator is to the west, the stairwell is to the east, and a corridor leads north and south. There is a bottled water vending machine here.

>e
As soon as Jones enters the stairwell, a disruptor blast from above zings past her shoulder, and she beats a hasty retreat. She won't be going up the stairs until she can clear out the resistance, and she can't do that from here.

Jones: "In case of fire, don't use the stairs."

Galaxy Jones is in the ninth floor elevator hall. The elevator is to the west, the stairwell is to the east, and a corridor leads north and south. There is a bottled water vending machine here.

>n
Galaxy Jones is in the ninth floor north hallway. This anonymous corporate hallway ends here at the north end of the building. An open doorway leads west. To the east is a door labeled "Cybernetica Inc."

* * *

>x office
Galaxy Jones is in the Cybernetica office. It's spacious and luxurious, designed to make developers forget how spent they are from months of overwork and abuse. Ergonomic desks and chairs fill space like a furniture fractal, before giving way to an open area, presumably for group activities. At the south end of the room is a door labeled "Inspiration Chamber". One of the windows along the east side of the office is broken.

The remains of the purple guard robot are sprawled on the ground.

>x desks
Very nice and good for hiding under and among.

>x window
Looks like Jones could get through if she's careful.

>s
Galaxy Jones is in the Inspiration Chamber. One of the most unique features of the office is the "inspiration chamber," a specialized room designed to stimulate creativity and innovation. The room is filled with advanced technology, including AI-generated art, interactive displays, and sensory stimulation devices that can help employees think outside the box and come up with new ideas.

Jones: "We gotta get us some of this stuff."

Beck: "What's that?"

Jones: "Never mind."

* * *

>xyzzy
That's not a verb I recognise.