>i
Jones is carrying:
  a bottle of Electrofil quick-setting conductive polymer gel
  a black card key
  an elevator drop key
  a safety pin
  a garish medal
  a red key card
  an Atmo-Suit (being worn)
  a disruptor pistol

* * *

>unscrew vent
Jones loosens the screws and removes the grill from the vent.

* * *

>w
(first opening the air handling door)

Galaxy Jones is on the north side of the Consolidated Microthings office. This looks like the IT area of the office.

>s
Galaxy Jones is in the tenth floor elevator hall.

>w
Galaxy Jones is in the elevator car. It's luxurious, with gold-plated walls and crystal lighting on the ceiling. The button panel is lacquered dark mahogany with what looks like real ivory buttons. The carpeting is soft and plush. A golden keyhole sits above the buttons.

One of the ceiling panels looks loose.

>take panel
Jones removes the ceiling panel, exposing a hole wide enough for her to climb through.

>e
Galaxy Jones is in the tenth floor elevator hall.

>s
Galaxy Jones is on the south side of the Consolidated Microthings office. It has a great view of the New Reykjavik Botanic Dome. Couches are lined up to take advantage.

Jones sees the mauve guard robot to the west.

>n
Galaxy Jones is in the tenth floor elevator hall. 

The mauve guard robot appears to the south, coming from the west.

* * *

>jump on robot
Jones drops down through the ceiling and on to the guard robot. It swings around looking for her, obviously panicked that it can't bring its gun to bear on its attacker. Jones manages to hang on.

The mauve guard robot struggles against her hold on it, to no avail.

>pour gel on robot
Jones pours the gel into the vent on the robot's head. The robot flails around wildly and throws her from its back, then lets out a loud crackling sound and stops moving.

Galaxy Jones is in the elevator car. It's luxurious, with gold-plated walls and crystal lighting on the ceiling. The button panel is lacquered dark mahogany with what looks like real ivory buttons. The carpeting is soft and plush. A golden keyhole sits above the buttons.

The remains of the mauve guard robot are sprawled on the ground.

>e
Galaxy Jones is in the tenth floor elevator hall.

>s
Galaxy Jones is on the south side of the Consolidated Microthings office. It has a great view of the New Reykjavik Botanic Dome. Couches are lined up to take advantage.

>w
Galaxy Jones is at the southwest corner of the Consolidated Microthings office. This looks like the IT area of the office.

There is a present with a note attached sitting on a desk here.

>open present
Jones rips the package open and discovers a golden key.

>e
Galaxy Jones is on the south side of the Consolidated Microthings office. It has a great view of the New Reykjavik Botanic Dome. Couches are lined up to take advantage.

>n
Galaxy Jones is in the tenth floor elevator hall.

>w
Galaxy Jones is in the elevator car. It's luxurious, with gold-plated walls and crystal lighting on the ceiling. The button panel is lacquered dark mahogany with what looks like real ivory buttons. The carpeting is soft and plush. A golden keyhole sits above the buttons.

The remains of the mauve guard robot are sprawled on the ground.

>put key in keyhole
Which do you mean, the golden key, the black card key, the elevator drop key, or the red key card?

>golden
Jones puts the key in the keyhold and turns. There is a pleasant chime, and some buttons light up.

Galaxy Jones is in the elevator car. It's luxurious, with gold-plated walls and crystal lighting on the ceiling. The button panel is lacquered dark mahogany with what looks like real ivory buttons. The carpeting is soft and plush. A golden key rests in a golden keyhole above the buttons. The buttons 1, 9, 10, and 100 are illuminated.

The remains of the mauve guard robot are sprawled on the ground.

Admiral Thallium's voice oozes from concealed speakers: "Yes, Jones, that is real ivory. I imported the elephant here myself for a hunt on my estate. You have no idea how much money it takes to simulate an African jungle on Mars. In retrospect I should have gotten an Indian elephant."

* * *

>press 100
Describe a fast elevator ride all the way to the top.
The doors open. You're on floor 100.

>e
Galaxy Jones is in the 100th floor elevator hall.

>e
Galaxy Jones is on the roof stairs.

* * *

>w
Jones climbs into the elevator shaft

Galaxy Jones is in the ground floor elevator shaft. She is at the bottom of a dark well. Shining her suit light up, she can see that the elevator car is several floors up, unmoving. There is a ladder on the west wall.

* * *

>n
Galaxy Jones is next to the cage. The closely-set silnium bars seem to dash all hope of a rescue.

Europa Callisto is lying at the center of the cage, out of Jones's reach.

Jones tries the strength of the bars just in case. They don't budge.

South of the cage, Thallium crosses the roof to the flyer pad, where he boards the waiting flyer. The flyer lifts off and moves towards Jones.

>climb cage
Jones gets onto the cage.

Thallium's flyer hovers over the rooftop. "Jones!"  he bellows. "Play time is over. I grow weary of your intransigence. In a moment this roof will be swarmed by guard robots -- of many different colors -- so many robots you couldn't possibly vandalize them all.  Say your prayers, Jones, or whatever you do when you're about to die."

Jones rolls her eyes.

A little ways off, a small flyer aims for the rooftop and accelerates.

>throw cable at flyer
Jones throws the cable up to the flyer where it hooks around the rail, and attaches the other end to the cage, then jumps off the cage to escape the aftermath. Seeing his flyer's predicament, Thallium jumps through the door and disappears below the edge of the roof. The flyer reaches the end of its tether and slingshots downwards, slamming into side of the building.

The cage has tilted to the side, one attachment torn loose from the rooftop. Jones crawls into the cage to see to Europa Callisto.

"Europa! Can you hear me? I need you to move to get out of this cage. I can't carry you through that small opening. Europa!"

Europa moans but doesn't show any signs of having understood Jones.

Galaxy Jones is in the cage. The whole structure is tilted, leaving a hole at the eastern end.

Jones is kneeling at Europa Callisto's side, trying to rouse her.

The flyer, now recognizable as Galaxy's own, settles down onto the landing pad.

>x europa
There seems to be nothing special about her.

>i
Jones is carrying:
  a bottle of Electrofil quick-setting conductive polymer gel
  a screwdriver
  a black card key
  a full water bottle
  an elevator drop key
  a safety pin
  a garish medal
  a fork
  a red key card
  an Atmo-Suit
  a disruptor pistol

Beck sticks his head out of the door of the flyer and yells "C'mon Jones, get Europa and get in the flyer!"

>give water to europa
Jones opens the water bottle and brings it to Europa's lips. Even with closed eyes she drinks, first slowly and then with renewed vigor, until her eyes open.

"Ga- Galaxy Jones?" she says.

Jones nods, but says "We'll have time for introductions later. We have to get out of here before the roof is full of killer robots. Can you crawl? If you can get through that hole I can carry you the rest of the way."

Europa nods. "I think so."

Galaxy Jones helps her through the hole in the cage, then gently picks her up and jogs toward the waiting flyer. Beck's familiar face appears at the door of the aircraft, urging her on.

Not so far away, Admiral Thallium has somehow survived the crash and scaled the cable back to the roof. As he pulls himself up, he aims a pistol at Jones's back...

...and she falls sprawling on the landing pad, Europa Callisto tumbling from her arms. Beck is by Callisto's side in a moment, lifting her and carrying her into the flyer.

And then the robots swarm the roof like a mechanical rainbow tide. By the time Beck returns to the door it is already too late. A group of robots surrounds Jones, while another robot carries Thallium triumphantly. Beck has no choice but to take off, leaving Jones behind, not knowing if she still lives...

    *** The End, For Now... ***

In that game you scored 5 out of a possible 0, in 101 turns.

Extensions by:
Standard Rules version 3/120430 by Graham Nelson
Deluxe Doors version 4 by Emily Short
Skeleton Keys by Emily Short
Epistemology version 9 by Eric Eve
Exit Lister version 11 by Eric Eve
Gender Options version 3/210331 by Nathanael Nerode

Story by Phil Riley.
Programming by Phil Riley.
Playtesting by TBD.
Invaluable inspiration from Laura Taalman.

The story, all names, characters, and incidents portrayed in this production are fictitious. No identification with actual persons (living or deceased), places, buildings, and products is intended or should be inferred.

Promotional consideration provided by Olympus Springs Inc.

...

<Black screen>

"Jones! Jones! Wake up! I'm trying to talk to you!"

<Cut to a shot of two closed eyes>

"C'mon, open those eyes."

<The shot widens to show Galaxy Jones, the Solar System's greatest hero, flat on the floor, seemingly unconscious>

"This is getting tiresome, Jones. Stop playing dead."

Her eyes flutter open, close again, then open. She winces and brings one hand up to shield her eyes. "Who's that?" she says, hoarsely.

Join Galaxy Jones next time in Galaxy Jones II: Existential Time Crisis!
 _________      __                     _____                     
 __/ ____/___ _/ /___ __  ____  __     __/ /___  ____  ___  _____
 _/ / __/ __ `/ / __ `/ |/ / / / /____ _/ / __ \/ __ \/ _ \/ ___/
 / /_/ / /_/ / / /_/ />  </ /_/ / _/ /_/ / /_/ / / / /  __(__  ) 
 \____/\__,_/_/\__,_/_/|_|\__, /  _\____/\____/_/ /_/\___/____/  
 _____________________________/ 

Would you like to RESTART, RESTORE a saved game, QUIT, or UNDO the last command?