>gonear roof staits
There seems to be no such object anywhere in the model world.

>gonear roof stairs
Galaxy Jones is on the roof stairs.

>u
(first opening the roof access door)

Jones walks out onto the luxurious penthouse roof. Admiral Thallium turns from the railing to face Jones. He is dressed in an absurd elaboration of the Martian Admiral's uniform. He looks Jones up and down with a lecherous leer. "Ah, Galaxy Jones, as lovely as ever. If it weren't so unbearably cliché I'd ask you to join me in my rise to greatness. But alas, you are too habituated to the smug high of 'goodness'." He sighs dramatically. "We've trodden similar ground before; no need to discuss it further. Although I will challenge any of your various chèris to conjugate 'tread' correctly.

"Anyway, I guess this is the time where you do something predictably undignified and violent. Before you do I feel I should inform you that your sidearm has been rendered quite ineffective by my personal security field. But do go ahead and try it"

Galaxy Jones is on the penthouse roof. It is an extravagant and opulent space, designed to showcase Thallium's wealth and power. Much of the rooftop is devoted to an outdoor lounge area, with comfortable seating and a fire pit, centered around a hot tub and flanked by a bar. All around is the city of New Reykjavik, and beyond that the red Martian landscape. Around the entirety of the roof is an electrostatic field designed to keep air in and particulates out. To the north is a large cage, and to the west is a landing pad. You can distantly see a woman lying on the floor of the cage.

Numerous aircraft dot the skies around the city.

Admiral Thallium is here, leering at Jones.

Jones sees Admiral Thallium here.

* * *

>n
Jones approaches the Viking Building entryway, the dramatic façade towering over her.

Galaxy Jones is at the entry doorway. A glass revolving door leads into a large open space north of here. The speeder dock is to the south.

Jones peers upwards at the 100 stories of glass and steel. "What do you want to bet Thallium's got Europa all the way at the top?"

Beck: "Oh, no doubt."

>n
Jones takes a deep breath. "I'm going in."

Beck replies, "Be careful, Galaxy."

Jones passes through the revolving door and into the lobby, alert to any defenses.

Galaxy Jones is in the lobby. The ground floor of the Viking Building is breathtaking. Low-G architecture means more glass and thinner supports, and the building takes advantage of that. Four walls of glass surround a central pillar in which are set the utility rooms and elevators. In between is an expanse of plants, water installations, and stylish seating. Near the entryway is a front desk. A giant crystal sculpture floats above it, suspended on almost invisible cables.. She may go east and west from here, north to the elevators, or south out of the building.

>w
Before Jones gets a chance to do anything, two robot guards emerge from niches in the back wall! She dives behind the front desk and draws her disruptor pistol.

Jones shouts, "I'm under fire from two ugly robot things!"

Beck responds, "Monitoring lifesigns."

>shoot art
Jones fires the disruptor into the sculpture's main support cable, snapping it. The huge crystal blob starts to sag, straining the other cables. In quick succession they break as well, and the whole installation plummets to the ground, right on top of the hapless guard robots.

Beck: "What was that crash? What's going on?"

Jones: "That, my friend, was what you'd call a work of art. Targets terminated."

 _________      __                     _____                     
 __/ ____/___ _/ /___ __  ____  __     __/ /___  ____  ___  _____
 _/ / __/ __ `/ / __ `/ |/ / / / /____ _/ / __ \/ __ \/ _ \/ ___/
 / /_/ / /_/ / / /_/ />  </ /_/ / _/ /_/ / /_/ / / / /  __(__  ) 
 \____/\__,_/_/\__,_/_/|_|\__, /  _\____/\____/_/ /_/\___/____/  
 _____________________________/ 

[Your score has just gone up by one point.]

>w
Jones crosses the floor carefully, disruptor pistol at the ready.

Galaxy Jones is at the southwest corner of the ground floor. A lush waterfall here contrasts with the dusty red streets of New Reykjavik beyond the glass walls. The ground floor extends north and east.

>take coin
There's nothing like that nearby.

>x water
The waterfall descends the length of an artificial rock formation fringed by wide-leaved Earth plants and ferns. The water collects in a basin at the bottom, where it begins its journey again. A single coin sits on the bottom of the basin.

* * *

>x ruin
Jones digs through the ruins and finds a thingy, which she takes.

>w
Galaxy Jones is at the southwest corner of the ground floor. A lush waterfall here contrasts with the dusty red streets of New Reykjavik beyond the glass walls. The ground floor extends north and east.

* * *

>take medal
(the garish medal)
Taken.

>s
Galaxy Jones is on the east side of the ground floor. Apparently some kind of function was happening here before Admiral Thallium emptied the building, for there is an array of canapes on a catering table here. The floor stretches north and south, and there's a closet door to the west.

* * *

>take all
fork: Taken.
shrimp tea sandwich: Taken.
poached ostrich eggs in jelly: Don't even.

>type 0
(on the keypad)
An indicator light glows green.
opened maintenance closet

>w
(first opening the closet door)

Galaxy Jones is in the maintenance closet. 

There is an Atmo-Suit hanging from a hook here.

On the shelf is a red key card.

* * *

>e
(first opening the utility door)
(first unlocking the utility door)
(with the red key card)

Galaxy Jones is in the elevator room. This is a utility room related to the operation of the elevator, on the other side of the east wall here. There is a control panel on the wall, and a door leading west.

Hanging from a hook here is an elevator drop key.

>take drop key
Taken.

>w
Galaxy Jones is on the west side of the ground floor. Semicircular couches open on either side of a central carpeted path leading north and south. Set in the central pillar of the building to the east is a utility door. The city looms beyond the glass wall to the west.

* * *

>n
Galaxy Jones is in the ground floor elevator hall. This hallway between the north and south ends of the ground floor is home to the elevator to the west. To the east is the entrance to a stairwell.

>open elevator door with drop key
(the elevator drop key)
Jones inserts the elevator drop key into the drop key hole and turns it, disengaging the lock mechanism. Then she slides the door open.

>w
Jones climbs into the elevator shaft

Galaxy Jones is in the ground floor elevator shaft. She is at the bottom of a dark well. Shining her suit light up, she can see that the elevator car is several floors up, unmoving. There is a ladder on the west wall.

* * *

>u
Galaxy Jones is in the second floor elevator shaft.

>u
Galaxy Jones is in the third floor elevator shaft.

>u
Galaxy Jones is in the fourth floor elevator shaft.

>u
Galaxy Jones is in the fifth floor elevator shaft.

>u
Galaxy Jones is in the sixth floor elevator shaft.

>u
Galaxy Jones is in the seventh floor elevator shaft.

>u
Galaxy Jones is in the eighth floor elevator shaft.

>open door
Jones is unable to open the door. Perhaps it's blocked from the other side.

Jones: "No luck trying to open the elevator door."

Beck: "Try another."

Jones: "Thanks for the advice."

>u
Galaxy Jones is in the ninth floor elevator shaft.

* * *

>open door
Jones opens the ninth floor elevator door.

>e
Jones: "Finally out of the shaft. That was quite a climb."

Beck: "This floor is just offices. Check the building management office to the west. It might have some useful stuff."

 _________      __                     _____                     
 __/ ____/___ _/ /___ __  ____  __     __/ /___  ____  ___  _____
 _/ / __/ __ `/ / __ `/ |/ / / / /____ _/ / __ \/ __ \/ _ \/ ___/
 / /_/ / /_/ / / /_/ />  </ /_/ / _/ /_/ / /_/ / / / /  __(__  ) 
 \____/\__,_/_/\__,_/_/|_|\__, /  _\____/\____/_/ /_/\___/____/  
 _____________________________/ 

Galaxy Jones is in the ninth floor elevator hall. 

[Your score has just gone up by one point.]

>e
As soon as Jones enters the stairwell, a disruptor blast from above zings past her shoulder, and she beats a hasty retreat. She won't be going up the stairs until she can clear out the resistance, and she can't do that from here.

Galaxy Jones is in the ninth floor elevator hall.

* * *

>put coin in vending machine
Jones inserts the coin in the machine and takes the bottle that appears a few seconds later.

>n
Galaxy Jones is in the ninth floor north hallway.

>w
(first opening the north building management door)

Galaxy Jones is at the north end of the building management office.

>x desk
There seems to be nothing special about it.

>pick lock with pin
There's nothing like that nearby.

>x medal
While the front looks authentic, the reverse is engraved with Thallium's personal motto "Planetas Vincam". The ribbon conceals a safety pin. It looks like it could be removed.

>take pin
Taken.

>pick lock with pin
Jones pushes the pin into the keyhole and wiggles it around. After a few seconds the desk drawer pops open. It contains a black card key.

>take black
Taken.

>s
Galaxy Jones is at the south end of the building management office. 

A screwdriver sits atop the filing cabinet.

>take screwdriver
Jones reaches for the screwdriver, but she fumbles it and it rolls off the back of the filing cabinet.

Jones: "Damn."

Beck: "What? What's going on?"

Jones: "Just being clumsy is all."

* * *

>take screwdriver
Jones reaches behind the cabinet to retrieve the screwdriver. A swipe and a hiss make her recoil.

Jones: "Holy --!"

Beck: "What now?"

Jones: "There's a cat here! Behind a filing cabinet. Gotta get behind there to get a screwdriver, so I need a way to drive off the cat."

>look behind cabinet
(taking the screwdriver)
Forget it. Jones isn't getting another scratch.

>drop shrimp
Sensing food, the black cat pokes its head out, grabs the shrimp in its jaws, and races off.

Jones: "Aha! No creature is too fearsome for Galaxy Jones!"

Beck: "Congratulations on your victory."

 _________      __                     _____                     
 __/ ____/___ _/ /___ __  ____  __     __/ /___  ____  ___  _____
 _/ / __/ __ `/ / __ `/ |/ / / / /____ _/ / __ \/ __ \/ _ \/ ___/
 / /_/ / /_/ / / /_/ />  </ /_/ / _/ /_/ / /_/ / / / /  __(__  ) 
 \____/\__,_/_/\__,_/_/|_|\__, /  _\____/\____/_/ /_/\___/____/  
 _____________________________/ 

[Your score has just gone up by one point.]

>e
(first opening the south building management door)

Galaxy Jones is in the ninth floor south hallway.

>e
(first opening the Chemical door)
(first unlocking the Chemical door)
(with the black card key)

Galaxy Jones is in the Martian Chemical office.

>take chemical
Which do you mean, the Chemical door or the chemical cabinet?

>take gel
Taken.

>w
Galaxy Jones is in the ninth floor south hallway.

>n
Galaxy Jones is in the ninth floor elevator hall.

>n
Galaxy Jones is in the ninth floor north hallway.

>e
(first opening the Cybernetica door)
(first unlocking the Cybernetica door)
(with the black card key)

Galaxy Jones is in the Cybernetica office. It's spacious and luxurious, designed to make developers forget how spent they are from months of overwork and abuse. Ergonomic desks and chairs fill space like a furniture fractal, before giving way to an open area, presumably for group activities. At the south end of the room is a door labeled "Inspiration Chamber".

As soon as Jones steps into the office, a shot zaps just past her nose. She dives to the ground, protected by the maze of desks and chairs. Peeking through the mesh back of one of the chairs, she takes notice of both the purple guard robot training its disruptor on the room, and the chair's fine construction and lumbar support.

Jones (whispering): "We've got another one! I'm out of sight for now, but it's going to be hard to get a shot off at this 'bot."

Beck: "What's the situation?"

Jones: "I'm on the floor with desks and chairs all around. The target is a few yards off, coming this way. I might get a shot in, but it might just absorb it anyway."

Beck: "Well, see if you can sneak up on it. Maybe close up you can find a way past its defenses."

>sneak up on robot
Jones creeps a little ways toward the guard robot.

>g
Slowly, slowly, Jones gets a little closer. Just a little more...
She must have poked up her shoulder or something, for the guard robot fires his disruptor. The shot takes out a window on the east side of the room. The electrostatic field around the building keeps the atmosphere from pouring out.

>g
Jones is right up next to the robot, crouched beneath a desk. She'll never get a better shot.

>shoot robot
Jones aims the pistol upward under the robot's enhanced armor and fires. She flinches back when the robot's innards explode downward in a shower of sparks. It topples over, dead.

Jones: "Better than a video game. "

Beck: "Nice, but don't forget to credit your handler."

Jones: "Yes, yes, thanks for helping me not get killed."

Beck: "You're welcome."

 _________      __                     _____                     
 __/ ____/___ _/ /___ __  ____  __     __/ /___  ____  ___  _____
 _/ / __/ __ `/ / __ `/ |/ / / / /____ _/ / __ \/ __ \/ _ \/ ___/
 / /_/ / /_/ / / /_/ />  </ /_/ / _/ /_/ / /_/ / / / /  __(__  ) 
 \____/\__,_/_/\__,_/_/|_|\__, /  _\____/\____/_/ /_/\___/____/  
 _____________________________/ 

[Your score has just gone up by one point.]

>s
Galaxy Jones is in the Inspiration Chamber. One of the most unique features of the office is the "inspiration chamber," a specialized room designed to stimulate creativity and innovation. The room is filled with advanced technology, including AI-generated art, interactive displays, and sensory stimulation devices that can help employees think outside the box and come up with new ideas.

Jones: "This is some real B.S. here."

Beck: "What's that?"

Jones: "Never mind."

* * *

>z
Before Jones gets a chance to do anything, two robot guards emerge from niches in the back wall! She dives behind the front desk and draws her disruptor pistol.

Jones shouts, "I'm under fire from two ugly robot things!"

Beck responds, "Monitoring lifesigns."

>s
Trying to reach an exit would surely get Jones shot.

Jones: "I'm pinned down here!"

The green robot tries to flank her, but a shot from her disruptor sends it scurrying back.

>w
Trying to reach an exit would surely get Jones shot.

>shoot art
Jones fires the disruptor into the sculpture's main support cable, snapping it. The huge crystal blob starts to sag, straining the other cables. In quick succession they break as well, and the whole installation plummets to the ground, right on top of the hapless guard robots.

Beck: "What was that crash? What's going on?"

Jones: "That, my friend, was what you'd call a work of art. Targets terminated."
 _________      __                     _____                     
 __/ ____/___ _/ /___ __  ____  __     __/ /___  ____  ___  _____
 _/ / __/ __ `/ / __ `/ |/ / / / /____ _/ / __ \/ __ \/ _ \/ ___/
 / /_/ / /_/ / / /_/ />  </ /_/ / _/ /_/ / /_/ / / / /  __(__  ) 
 \____/\__,_/_/\__,_/_/|_|\__, /  _\____/\____/_/ /_/\___/____/  
 _____________________________/ 

[Your score has just gone up by one point.]

>x art
Jones digs through the ruins and finds a thingy, which she takes.

* * *

>x viking
Before Jones gets a chance to do anything, two robot guards emerge from niches in the back wall! She dives behind the front desk and draws her disruptor pistol.

Jones shouts, "I'm under fire from two ugly robot things!"

Beck responds, "Monitoring lifesigns."

>x viking
The entryway (exit actually) leads out to the speeder dock.

The robots intone "Destroy Jones" in an eerie drone.

>shoot robot
Who do you mean, the green guard robot or the red guard robot?

>green
A perfect shot! Yet, somehow, the robot is unscathed.
Jones: "Target seems to be absorbing disruptor fire. This will make things a little harder."

The two robots coordinate fire over the desk, narrowly missing Jones.

>g
Jones sticks her head out from behind the desk and squeezes off a shot at the green guard robot. In Jones's haste it goes wide of the target.

The green robot fires a blistering shot into the front desk.

>g
Jones's shot hits the green guard robot dead on, but nothing happens, almost as if the robot had absorbed the energy.

The green robot fires a blistering shot into the front desk.

>g
Oops! Jones misses.

>g
Oof. Big miss.

>g
A perfect shot! Yet, somehow, the robot is unscathed.

One of the robots fires directly above Jones's head.

>g
Oof. Big miss.

Zip! Disruptor fire scorches a nearby couch.

>g
A perfect shot! Yet, somehow, the robot is unscathed.

The green robot fires a blistering shot into the front desk.

>shoot couch
Shooting that would accomplish nothing.

One of the robots fires directly above Jones's head.

>shoot desk
Shooting that would accomplish nothing.

The two robots coordinate fire over the desk, narrowly missing Jones.

>shoot art
Jones fires the disruptor into the sculpture's main support cable, snapping it. The huge crystal blob starts to sag, straining the other cables. In quick succession they break as well, and the whole installation plummets to the ground, right on top of the hapless guard robots.

Beck: "What was that crash? What's going on?"

Jones: "That, my friend, was what you'd call a work of art. Targets terminated."

 _________      __                     _____                     
 __/ ____/___ _/ /___ __  ____  __     __/ /___  ____  ___  _____
 _/ / __/ __ `/ / __ `/ |/ / / / /____ _/ / __ \/ __ \/ _ \/ ___/
 / /_/ / /_/ / / /_/ />  </ /_/ / _/ /_/ / /_/ / / / /  __(__  ) 
 \____/\__,_/_/\__,_/_/|_|\__, /  _\____/\____/_/ /_/\___/____/  
 _____________________________/ 

[Your score has just gone up by one point.]

* * *

>x eggs
Definitely not to Jones's taste.

Jones: "You ever have poached ostrich eggs, Beck?"

Beck: "No, but I'll take you for some when you're done there."

Jones: "Oh, thanks."

>w
(first opening the closet door)
(first unlocking the closet door)
Jones will have to enter the correct code on the keypad.
Jones: "Door on the east side has a keypad lock."

>type 0
(on the keypad)
An indicator light glows green.
Jones: "I've unlocked the east side utility door."

>w
(first opening the closet door)

Galaxy Jones is in the maintenance closet. 

There is an Atmo-Suit hanging from a hook here.

On the shelf is a red key card.

* * *

>u
Galaxy Jones is in the second floor elevator shaft.

>open door
Jones is unable to open the door. Perhaps it's blocked from the other side.
Jones: "No luck trying to open the elevator door."

Beck: "Try another."

Jones: "Thanks for the advice."

>u
Galaxy Jones is in the third floor elevator shaft.

* * *

>s
Jones can't go that way. The obvious exits are north (to the ninth floor elevator hall), east and west (to the south end of the building management office).

>e
(first opening the Chemical door)
(first unlocking the Chemical door)
Jones lacks a key that fits the Chemical door.

>w
Galaxy Jones is at the south end of the building management office. 

A screwdriver sits atop the filing cabinet.

* * *

>e
Galaxy Jones is in the ninth floor north hallway.

>s
Galaxy Jones is in the ninth floor elevator hall.

>s
Galaxy Jones is in the ninth floor south hallway.

>e
(first opening the Chemical door)
(first unlocking the Chemical door)
(with the black card key)

Galaxy Jones is in the Martian Chemical office.

>take bottle
Taken.

>w
Galaxy Jones is in the ninth floor south hallway.

* * *

>sneak up on robot
Jones creeps a little ways toward the guard robot.

>sneak up on robot
Slowly, slowly, Jones gets a little closer. Just a little more...
She must have poked up her shoulder or something, for the guard robot fires his disruptor. The shot takes out a window on the east side of the room. The electrostatic field around the building keeps the atmosphere from pouring out.

>sneak up on robot
Jones is right up next to the robot, crouched beneath a desk. She'll never get a better shot.

>shoot robot
Jones aims the pistol upward under the robot's enhanced armor and fires. She flinches back when the robot's innards explode downward in a shower of sparks. It topples over, dead.

Jones: "Better than a video game. "

Beck: "Nice, but don't forget to credit your handler."

Jones: "Yes, yes, thanks for helping me not get killed."

Beck: "You're welcome."

 _________      __                     _____                     
 __/ ____/___ _/ /___ __  ____  __     __/ /___  ____  ___  _____
 _/ / __/ __ `/ / __ `/ |/ / / / /____ _/ / __ \/ __ \/ _ \/ ___/
 / /_/ / /_/ / / /_/ />  </ /_/ / _/ /_/ / /_/ / / / /  __(__  ) 
 \____/\__,_/_/\__,_/_/|_|\__, /  _\____/\____/_/ /_/\___/____/  
 _____________________________/ 

[Your score has just gone up by one point.]

>l
Galaxy Jones is in the Cybernetica office. It's spacious and luxurious, designed to make developers forget how spent they are from months of overwork and abuse. Ergonomic desks and chairs fill space like a furniture fractal, before giving way to an open area, presumably for group activities. At the south end of the room is a door labeled "Inspiration Chamber". One of the windows along the east side of the office is broken.

>s
Galaxy Jones is in the Inspiration Chamber. One of the most unique features of the office is the "inspiration chamber," a specialized room designed to stimulate creativity and innovation. The room is filled with advanced technology, including AI-generated art, interactive displays, and sensory stimulation devices that can help employees think outside the box and come up with new ideas.
Jones: "This is some real B.S. here."

Beck: "What's that?"

Jones: "Never mind."

>n
Galaxy Jones is in the Cybernetica office. It's spacious and luxurious, designed to make developers forget how spent they are from months of overwork and abuse. Ergonomic desks and chairs fill space like a furniture fractal, before giving way to an open area, presumably for group activities. At the south end of the room is a door labeled "Inspiration Chamber". One of the windows along the east side of the office is broken.

* * *

>press up button
Jones presses the button, and the scaffold begins to rise.

Galaxy Jones is on a window washing scaffold. It's lined up with the ninth floor window. She could climb back into the building through the window here. Mounted on the scaffold is a control panel with two buttons: one indicating up and one indicating down.

Jones: "Beck?"

Beck: "Yes?"

Jones: "I hate it out here."

Beck: "Well, there's the open window right next to you."

>press up button
Jones presses the button, and the scaffold begins to rise.

Galaxy Jones is on a window washing scaffold. It's lined up with the tenth floor. Instead of a window, there's what appears to be an exhaust vent. If it's for forced air, though, the fan is currently not running. Mounted on the scaffold is a control panel with two buttons: one indicating up and one indicating down.
Jones: "Alright, I'm by the tenth floor now. What's this grill thing here?"

Beck: "That's an exhaust vent. There's an air handling room on this floor which it leads into. If you can get the cover off you should be able to access the whole floor from here."

>press up button
Nothing happens.

* * *

>remove screws
(the exhaust vent)
Jones loosens the screws and removes the grill from the vent.

>w
Jones climbs inside the vent, crawls along a short length of duct work, and emerges through another, hinged grill, into the air handling room.

Galaxy Jones is in the air handling room. 

She doffs the Atmo-Suit.

Jones: "Ha! I'm in!"

Beck: "Be careful, you're likely to run into more resistance here. The floor is all one open office, so any guard robots will have good line of sight."

Jones: "Got it."

Beck: "And Jones? Save your game."

 _________      __                     _____                     
 __/ ____/___ _/ /___ __  ____  __     __/ /___  ____  ___  _____
 _/ / __/ __ `/ / __ `/ |/ / / / /____ _/ / __ \/ __ \/ _ \/ ___/
 / /_/ / /_/ / / /_/ />  </ /_/ / _/ /_/ / /_/ / / / /  __(__  ) 
 \____/\__,_/_/\__,_/_/|_|\__, /  _\____/\____/_/ /_/\___/____/  
 _____________________________/ 

[Your score has just gone up by one point.]

>w
(first opening the air handling door)

Galaxy Jones is on the north side of the Consolidated Microthings office.

* * *

>s
Galaxy Jones is on the south side of the Consolidated Microthings office. 

Jones sees the mauve guard robot to the west.

>n
Galaxy Jones is in the tenth floor elevator hall. 

The mauve guard robot appears to the south, coming from the west.

>w
Galaxy Jones is in the elevator car. It's luxurious, with gold-plated walls and crystal lighting on the ceiling. The button panel is lacquered dark mahogany with what looks like real ivory buttons. The carpeting is soft and plush. A golden keyhole sits above the buttons.

The mauve guard robot appears to the east, coming from the south.

* * *

>u
Galaxy Jones is on the top of the elevator car. The elevator shaft extends many hundreds of feet above here. You can see down into the elevator car from here.

The mauve guard robot enters the elevator car below.

>shoot robot
From the top, even from this range, your shot is entirely ineffective. The robot swivels its head to find you, and you barely jump back out of sight.

>pour gel on robot
Jones tries, but she can't get close enough to the robot.

The mauve guard robot exits the elevator car, out of sight.

>jump on robot
There's nothing like that nearby.

>pour chemical on robot
There's nothing like that nearby.

>pour gel on robot
There's nothing like that nearby.

>e
Galaxy Jones is in the tenth floor elevator hall.

>s
Galaxy Jones is on the south side of the Consolidated Microthings office.

>w
Galaxy Jones is at the southwest corner of the Consolidated Microthings office. 

There is a present with a note attached sitting on a desk here.

>take present
Taken.

>open it
Jones rips the package open and discovers a golden key.

>e
Galaxy Jones is on the south side of the Consolidated Microthings office.

>n
Galaxy Jones is in the tenth floor elevator hall.

>w
Galaxy Jones is in the elevator car. It's luxurious, with gold-plated walls and crystal lighting on the ceiling. The button panel is lacquered dark mahogany with what looks like real ivory buttons. The carpeting is soft and plush. A golden keyhole sits above the buttons.

Also here is the dead robot.

>put golden key in keyhole
Jones puts the key in the keyhold and turns. There is a pleasant chime, and some buttons light up.

Galaxy Jones is in the elevator car. It's luxurious, with gold-plated walls and crystal lighting on the ceiling. The button panel is lacquered dark mahogany with what looks like real ivory buttons. The carpeting is soft and plush. A golden key rests in a golden keyhole above the buttons. The buttons 1, 9, 10, and 100 are illuminated.

Also here is the dead robot.

Admiral Thallium's voice oozes from concealed speakers: "Yes, Jones, that is real ivory. I imported the elephant here myself for a hunt on my estate. You have no idea how much money it takes to simulate a African jungle on Mars. On second thought I should have gotten an Indian elephant."

>undo
elevator car
[Previous turn undone.]

>rules
Rules tracing now switched on. Type "rules off" to switch it off again, or "rules all" to include even rules which do not apply.

[Rule "clear LPR rule" applies.]

* * *

>pour gel on robot
There's nothing like that nearby.

>i
Jones is carrying:
  a screwdriver
  a bottle of Electrofil quick-setting conductive polymer gel
  a black card key
  an elevator drop key
  a red key card
  an Atmo-Suit
  a fork
  a safety pin
  a garish medal
  a coin
  a thingy
  a disruptor pistol

* * *

>pour gel on robot
Jones tries, but she can't get close enough to the robot.

The mauve guard robot exits the elevator car, out of sight.

>z
Jones stands around and waits.

>d
Galaxy Jones is in the elevator car. It's luxurious, with gold-plated walls and crystal lighting on the ceiling. The button panel is lacquered dark mahogany with what looks like real ivory buttons. The carpeting is soft and plush. A golden keyhole sits above the buttons.

>e
Galaxy Jones is in the tenth floor elevator hall.

* * *

>u
Galaxy Jones is on the top of the elevator car. The elevator shaft extends many hundreds of feet above here. You can see down into the elevator car from here.

The mauve guard robot enters the elevator car below.

>jump on robot
Jones drops down through the ceiling and on to the guard robot. It swings around looking for her, obviously panicked that it can't bring its gun to bear on its attacker. Jones manages to hang on.

Galaxy Jones is in the elevator car. It's luxurious, with gold-plated walls and crystal lighting on the ceiling. The button panel is lacquered dark mahogany with what looks like real ivory buttons. The carpeting is soft and plush. A golden keyhole sits above the buttons.

The mauve guard robot struggles against her hold on it, to no avail.

Jones sees the mauve guard robot here.

>shoot robot
Firing would be too risky at this close range. You could easily hit yourself with the rebound.

The mauve guard robot struggles against Jones's hold on it, to no avail.

>pour gel on vent
There's nothing like that nearby.

>x vent
There's nothing like that nearby.

>x robot
This one looks, if anything, even meaner than the ones Jones has already seen. There is a small vent on the top of its head, probably to dispose of excess heat.

The mauve guard robot throws her from its back, and she goes sprawling into the corner of the elevator. The robot rotates its disruptor barrel to face her, and opens fire.

    *** The End ***

In that game you scored 5 out of a possible 0, in 170 turns.

Would you like to RESTART, RESTORE a saved game, QUIT, or UNDO the last command?

* * *

>shoot robot
Firing would be too risky at this close range. You could easily hit yourself with the rebound.

The mauve guard robot struggles against Jones's hold on it, to no avail.

>undo
elevator car
[Previous turn undone.]

* * *

>u
Galaxy Jones is on the top of the elevator car. The elevator shaft extends many hundreds of feet above here. You can see down into the elevator car from here.

The mauve guard robot enters the elevator car below.

>x robot
This one looks, if anything, even meaner than the ones Jones has already seen. It's looking around as if confused. There is a small vent on the top of its head, probably to dispose of excess heat.

>x vent
Definitely a point of weakness.

Jones: "I think I see a point of weakness. Now if I can just get in close enough..."

Beck: "Just stay out of its line of sight."

The mauve guard robot exits the elevator car, out of sight.

>d
Galaxy Jones is in the elevator car. It's luxurious, with gold-plated walls and crystal lighting on the ceiling. The button panel is lacquered dark mahogany with what looks like real ivory buttons. The carpeting is soft and plush. A golden keyhole sits above the buttons.

The mauve guard robot approaches from the east.
The robot slaughters Jones.

    *** The End ***

In that game you scored 5 out of a possible 0, in 170 turns.

Would you like to RESTART, RESTORE a saved game, QUIT, or UNDO the last command?

* * *

>x vent
Definitely a point of weakness.

Jones: "I think I see a point of weakness. Now if I can just get in close enough..."

Beck: "Just stay out of its line of sight."

The mauve guard robot exits the elevator car, out of sight.

>z
Jones stands around and waits.

* * *

>jump on robot
Jones drops down through the ceiling and on to the guard robot. It swings around looking for her, obviously panicked that it can't bring its gun to bear on its attacker. Jones manages to hang on.

The mauve guard robot struggles against her hold on it, to no avail.

>pour gel in vent
Jones pours the gel into the  vent on the robot's head. The robot flails around wildly and throws her from its back, then lets out a loud crackling sound and stops moving.

Galaxy Jones is in the elevator car. It's luxurious, with gold-plated walls and crystal lighting on the ceiling. The button panel is lacquered dark mahogany with what looks like real ivory buttons. The carpeting is soft and plush. A golden keyhole sits above the buttons.

The remains of the mauve guard robot are sprawled on the ground.

>x remains
There's nothing like that nearby.

>x robot
There seems to be nothing special about it.

>x dead robot
There seems to be nothing special about it.

>x ground
There's nothing like that nearby.

>x floor
There seems to be nothing special about it.

>x wall
There's nothing like that nearby.

>x ceiling
There's nothing like that nearby.

>look up
Jones sees the top of the elevator car in that direction.

>look down
There's nothing in that direction.

* * *

>purloin cable
[Purloined.]

>purloin water
(the full water bottle)
[Purloined.]

>gonear roof stairs
Galaxy Jones is on the roof stairs.

>u
(first opening the roof access door)
Jones open the door and step through onto the roof. The door crashes shut, and a lock audibly clicks.

Jones walks out onto the luxurious penthouse roof. Admiral Thallium turns from the railing to face her. He is dressed in an absurd elaboration of a Martian Admiral's uniform. He looks Jones up and down with a lecherous leer. "Ah, Galaxy Jones, as lovely as ever. If it weren't so unbearably cliché I'd ask you to join me in my rise to greatness. But alas, you are too habituated to the smug high of 'goodness'." He sighs dramatically. "We've trodden similar ground before; no need to discuss it further. Although I would challenge any of your various amants to conjugate 'tread' correctly.

"Anyway, I guess this is the time where you do something predictably undignified and violent. Before you do I feel I should inform you that your sidearm has been rendered quite ineffective by my personal security field. But do go ahead and try it."

Jones sneers. "I wouldn't give you the satisfaction," she says, looking around. "I see you don't have any of your robot pets up here. How are you going to stop me from rescuing Europa?"

"Oh please, while we're trying things, try that too. I wish you luck breaking the silnium bars of the cage."

"What's silnium?"

"A superstrong material invented here in my Martian Chemical laboratory. We had a press conference for it -- weren't you watching?"

"Couldn't be bothered."

"Oh for frotz sake, Jones, you're so frustrating!"

Thallium turns his back on Jones and stares out over the city.

Galaxy Jones is on the penthouse roof. It is an extravagant and opulent space, designed to showcase Thallium's wealth and power. Much of the rooftop is devoted to an outdoor lounge area, with comfortable seating and a fire pit, centered around a hot tub and flanked by a bar. All around is the city of New Reykjavik, and beyond that the red Martian landscape. Around the entirety of the roof is an electrostatic field designed to keep air in and particulates out. To the north is a large cage, and to the west is a landing pad. You can distantly see a woman lying on the floor of the cage. A green and black flyer sits on the landing pad.

Admiral Thallium is sulking.

>n
Galaxy Jones is next to a cage. The closely-set silnium bars seem to dash all hope of a rescue.

Europa Callisto is lying at the center of the cage, out of Jones's reach.

Also here is a cage.

Jones tries the strength of the bars just in case. They don't budge.

South of the cage, Thallium crosses the roof to the flyer pad, where he boards the waiting flyer. The flyer lifts off and moves towards you.

>throw cable at flyer
Foo
Thallium's flyer hovers over the rooftop. "Jones!"  he bellows. "Play time is over. I grow weary of your intransigence. In a moment this roof will be swarmed by guard robots -- of many different colors -- so many robots you couldn't possibly vandalize them all.  Say your prayers, Jones, or whatever you do when you're about to die."

Jones rolls her eyes.

A little ways off, a small flyer aims for the rooftop and accelerates.

>climb cage
Jones gets onto the cage.

Jones sees Europa Callisto here.

>scenes
Scene 'Entire Game' playing (for 5 mins now)
Scene 'Endgame' playing (for 4 mins now)
Scene 'On-Rooftop' ended
Scene 'Thallium alight' ended
Scene 'Thallium ultimatum' playing (for 1 mins now)
(Scene monitoring now switched on. Type "scenes off" to switch it off again.)

>throw cable at flyer
Jones throws the cable up to the flyer where it hooks around the rail, and attaches the other end to the cage, then jumping off the cage to escape the aftermath. Seeing his flyer's predicament, Thallium screams at his pilot to escape. The flyer reaches the end of its tether and slingshots downwards, slamming into side of the building.

The cage has tilted to the side, one attachment tearing loose from the rooftop. Jones crawls into the cage to see to Europa Callisto.

"Europa! Can you hear me? I need you to move to get out of this cage. I can't carry you through that small opening. Europa!"

[Scene 'Thallium ultimatum' ends]
[Scene 'Saving Europa' begins]

* * *

>climb cage
Jones gets onto the cage.

Jones sees Europa Callisto here.

>throw cable at flyer
Jones throws the cable up to the flyer where it hooks around the rail, and attaches the other end to the cage, then jumps off the cage to escape the aftermath. Seeing his flyer's predicament, Thallium screams at his pilot to escape. The flyer reaches the end of its tether and slingshots downwards, slamming into side of the building.

The cage has tilted to the side, one attachment torn loose from the rooftop. Jones crawls into the cage to see to Europa Callisto.

"Europa! Can you hear me? I need you to move to get out of this cage. I can't carry you through that small opening. Europa!"

Europa moans but doesn't show any signs of having understood Jones.

>give water to europa
Jones opens the water bottle and brings it to Europa's lips. Even with closed eyes she drinks, first slowly and then with renewed vigor, until her eyes open.

"Ga- Galaxy Jones?" she says.

Jones nods, but says "We'll have time for introductions later. We have to get out of here before the roof is full of killer robots. Can you crawl? If you can get through that hole I can carry you the rest of the way."

Europa nods. "I think so."

Galaxy Jones helps her through the hole in the cage, then gently picks her and jogs toward the waiting flyer. Beck's familiar face appears at the door of the aircraft, urging her on.
Not so far away, Admiral Thallium has somehow survived the crash and scaled the cable back to the roof. As he pulls himself up, he aims a pistol at Jones's back...
...and she falls sprawling on the landing pad, Europa Callisto tumbling from her arms. Beck is by Callisto's side in a moment, lifting her and carrying her into the flyer.
And then the robots swarm the roof. By the time Beck returns to the door it is already too late. A group of robots surrounds Jones, while another robot carries Thallium triumphantly. Beck has no choice but to take off, leaving Jones behind, not knowing if she still lives...

    *** The End, For Now... ***

In that game you scored 0 out of a possible 0, in 7 turns.

Extensions by:
Standard Rules version 3/120430 by Graham Nelson
Deluxe Doors version 4 by Emily Short
Skeleton Keys by Emily Short
Epistemology version 9 by Eric Eve
Exit Lister version 11 by Eric Eve
Gender Options version 3/210331 by Nathanael Nerode

Story by Phil Riley.
Programming by Phil Riley.
Playtesting by TBD.
Invaluable inspiration from Laura Taalman.

The story, all names, characters, and incidents portrayed in this production are fictitious. No identification with actual persons (living or deceased), places, buildings, and products is intended or should be inferred.

Promotional consideration provided by Olympus Springs Inc.

...

<Black screen>

"Jones! Jones! Wake up! I'm trying to talk to you!"

<Cut to a shot of two closed eyes>

"C'mon, open those eyes."

<The shot widens to show Galaxy Jones, the Solar System's greatest hero, flat on the floor, seemingly unconscious>

"This is getting tiresome, Jones. Stop playing dead."

Her eyes flutter open, close again, then open. She winces and brings one hand up to shield her eyes. "Who's that?" she says, hoarsely.

Join Galaxy Jones next time in Existential Time Crisis!
 _________      __                     _____                     
 __/ ____/___ _/ /___ __  ____  __     __/ /___  ____  ___  _____
 _/ / __/ __ `/ / __ `/ |/ / / / /____ _/ / __ \/ __ \/ _ \/ ___/
 / /_/ / /_/ / / /_/ />  </ /_/ / _/ /_/ / /_/ / / / /  __(__  ) 
 \____/\__,_/_/\__,_/_/|_|\__, /  _\____/\____/_/ /_/\___/____/  
 _____________________________/ 

Would you like to RESTART, RESTORE a saved game, QUIT, or UNDO the last command?

>undo
cage
[Previous turn undone.]

>rules
Rules tracing now switched on. Type "rules off" to switch it off again, or "rules all" to include even rules which do not apply.

[Rule "clear LPR rule" applies.]

>give water to europa
[Rule "After deciding the scope of the player" applies.]
[Rule "After deciding the scope of the player" applies.]
[Rule "After deciding the scope of the player" applies.]
[Rule "After deciding the scope of the player" applies.]
[Rule "After deciding the scope of the player" applies.]
[Rule "After deciding the scope of the player" applies.]
[Rule "After deciding the scope of the player" applies.]
[Rule "After deciding the scope of the player" applies.]
[Rule "After deciding the scope of the player" applies.]
[Rule "declare everything initially unmentioned rule" applies.]
[Rule "assign alternative door targets rule" applies.]
[Rule "announce items from multiple object lists rule" applies.]
[Rule "set pronouns from items from multiple object lists rule" applies.]
[Rule "before stage rule" applies.]
[Rule "Before doing something" applies.]
[Rule "keychain-aware carrying requirements rule" applies.]
[Rule "instead stage rule" applies.]
[Rule "Instead of giving the bottled water to Europa" applies.]
water
[Rule "when play ends stage rule" applies.]
[Rule "print player's obituary rule" applies.]

    *** The End, For Now... ***

In that game you scored 0 out of a possible 0, in 7 turns.
[Rule "After printing the player's obituary" applies.]

Join Galaxy Jones next time in Existential Time Crisis!
 _________      __                     _____                     
 __/ ____/___ _/ /___ __  ____  __     __/ /___  ____  ___  _____
 _/ / __/ __ `/ / __ `/ |/ / / / /____ _/ / __ \/ __ \/ _ \/ ___/
 / /_/ / /_/ / / /_/ />  </ /_/ / _/ /_/ / /_/ / / / /  __(__  ) 
 \____/\__,_/_/\__,_/_/|_|\__, /  _\____/\____/_/ /_/\___/____/  
 _____________________________/ 

[Rule "print the final question rule" applies.]
Would you like to RESTART, RESTORE a saved game, QUIT, or UNDO the last command?
[Rule "print the final prompt rule" applies.]

>undo
[Rule "standard respond to final question rule" applies.]
cage
[Previous turn undone.]

>credits
[Rule "After deciding the scope of the player" applies.]
[Rule "After deciding the scope of the player" applies.]
[Rule "After deciding the scope of the player" applies.]
That's not a verb I recognise.
[Rule "clear LPR rule" applies.]

>about
[Rule "After deciding the scope of the player" applies.]
[Rule "After deciding the scope of the player" applies.]
[Rule "After deciding the scope of the player" applies.]
That's not a verb I recognise.
[Rule "clear LPR rule" applies.]

* * *

>scenes
Scene 'Entire Game' playing (for 0 mins now)
(Scene monitoring now switched on. Type "scenes off" to switch it off again.)

>gonear roof stairs
Galaxy Jones is on the roof stairs.

>u
(first opening the roof access door)

Jones walks out onto the luxurious penthouse roof. Admiral Thallium turns from the railing to face Jones. He is dressed in an absurd elaboration of a Martian Admiral's uniform. He looks Jones up and down with a lecherous leer. "Ah, Galaxy Jones, as lovely as ever. If it weren't so unbearably cliché I'd ask you to join me in my rise to greatness. But alas, you are too habituated to the smug high of 'goodness'." He sighs dramatically. "We've trodden similar ground before; no need to discuss it further. Although I will challenge any of your various chèris to conjugate 'tread' correctly.

"Anyway, I guess this is the time where you do something predictably undignified and violent. Before you do I feel I should inform you that your sidearm has been rendered quite ineffective by my personal security field. But do go ahead and try it"

Galaxy Jones is on the penthouse roof. It is an extravagant and opulent space, designed to showcase Thallium's wealth and power. Much of the rooftop is devoted to an outdoor lounge area, with comfortable seating and a fire pit, centered around a hot tub and flanked by a bar. All around is the city of New Reykjavik, and beyond that the red Martian landscape. Around the entirety of the roof is an electrostatic field designed to keep air in and particulates out. To the north is a large cage, and to the west is a landing pad. You can distantly see a woman lying on the floor of the cage.

Numerous aircraft dot the skies around the city.

Admiral Thallium is here, smirking at Jones.

[Scene 'On-Rooftop' begins]

>w
Galaxy Jones is on the flyer pad. 

[Scene 'Thallium alight' begins]
[Scene 'On-Rooftop' ends]

>undo
penthouse roof
[Previous turn undone.]

>n
Galaxy Jones is in a cage. 

[Scene 'Thallium alight' begins]
[Scene 'On-Rooftop' ends]
Jones sees Europa Callisto here.