>s
Galaxy Jones is in the tenth floor elevator hall. The elevator car to the west stands open. There is a stairwell to the east. The hall runs north and south into a sumptuous corporate office.

>n
Galaxy Jones is on the north side of the Consolidated Microthings office. This is the company cafeteria. The elevator is south, the air handling room is to the east, and the office continues to the west and southeast.

>e
Galaxy Jones is in the air handling room. There is a good number of loud fans and other air handling machinery here. A small hinged vent opening leads into some ductwork, and from there to the outside. A door leads west.

>s
Jones can go west through the door, or east back out to the scaffold.

>se
Jones can go west through the door, or east back out to the scaffold.

>s
Jones can go west through the door, or east back out to the scaffold.

>w
Galaxy Jones is on the north side of the Consolidated Microthings office. This is the company cafeteria. The elevator is south, the air handling room is to the east, and the office continues to the west and southeast.

Thallium's voice booms over the office PA: "You can run, Jones, but you can't - well, there aren't very many places you can hide."

>se
Galaxy Jones is on the east side of the Consolidated Microthings office. This part of the office is currently unused. Jones can go northwest or south from here.

>s
Galaxy Jones is at the southeast corner of the Consolidated Microthings office. This corner of the floor contains the gym and other company amenities. Reception is to the west, and an empty area lies to the north.

Beck: "If I only had a heart, indeed."

Jones sees the mauve guard robot a couple of steps to the west.

>shoot gym
Focus on the robot instead.

A couple of steps to the west, the mauve guard robot heads east.

>n
Galaxy Jones is on the east side of the Consolidated Microthings office. This part of the office is currently unused. Jones can go northwest or south from here.

The mauve guard robot appears nearby to the south, coming from the west.

Thallium: "Jones, you still hanging around with that loser Beck?"

>nw
Galaxy Jones is on the north side of the Consolidated Microthings office. This is the company cafeteria. The elevator is south, the air handling room is to the east, and the office continues to the west and southeast.

The mauve guard robot appears nearby to the southeast, coming from the south.

* * *

>s
Galaxy Jones is on the west side of the Consolidated Microthings office. This ocean of desks looks out toward the Utopia Tower, twice the height of the Viking Building, where Jones is now. One can go north or south.

The mauve guard robot appears nearby to the north, coming from the east.

>s
Galaxy Jones is at the southwest corner of the Consolidated Microthings office. This looks like the IT area of the office. Numerous desks and an abundance of computer parts are here. Jones can go north or east from here.

There is a present with a note attached sitting on a desk here.

A couple of steps to the north, the mauve guard robot heads south.

Beck: "Come and get us, ugly!"

Jones: "'Us'? Seems like I'm the only one with her life on the line."

>e
Galaxy Jones is on the south side of the Consolidated Microthings office. This is reception. The front desk has a great view of the New Reykjavik Botanic Dome. Couches are lined up to take advantage. The floor extends east and west, and north to the elevator.

The mauve guard robot appears nearby to the west, coming from the north.

>n
Galaxy Jones is in the tenth floor elevator hall. The elevator car to the west stands open. There is a stairwell to the east. The hall runs north and south into a sumptuous corporate office.

The mauve guard robot appears nearby to the south, coming from the west.

Thallium: "Don't you just hate it, Jones -- not knowing when death will just jump out at you?"

>nw
The elevator is to the west, the stairs are to the east, and the office floor lies both north and south of here.

The mauve guard robot approaches from the south.

The robot electrocutes Jones with its electro-darts.

    *** Jones was killed by the mauve guard robot ***

In that game you scored 0 out of a possible 10, in 20 turns.

Would you like to RESTART, RESTORE a saved game, QUIT, or UNDO the last command?

>undo
Galaxy Jones is in the tenth floor elevator hall.
[Previous turn undone.]

>n
Galaxy Jones is on the north side of the Consolidated Microthings office. This is the company cafeteria. The elevator is south, the air handling room is to the east, and the office continues to the west and southeast.

A couple of steps to the south, the mauve guard robot heads north.

>e
Galaxy Jones is in the air handling room. There is a good number of loud fans and other air handling machinery here. A small hinged vent opening leads into some ductwork, and from there to the outside. A door leads west.

* * *

>z
Jones stands around and waits.

>s
Jones can go west through the door, or east back out to the scaffold.

>w
Galaxy Jones is on the north side of the Consolidated Microthings office. This is the company cafeteria. The elevator is south, the air handling room is to the east, and the office continues to the west and southeast.

* * *

>s
Galaxy Jones is in the tenth floor elevator hall. The elevator car to the west stands open. There is a stairwell to the east. The hall runs north and south into a sumptuous corporate office.

>w
Galaxy Jones is in the elevator car. It's luxurious, with gold-plated walls and crystal lighting on the ceiling. The button panel is lacquered dark mahogany with what look like real ivory buttons. The carpeting is soft and plush. A golden keyhole sits above the buttons. You can leave the elevator to the east.

One of the ceiling panels looks loose.

Admiral Thallium's voice oozes from concealed speakers: "Yes, Jones, that is real ivory. I imported the elephant here myself for a hunt on my estate. You have no idea how much money it takes to simulate an African jungle on Mars. In retrospect I should have gotten an Indian elephant."

>open panel
(the ceiling panel)
Jones removes the ceiling panel, exposing a hole wide enough for her to squeeze through.

>s
The exit is to the east.

>e
Galaxy Jones is in the tenth floor elevator hall. The elevator car to the west stands open. There is a stairwell to the east. The hall runs north and south into a sumptuous corporate office.

>s
Galaxy Jones is on the south side of the Consolidated Microthings office. This is reception. The front desk has a great view of the New Reykjavik Botanic Dome. Couches are lined up to take advantage. The floor extends east and west, and north to the elevator.

Jones sees the mauve guard robot nearby to the west.

>n
Galaxy Jones is in the tenth floor elevator hall. The elevator car to the west stands open. There is a stairwell to the east. The hall runs north and south into a sumptuous corporate office.

The mauve guard robot appears nearby to the south, coming from the west.

>w
Galaxy Jones is in the elevator car. It's luxurious, with gold-plated walls and crystal lighting on the ceiling. The button panel is lacquered dark mahogany with what look like real ivory buttons. The carpeting is soft and plush. A golden keyhole sits above the buttons. There is a hole in the ceiling big enough for Jones to squeeze through. You can leave the elevator to the east.

The mauve guard robot appears nearby to the east, coming from the south.

>u
Galaxy Jones is on the top of the elevator car. The elevator shaft extends many hundreds of feet above her. She can see down into the elevator car from here.

The mauve guard robot enters the elevator car below.

>shoot shaft
Jones only uses violent means when absolutely necessary.

>shoot vent
Jones only uses violent means when absolutely necessary.

The mauve guard robot exits the elevator car, out of sight.

>undo
Galaxy Jones is on the top of the elevator car.
[Previous turn undone.]

>undo
Galaxy Jones is on the top of the elevator car.
[Previous turn undone.]

>shoot robot
From the top, even from this range, Jones's shot is entirely ineffective. The robot swivels its head to find her, and she barely jumps back out of sight.

* * *

>gonear admiral thallium
(Admiral Thallium)
Galaxy Jones is on the penthouse roof. It is an extravagant and opulent space, designed to showcase Thallium's wealth and power. Much of the rooftop is devoted to an outdoor lounge area, with comfortable seating and a fire pit, centered around a hot tub and flanked by a bar. All around is the city of New Reykjavik, and beyond that the red Martian landscape. Around the entirety of the roof is an electrostatic field designed to keep air in and particulates out. To the north is a large cage, and to the west is a landing pad. Jones can distantly see a woman lying on the floor of the cage. A green and black flyer sits on the landing pad.

Admiral Thallium is sulking.

>kiss thallium
(Admiral Thallium)
Jones would rather not touch Thallium.

>n
Galaxy Jones is next to the cage. The closely-set silnium bars seem to dash all hope of a rescue. The flyer pad is to the southwest and the rest of the rooftop to the south.

Europa Callisto is lying at the center of the cage, out of Jones's reach.

Jones tries the strength of the bars just in case. They don't budge.

South of the cage, Thallium crosses the roof to the flyer pad, where he boards the waiting flyer. The flyer lifts off and moves towards Jones.

>kiss europa
Jones can't reach Europa inside the cage.

Thallium's flyer hovers over the rooftop. "Jones!"  he bellows. "Play time is over. I grow weary of your intransigence. In a moment this roof will be swarmed by guard robots -- of many different colors -- so many robots you couldn't possibly vandalize them all.  Say your prayers, Jones, or whatever you do when you're about to die."

Jones rolls her eyes.

A little ways off, another flyer, small and red, aims for the rooftop and accelerates.

>purloin cable
(the cable with hooks at either end)
[Purloined.]

>get on cage
Jones gets onto the cage.

>throw cable at flyer
(Admiral Thallium's flyer)
 _________      __                     _____                     
 __/ ____/___ _/ /___ __  ____  __     __/ /___  ____  ___  _____
 _/ / __/ __ `/ / __ `/ |/ / / / /____ _/ / __ \/ __ \/ _ \/ ___/
 / /_/ / /_/ / / /_/ />  </ /_/ / _/ /_/ / /_/ / / / /  __(__  ) 
 \____/\__,_/_/\__,_/_/|_|\__, /  _\____/\____/_/ /_/\___/____/  
 _____________________________/ 

[Your score has just gone up by one point.]

Jones throws the cable up to the flyer where it hooks around the rail, and attaches the other end to the cage, then jumps off the cage to escape the aftermath. Seeing his flyer's predicament, Thallium jumps out of the craft and disappears below the edge of the roof. The flyer reaches the end of its tether and slingshots downwards, slamming into side of the building.

The cage has tilted to the side, one attachment torn loose from the rooftop. Jones crawls into the cage to see to Europa Callisto.

"Europa! Can you hear me? I need you to move to get out of this cage. I can't carry you through that small opening. Europa!"

Europa moans but doesn't show any signs of having understood Jones.

Galaxy Jones is in the cage. The whole structure is tilted, leaving a hole at the eastern end. The flyer pad is to the southwest and the rest of the rooftop to the south.

Jones is kneeling at Europa Callisto's side, trying to rouse her.

The red flyer, now recognizable as Galaxy's own, settles down onto the landing pad.

>kiss callisto
That would be totally inappropriate, given the circumstances.

>gonear air
(the air handling room)
Galaxy Jones is in the air handling room. There is a good number of loud fans and other air handling machinery here. A small hinged vent opening leads into some ductwork, and from there to the outside. A door leads west.

Beck sticks his head out of the door of the flyer and yells "C'mon Jones, get Europa and get in the flyer!"

>w
(first opening the air handling door)

Galaxy Jones is on the north side of the Consolidated Microthings office. This is the company cafeteria. The elevator is south, the air handling room is to the east, and the office continues to the west and southeast.

Thallium's voice booms over the office PA: "You can run, Jones, but you can't - well, there aren't very many places you can hide."

>s
Galaxy Jones is in the tenth floor elevator hall. The elevator car to the west stands open. There is a stairwell to the east. The hall runs north and south into a sumptuous corporate office.

Thallium: "Jones, you still hanging around with that loser Beck?"

>w
Galaxy Jones is in the elevator car. It's luxurious, with gold-plated walls and crystal lighting on the ceiling. The button panel is lacquered dark mahogany with what look like real ivory buttons. The carpeting is soft and plush. A golden keyhole sits above the buttons. You can leave the elevator to the east.

One of the ceiling panels looks loose.

Admiral Thallium's voice oozes from concealed speakers: "Yes, Jones, that is real ivory. I imported the elephant here myself for a hunt on my estate. You have no idea how much money it takes to simulate an African jungle on Mars. In retrospect I should have gotten an Indian elephant."

>shoot car
Jones's disruptor does nothing. Looks like Thallium was telling the truth.

>restart
Are you sure you want to restart?

* * *

>shoot car
Jones should focus on disabling the robot.

>shoot elevator
Which do you mean, the elevator car door, the elevator control panel, or the tenth floor elevator hall?

>car
Jones should focus on disabling the robot.

>e
Galaxy Jones is in the tenth floor elevator hall. The elevator car to the west stands open. There is a stairwell to the east. The hall runs north and south into a sumptuous corporate office.

>shoot elevator
(the elevator car)

>actions
Actions listing on.

>shoot elevator
(the elevator car)
[shooting the elevator car with the disruptor pistol]
[shooting the elevator car with the disruptor pistol - succeeded]

>n
[going north]

Galaxy Jones is on the north side of the Consolidated Microthings office. This is the company cafeteria. The elevator is south, the air handling room is to the east, and the office continues to the west and southeast.

[going north - succeeded]

>shoot cafeteria
[shooting the cafeteria with the disruptor pistol]
Jones should focus on disabling the robot.
[shooting the cafeteria with the disruptor pistol - failed the Check shooting something with something when the location is in the tenth-floor-region or the location is the top of the elevator car]

>s
[going south]

Galaxy Jones is in the tenth floor elevator hall. The elevator car to the west stands open. There is a stairwell to the east. The hall runs north and south into a sumptuous corporate office.

[going south - succeeded]

Thallium's voice booms over the office PA: "You can run, Jones, but you can't - well, there aren't very many places you can hide."

>scope
1: Jones (1148966)
2: a stairwell (1152134)
3: a black jumpsuit (1148998)
4: a suit light (1148582)
5: a disruptor pistol (1149030)
6: an elevator car (1152198)
7: a golden keyhole (1152230)
8: a ceiling panel (1152262)
9: an elevator car door (1152294)
10: a walls (1152326)
11: a crystal lighting (1152358)
12: an elevator control panel (1152390)
13: an ivory buttons (1152422)
14: a carpeting (1152454)
15: the south side of the Consolidated Microthings office (1152518)
16: Reception (1152550)
17: a couches (1152582)
18: a New Reykjavik Botanic Dome (1152614)
19: the north side of the Consolidated Microthings office (1152934)
20: outside (1154630)
21: an air handling door (1153094)
22: a cafeteria (1152966)
23: a food (1156422)
24: Beck (1148518)

>showme tenth-floor-region
(the stairwell)
stairwell - thing
location: in the tenth floor elevator hall
singular-named, improper-named, unused; unlit, inedible, fixed in place, scenery, neuter, seen, familiar, non-pourable, dull
list grouping key: none
printed name: "stairwell"
printed plural name: none
indefinite article: none
most recent reference: nominal
third singular pronoun: It-pronoun
conversation: none
description: "They lead up and down from here."
initial appearance: none
third-plural-pronoun: They-pronoun

>rules
Rules tracing now switched on. Type "rules off" to switch it off again, or "rules all" to include even rules which do not apply.

[Rule "reset conversed this turn rule" applies.]
[Rule "clear LPR rule" applies.]

* * *

>s
Galaxy Jones is at the southeast corner of the Consolidated Microthings office. This corner of the floor contains the gym and other company amenities. Reception is to the west, and an empty area lies to the north.

Jones sees the mauve guard robot a couple of steps to the west.

>kiss robot
Jones can't reach the mauve guard robot.

A couple of steps to the west, the mauve guard robot heads east.

>kiss robot
Jones can't reach the mauve guard robot.

The mauve guard robot approaches from the west.

Jones doesn't stand a chance against the mauve guard robot's terrible knives.

    *** Jones was killed by the mauve guard robot ***

In that game you scored 0 out of a possible 10, in 10 turns.

Would you like to RESTART, RESTORE a saved game, QUIT, or UNDO the last command?

* * *

>gonear rooftop
(the rooftop)

*** Run-time problem P61: Attempt to move the player off-stage.

* * *

>gonear cybernetica
(the Cybernetica office)
Galaxy Jones is in the Cybernetica office. It's spacious and luxurious, designed to make developers forget how spent they are from months of overwork and abuse. Ergonomic desks and chairs fill space like a furniture fractal, before giving way to an open area, presumably for group activities.

As soon as Jones steps into the office, a shot zaps just past her nose. She dives to the ground, protected by the maze of desks and chairs. Peeking through the mesh back of one of the chairs, she takes notice of both the purple guard robot training its disruptor on the room, and the chair's fine construction and lumbar support.

Jones (whispering): "We've got another one! I'm out of sight for now, but it's going to be hard to get a shot off at this 'bot."

Beck: "What's the situation?"

Jones: "I'm on the floor with desks and chairs all around. The target is a few yards off, coming this way. I can get a shot in, but it might just absorb it anyway."

Beck: "Well, see if you can sneak up on it. Maybe close up you can find a way past its defenses."

>kiss robot
Fine way for Jones to get herself killed.

* * *

>shoot desk
Focus on the robot instead.

>shoot robot
Jones raises her head and fires wide. The robot fires back. Jones ducks and crawls off among the labyrinth of desks.

Beck: "Are you still shooting at those things? Even if you hit 'em it's not going to leave a scratch."

Jones (whispering): "So what do you propose?"

Beck: "Get closer. Keep your head down, but move in closer to it until you can get a good shot in."

* * *

>gonear ledge
Galaxy Jones is on a ledge. The ledge runs north and south. Jones is plastered up against the wall, trying not to look down.

>n
The wall juts out and blocks Jones's progress.

>s
The wall juts out and blocks Jones's progress.

* * *

>gonear ninth
Which do you mean, the ninth floor elevator shaft, the ninth floor stairwell, the ninth floor north hallway, the ninth floor south hallway, the ninth floor elevator door, or the ninth floor elevator hall?

>hall
Galaxy Jones is in the ninth floor elevator hall. The elevator is to the west, the stairwell is to the east, and a corridor leads north and south. There is a bottled water vending machine here.

>s
Galaxy Jones is in the ninth floor south hallway. This anonymous corporate hallway ends here at the south end of the building. An open doorway leads west. To the east is a door with a swipe lock, labeled "Martian Chemical."

>w
Galaxy Jones is at the south end of the building management office. The building management office is a bunch of desks and task boards. There is a filing cabinet against the east wall. The office exit is to the east, and the office continues to the north.

A screwdriver sits atop the filing cabinet.

>x task
The board says "Jones is coming, surprise day off!". A black marker with an eraser at the end is tied to the board.

>take marker
That seems to be a part of the task board.

>take eraser
That seems to be a part of the task board's black marker.

>write on board
You must say what you want Jones to write.

>write fooooooo on board
Now the board says "Jones is coming, surprise day off! fooooooo on board".

>write fooooo
Now the board says "Jones is coming, surprise day off! fooooooo on board fooooo".

>erase board
Now the board is blank.

>purloin pin
[Purloined.]

>e
Galaxy Jones is in the ninth floor south hallway. This anonymous corporate hallway ends here at the south end of the building. An open doorway leads west. To the east is a door with a swipe lock, labeled "Martian Chemical."

>open door with pin
Jones is unable to unlock the Martian Chemical door with the safety pin.

>open door with pistol
Jones is unable to unlock the Martian Chemical door with the disruptor pistol.

>gonear cybernetica
(the Cybernetica office)
Galaxy Jones is in the Cybernetica office. It's spacious and luxurious, designed to make developers forget how spent they are from months of overwork and abuse. Ergonomic desks and chairs fill space like a furniture fractal, before giving way to an open area, presumably for group activities.

As soon as Jones steps into the office, a shot zaps just past her nose. She dives to the ground, protected by the maze of desks and chairs. Peeking through the mesh back of one of the chairs, she takes notice of both the purple guard robot training its disruptor on the room, and the chair's fine construction and lumbar support.

Jones (whispering): "We've got another one! I'm out of sight for now, but it's going to be hard to get a shot off at this 'bot."

Beck: "What's the situation?"

Jones: "I'm on the floor with desks and chairs all around. The target is a few yards off, coming this way. I can get a shot in, but it might just absorb it anyway."

Beck: "Well, see if you can sneak up on it. Maybe close up you can find a way past its defenses."

>l
Galaxy Jones is in the Cybernetica office. It's spacious and luxurious, designed to make developers forget how spent they are from months of overwork and abuse. Ergonomic desks and chairs fill space like a furniture fractal, before giving way to an open area, presumably for group activities. There is a menacing purple guard robot here, looking for Jones.

>sneak
(toward the purple guard robot)
Jones creeps a little ways toward the guard robot.

>g
(toward the purple guard robot)
Slowly, slowly, Jones gets a little closer. Just a little more...

She must have poked up her shoulder or something, for the guard robot fires his disruptor. The shot takes out a window on the east side of the room. The electrostatic field around the building keeps the atmosphere from pouring out.

>g
(toward the purple guard robot)
Jones is right up next to the robot, crouched beneath a desk. She can see right up under its armor.

>shoot robot
Jones aims the pistol upward under the robot's enhanced armor and fires. She flinches back when the robot's innards explode downward in a shower of sparks. It topples over, dead. Jones stands up and surveys her handiwork.

 _________      __                     _____                     
 __/ ____/___ _/ /___ __  ____  __     __/ /___  ____  ___  _____
 _/ / __/ __ `/ / __ `/ |/ / / / /____ _/ / __ \/ __ \/ _ \/ ___/
 / /_/ / /_/ / / /_/ />  </ /_/ / _/ /_/ / /_/ / / / /  __(__  ) 
 \____/\__,_/_/\__,_/_/|_|\__, /  _\____/\____/_/ /_/\___/____/  
 _____________________________/ 

[Your score has just gone up by one point.]

Jones: "Better than a video game. "

Beck: "Nice, but don't forget to credit your handler."

Jones: "Yes, yes, thanks for helping me not get killed."

Beck: "You're welcome."

>l
Galaxy Jones is in the Cybernetica office. It's spacious and luxurious, designed to make developers forget how spent they are from months of overwork and abuse. Ergonomic desks and chairs fill space like a furniture fractal, before giving way to an open area, presumably for group activities. One of the windows along the east side of the office is broken.

The remains of the purple guard robot are sprawled on the ground.

* * *

>gonear tenth hall
Galaxy Jones is in the tenth floor elevator hall. The elevator car to the west stands open. There is a stairwell to the east. The hall runs north and south into a sumptuous corporate office.

>shoot elevator
(the elevator car)
Jones should focus on disabling the robot.

>rules
Rules tracing now switched on. Type "rules off" to switch it off again, or "rules all" to include even rules which do not apply.

[Rule "reset conversed this turn rule" applies.]
[Rule "clear LPR rule" applies.]

>shoot elevator
[Rule "After deciding the scope of the player" applies.]
[Rule "After deciding the scope of the player" applies.]
[Rule "After deciding the scope of the player" applies.]
(the elevator car)
[Rule "declare everything initially unmentioned rule" applies.]
[Rule "Rule for supplying a missing second noun while shooting" applies.]
[Rule "After deciding the scope of the player" applies.]
[Rule "After deciding the scope of the player" applies.]
[Rule "After deciding the scope of the player" applies.]
[Rule "assign alternative door targets rule" applies.]
[Rule "announce items from multiple object lists rule" applies.]
[Rule "set pronouns from items from multiple object lists rule" applies.]
[Rule "before stage rule" applies.]
[Rule "Before doing something other than going" applies.]
[Rule "keychain-aware carrying requirements rule" applies.]
[Rule "instead stage rule" applies.]
[Rule "investigate player's awareness before action rule" applies.]
[Rule "player aware of his own actions rule" applies.]
[Rule "check stage rule" applies.]
[Rule "carry out stage rule" applies.]
[Rule "after stage rule" applies.]
[Rule "investigate player's awareness after action rule" applies.]
[Rule "report stage rule" applies.]
[Rule "last specific action-processing rule" applies.]
[Rule "A first turn sequence rule" applies.]
[Rule "every turn stage rule" applies.]
[Rule "Every turn when the mauve guard robot is in the tenth-floor-region and the mauve guard robot is not under attack" applies.]
[Rule "reset protocol rule" applies.]
[Rule "Every turn" applies.]
[Rule "A last turn sequence rule" applies.]
[Rule "notify score changes rule" applies.]
[Rule "show us the people rule" applies.]
[Rule "reset conversed this turn rule" applies.]
[Rule "clear LPR rule" applies.]

>actions
[Rule "declare everything initially unmentioned rule" applies.]
[Rule "assign alternative door targets rule" applies.]
Actions listing on.

[Rule "reset conversed this turn rule" applies.]
[Rule "clear LPR rule" applies.]

>shoot elevator
[Rule "After deciding the scope of the player" applies.]
[Rule "After deciding the scope of the player" applies.]
[Rule "After deciding the scope of the player" applies.]
(the elevator car)
[Rule "declare everything initially unmentioned rule" applies.]
[Rule "Rule for supplying a missing second noun while shooting" applies.]
[Rule "After deciding the scope of the player" applies.]
[Rule "After deciding the scope of the player" applies.]
[Rule "After deciding the scope of the player" applies.]
[Rule "assign alternative door targets rule" applies.]
[shooting the elevator car with the disruptor pistol]
[Rule "announce items from multiple object lists rule" applies.]
[Rule "set pronouns from items from multiple object lists rule" applies.]
[Rule "before stage rule" applies.]
[Rule "Before doing something other than going" applies.]
[Rule "keychain-aware carrying requirements rule" applies.]
[Rule "instead stage rule" applies.]
[Rule "investigate player's awareness before action rule" applies.]
[Rule "player aware of his own actions rule" applies.]
[Rule "check stage rule" applies.]
[Rule "carry out stage rule" applies.]
[Rule "after stage rule" applies.]
[Rule "investigate player's awareness after action rule" applies.]
[Rule "report stage rule" applies.]
[Rule "last specific action-processing rule" applies.]
[shooting the elevator car with the disruptor pistol - succeeded]

[Rule "A first turn sequence rule" applies.]
[Rule "every turn stage rule" applies.]
[Rule "Every turn when the mauve guard robot is in the tenth-floor-region and the mauve guard robot is not under attack" applies.]
[Rule "reset protocol rule" applies.]
[Rule "Every turn" applies.]
[Rule "A last turn sequence rule" applies.]
[Rule "notify score changes rule" applies.]
[Rule "show us the people rule" applies.]
[Rule "reset conversed this turn rule" applies.]
[Rule "clear LPR rule" applies.]

* * *

>gonear top of the elevator car
Galaxy Jones is on the top of the elevator car. The elevator shaft extends many hundreds of feet above her. She can see down into the elevator car from here.

>ask for help
Beck: "Before we begin, save your game. This could get ugly."

>ask for help
Beck: "There are multiple ways to get past this floor. Here's one."

>ask for help
Beck: "Go west from the air handling room, south once, and west into the elevator car."

>ask for help
Beck: "You'll notice a loose ceiling panel. Open it."

>ask for help
Beck: "Now lure the robot in the southwest corner to the elevator car."

>ask for help
Beck: "Leave the elevator to the east, go south to catch the robot's eye, then go north and west back into the elevator car. Then go up onto the top of the car."

>ask for help
Beck: "The robot will enter the car but not see you. Now's your chance!"

>ask for help
Beck: "No, shooting won't work."

>ask for help
Beck: "When the robot leaves you'll have to lure it back again."

>ask for help
Beck: "Maybe pour something on the robot?"

>ask for help
Beck: "No, don't waste your water. What else is pourable?"

>ask for help
Beck: "Yes, the polymer gel! But you can't get close enough to pour it on the robot."

>ask for help
Beck: "Jump on the robot!"

>ask for help
Beck: "Then pour the gel on the robot."

>ask for help
Beck: "Then pour the gel on the robot."

>d
Galaxy Jones is in the elevator car. It's luxurious, with gold-plated walls and crystal lighting on the ceiling. The button panel is lacquered dark mahogany with what look like real ivory buttons. The carpeting is soft and plush. A golden keyhole sits above the buttons. You can leave the elevator to the east.

One of the ceiling panels looks loose.

Admiral Thallium's voice oozes from concealed speakers: "Yes, Jones, that is real ivory. I imported the elephant here myself for a hunt on my estate. You have no idea how much money it takes to simulate an African jungle on Mars. In retrospect I should have gotten an Indian elephant."

>open panel
(the ceiling panel)
Jones removes the ceiling panel, exposing a hole wide enough for her to squeeze through.

>e
Galaxy Jones is in the tenth floor elevator hall. The elevator car to the west stands open. There is a stairwell to the east. The hall runs north and south into a sumptuous corporate office.

Thallium's voice booms over the office PA: "You can run, Jones, but you can't - well, there aren't very many places you can hide."

>s
Galaxy Jones is on the south side of the Consolidated Microthings office. This is reception. The front desk has a great view of the New Reykjavik Botanic Dome. Couches are lined up to take advantage. The floor extends east and west, and north to the elevator.

Thallium: "Jones, you still hanging around with that loser Beck?"

Jones sees the mauve guard robot nearby to the west.

>n
Galaxy Jones is in the tenth floor elevator hall. The elevator car to the west stands open. There is a stairwell to the east. The hall runs north and south into a sumptuous corporate office.

The mauve guard robot appears nearby to the south, coming from the west.

>w
Galaxy Jones is in the elevator car. It's luxurious, with gold-plated walls and crystal lighting on the ceiling. The button panel is lacquered dark mahogany with what look like real ivory buttons. The carpeting is soft and plush. A golden keyhole sits above the buttons. There is a hole in the ceiling big enough for Jones to squeeze through. You can leave the elevator to the east.

The mauve guard robot appears nearby to the east, coming from the south.

Beck: "I've seen more intimidating kitchen appliances!"

>u
Galaxy Jones is on the top of the elevator car. The elevator shaft extends many hundreds of feet above her. She can see down into the elevator car from here.

The mauve guard robot enters the elevator car below.

>shoot vent
Jones only uses violent means when absolutely necessary.

>hit vent
Jones only uses violent means when absolutely necessary.

The mauve guard robot exits the elevator car, out of sight.

* * *

>gonear top of the elevator car
Galaxy Jones is on the top of the elevator car. The elevator shaft extends many hundreds of feet above her. She can see down into the elevator car from here.

>d
Galaxy Jones is in the elevator car. It's luxurious, with gold-plated walls and crystal lighting on the ceiling. The button panel is lacquered dark mahogany with what look like real ivory buttons. The carpeting is soft and plush. A golden keyhole sits above the buttons. You can leave the elevator to the east.

One of the ceiling panels looks loose.

Admiral Thallium's voice oozes from concealed speakers: "Yes, Jones, that is real ivory. I imported the elephant here myself for a hunt on my estate. You have no idea how much money it takes to simulate an African jungle on Mars. In retrospect I should have gotten an Indian elephant."

* * *

>open panel
(the ceiling panel)
Jones removes the ceiling panel, exposing a hole wide enough for her to squeeze through.

>e
Galaxy Jones is in the tenth floor elevator hall. The elevator car to the west stands open. There is a stairwell to the east. The hall runs north and south into a sumptuous corporate office.

>s
Galaxy Jones is on the south side of the Consolidated Microthings office. This is reception. The front desk has a great view of the New Reykjavik Botanic Dome. Couches are lined up to take advantage. The floor extends east and west, and north to the elevator.

Beck: "You're programmed to kill, but Jones is programmed to kick your metallic ass!"

Jones: "Ah, the bravery of being out of range."

Jones sees the mauve guard robot nearby to the west.

>n
Galaxy Jones is in the tenth floor elevator hall. The elevator car to the west stands open. There is a stairwell to the east. The hall runs north and south into a sumptuous corporate office.

The mauve guard robot appears nearby to the south, coming from the west.

* * *

>u
Galaxy Jones is on the top of the elevator car. The elevator shaft extends many hundreds of feet above her. She can see down into the elevator car from here.

The mauve guard robot enters the elevator car below.

>shoot vent
From the top, even from this range, Jones's shot is entirely ineffective. The robot swivels its head to find her, and she barely jumps back out of sight.

>shoot shaft
Jones should focus on disabling the robot.

The mauve guard robot exits the elevator car, out of sight.

>z
Jones stands around and waits.

>d
Galaxy Jones is in the elevator car. It's luxurious, with gold-plated walls and crystal lighting on the ceiling. The button panel is lacquered dark mahogany with what look like real ivory buttons. The carpeting is soft and plush. A golden keyhole sits above the buttons. There is a hole in the ceiling big enough for Jones to squeeze through. You can leave the elevator to the east.

>shoot car
Jones should focus on disabling the robot.

>shoot button
Jones should focus on disabling the robot.

>out
Galaxy Jones is in the tenth floor elevator hall. The elevator car to the west stands open. There is a stairwell to the east. The hall runs north and south into a sumptuous corporate office.

>shoot car
(the elevator car)

>shoot stairwell
Jones should focus on disabling the robot.

>shoot hall
There's nothing like that nearby.

>shoot office
There's nothing like that nearby.

>s
Galaxy Jones is on the south side of the Consolidated Microthings office. This is reception. The front desk has a great view of the New Reykjavik Botanic Dome. Couches are lined up to take advantage. The floor extends east and west, and north to the elevator.

Thallium's voice booms over the office PA: "You can run, Jones, but you can't - well, there aren't very many places you can hide."

Jones sees the mauve guard robot nearby to the west.

>n
Galaxy Jones is in the tenth floor elevator hall. The elevator car to the west stands open. There is a stairwell to the east. The hall runs north and south into a sumptuous corporate office.

The mauve guard robot appears nearby to the south, coming from the west.

* * *

>u
Galaxy Jones is on the top of the elevator car. The elevator shaft extends many hundreds of feet above her. She can see down into the elevator car from here.

The mauve guard robot enters the elevator car below.

>shoot robot
From the top, even from this range, Jones's shot is entirely ineffective. The robot swivels its head to find her, and she barely jumps back out of sight.

>shoow jones
I didn't understand that sentence.

>attack robot
Jones can't reach the mauve guard robot.

The mauve guard robot exits the elevator car, out of sight.

>attack shaft
Jones should focus on disabling the robot.

>shoot shaft
Jones should focus on disabling the robot.

>z
Jones stands around and waits.

* * *

>d
Galaxy Jones is in the elevator car. It's luxurious, with gold-plated walls and crystal lighting on the ceiling. The button panel is lacquered dark mahogany with what look like real ivory buttons. The carpeting is soft and plush. A golden keyhole sits above the buttons. There is a hole in the ceiling big enough for Jones to squeeze through. You can leave the elevator to the east.

>e
Galaxy Jones is in the tenth floor elevator hall. The elevator car to the west stands open. There is a stairwell to the east. The hall runs north and south into a sumptuous corporate office.

* * *

>n
Galaxy Jones is on the north side of the Consolidated Microthings office. This is the company cafeteria. The elevator is south, the air handling room is to the east, and the office continues to the west and southeast.

>e
(first opening the air handling door)

Galaxy Jones is in the air handling room. There is a good number of loud fans and other air handling machinery here. A small hinged vent opening leads into some ductwork, and from there to the outside. A door leads west.

>w
Galaxy Jones is on the north side of the Consolidated Microthings office. This is the company cafeteria. The elevator is south, the air handling room is to the east, and the office continues to the west and southeast.

Thallium: "Jones, you still hanging around with that loser Beck?"

>se
Galaxy Jones is on the east side of the Consolidated Microthings office. This part of the office is currently unused. Jones can go northwest or south from here.

>s
Galaxy Jones is at the southeast corner of the Consolidated Microthings office. This corner of the floor contains the gym and other company amenities. Reception is to the west, and an empty area lies to the north.

Beck: "I hope you have a warranty, because you're about to be seriously damaged!"

Jones: "Really, Beck? Is this your best material?"

Jones sees the mauve guard robot a couple of steps to the west.

>shoot robot
The shot is absorbed by the mauve robot.

A couple of steps to the west, the mauve guard robot heads east.

>undo
Galaxy Jones is at the southeast corner of the Consolidated Microthings office.
[Previous turn undone.]

>shoot gym
Focus on the robot instead.

A couple of steps to the west, the mauve guard robot heads east.

Thallium: "Don't you just hate it, Jones -- not knowing when death will just jump out at you?"

>n
Galaxy Jones is on the east side of the Consolidated Microthings office. This part of the office is currently unused. Jones can go northwest or south from here.

The mauve guard robot appears nearby to the south, coming from the west.

* * *

>w
Galaxy Jones is on the north side of the Consolidated Microthings office. This is the company cafeteria. The elevator is south, the air handling room is to the east, and the office continues to the west and southeast.

>undo
Galaxy Jones is in the air handling room.
[Previous turn undone.]

>undo
Galaxy Jones is in the air handling room.
[Previous turn undone.]

>w
Galaxy Jones is on the north side of the Consolidated Microthings office. This is the company cafeteria. The elevator is south, the air handling room is to the east, and the office continues to the west and southeast.

A couple of steps to the south, the mauve guard robot heads north.

>e
Galaxy Jones is in the air handling room. There is a good number of loud fans and other air handling machinery here. A small hinged vent opening leads into some ductwork, and from there to the outside. A door leads west.

* * *

>z
Jones stands around and waits.

>w
Galaxy Jones is on the north side of the Consolidated Microthings office. This is the company cafeteria. The elevator is south, the air handling room is to the east, and the office continues to the west and southeast.

A couple of steps to the south, the mauve guard robot heads north.

Thallium: "I bet you're just dying to meet Europa, right, Jones?"

>e
Galaxy Jones is in the air handling room. There is a good number of loud fans and other air handling machinery here. A small hinged vent opening leads into some ductwork, and from there to the outside. A door leads west.

>w
Galaxy Jones is on the north side of the Consolidated Microthings office. This is the company cafeteria. The elevator is south, the air handling room is to the east, and the office continues to the west and southeast.

The robot electrocutes Jones with its electro-darts.

    *** Jones was killed by the mauve guard robot ***

In that game you scored 0 out of a possible 10, in 53 turns.

Would you like to RESTART, RESTORE a saved game, QUIT, or UNDO the last command?

>undo
Galaxy Jones is in the air handling room.
[Previous turn undone.]

* * *

>kiss beck
I didn't understand that sentence.

>kiss speeder
I didn't understand that sentence.

* * *

>kiss speeder
You can only do that to something animate.

>kiss beck
Beck is just a voice in Jones's ear.

>n
Jones approaches the Viking Building entryway, the dramatic façade towering over her.

Galaxy Jones is at the entry doorway. A glass revolving door leads into a large open space north of here. The speeder dock is to the south.

Jones looks up at the 100 stories of glass and steel. "What do you want to bet Thallium's got Europa all the way at the top?"

Beck: "Oh, no doubt."

* * *

>n
Suddenly two robot guards, green and red, emerge from niches in the back wall! Jones dives behind the front desk and draws her disruptor pistol.

Jones shouts, "I'm under fire from two ugly robot things!"

Beck responds, "Monitoring your suit radar."

>kiss robot
As soon as Jones starts to act, an energy beam zips past her head, forcing her back down behind the desk.

One of the robots fires directly above her head.

>shoot art
Jones fires the disruptor into the sculpture's main support cable, snapping it. The huge crystal blob starts to sag, straining the other cables. In quick succession they break as well, and the whole installation plummets to the ground, right on top of the hapless guard robots.
 _________      __                     _____                     
 __/ ____/___ _/ /___ __  ____  __     __/ /___  ____  ___  _____
 _/ / __/ __ `/ / __ `/ |/ / / / /____ _/ / __ \/ __ \/ _ \/ ___/
 / /_/ / /_/ / / /_/ />  </ /_/ / _/ /_/ / /_/ / / / /  __(__  ) 
 \____/\__,_/_/\__,_/_/|_|\__, /  _\____/\____/_/ /_/\___/____/  
 _____________________________/ 

[Your score has just gone up by one point.]

Beck: "What was that crash? What's going on?"

Jones: "That, my friend, was what you'd call a work of art. Targets terminated."

>gonear vending machine
Galaxy Jones is in the ninth floor elevator hall. The elevator is to the west, the stairwell is to the east, and a corridor leads north and south. There is a bottled water vending machine here.

>n
Galaxy Jones is in the ninth floor north hallway. This anonymous corporate hallway ends here at the north end of the building. An open doorway leads west. To the east is a door with a swipe lock, labeled "Cybernetica Inc."

>gonear cybernetica
(the Cybernetica door)
Galaxy Jones is in the ninth floor north hallway. This anonymous corporate hallway ends here at the north end of the building. An open doorway leads west. To the east is a door with a swipe lock, labeled "Cybernetica Inc."

>gonear purple robot
(the purple guard robot)

*** Run-time problem P61: Attempt to move the player off-stage.

* * *

>l
Suddenly two robot guards, green and red, emerge from niches in the back wall! Jones dives behind the front desk and draws her disruptor pistol.

Jones shouts, "I'm under fire from two ugly robot things!"

Beck responds, "Monitoring your suit radar."

>l
Galaxy Jones is in the lobby. Near the entryway is a front desk. A giant crystal sculpture floats above the center of the area, suspended on almost invisible cables. Jones may go east and west from here, north to the elevators, or south out of the building. There are two niches in the central wall from which the guard robots emerged.

Two guard robots prowl the lobby, trying to outflank her.

Beck: "Robot on your right!"

One robot tries to flank her, but a shot from her disruptor sends it scurrying back.

>shoot sculpture
Jones fires the disruptor into the sculpture's main support cable, snapping it. The huge crystal blob starts to sag, straining the other cables. In quick succession they break as well, and the whole installation plummets to the ground, right on top of the hapless guard robots.
 _________      __                     _____                     
 __/ ____/___ _/ /___ __  ____  __     __/ /___  ____  ___  _____
 _/ / __/ __ `/ / __ `/ |/ / / / /____ _/ / __ \/ __ \/ _ \/ ___/
 / /_/ / /_/ / / /_/ />  </ /_/ / _/ /_/ / /_/ / / / /  __(__  ) 
 \____/\__,_/_/\__,_/_/|_|\__, /  _\____/\____/_/ /_/\___/____/  
 _____________________________/ 

[Your score has just gone up by one point.]

Beck: "What was that crash? What's going on?"

Jones: "That, my friend, was what you'd call a work of art. Targets terminated."

>l
Galaxy Jones is in the lobby. Near the entryway is a front desk. Jones may go east and west from here, north to the elevators, or south out of the building. There are two niches in the central wall from which the guard robots emerged.

Spread across the floor in a tangled ruin are the remains of a giant crystal sculpture and two guard robots.

>x niches
Aside from a robot charging station, there's nothing here.

>x station
The charging station is a socket fitted in a depression contoured to fit one of those robots.

>x charging stations
The charging station is a socket fitted in a depression contoured to fit one of those robots.

>take station
Jones can't take that.

>x depresssion
There's nothing like that nearby.

>x depression
There's nothing like that nearby.

* * *

>n
Suddenly two robot guards, green and red, emerge from niches in the back wall! Jones dives behind the front desk and draws her disruptor pistol.

Jones shouts, "I'm under fire from two ugly robot things!"

Beck responds, "Monitoring your suit radar."

>shoot desk
Focus on the robots instead.

A robot fires a blistering shot into the front desk.

>shoot couch
Focus on the robots instead.

A robot fires a blistering shot into the front desk.

>shoot couch
Focus on the robots instead.

Beck: "Robot on your right!"

One robot tries to flank Jones, but a shot from her disruptor sends it scurrying back.

>shoot robot
A barrage of fire from the robots prevents Jones from firing.

>shoot robot
Oof. Big miss.

One of the robots fires directly above Jones's head.

Jones: "I could use some ideas here!"

* * *

>shoot cable
There's nothing like that nearby.

>shoot cables
Suddenly two robot guards, green and red, emerge from niches in the back wall! Jones dives behind the front desk and draws her disruptor pistol.

Jones shouts, "I'm under fire from two ugly robot things!"

Beck responds, "Monitoring your suit radar."

>shoot cable
There's nothing like that nearby.

>shoot cables
Jones fires the disruptor into the sculpture's main support cable, snapping it. The huge crystal blob starts to sag, straining the other cables. In quick succession they break as well, and the whole installation plummets to the ground, right on top of the hapless guard robots.
 _________      __                     _____                     
 __/ ____/___ _/ /___ __  ____  __     __/ /___  ____  ___  _____
 _/ / __/ __ `/ / __ `/ |/ / / / /____ _/ / __ \/ __ \/ _ \/ ___/
 / /_/ / /_/ / / /_/ />  </ /_/ / _/ /_/ / /_/ / / / /  __(__  ) 
 \____/\__,_/_/\__,_/_/|_|\__, /  _\____/\____/_/ /_/\___/____/  
 _____________________________/ 

[Your score has just gone up by one point.]

Beck: "What was that crash? What's going on?"

Jones: "That, my friend, was what you'd call a work of art. Targets terminated."

>undo
Galaxy Jones is in the lobby.
[Previous turn undone.]

>shoot desk
Focus on the robots instead.

A robot fires a blistering shot into the front desk.

>shoot robot
Jones's shot hits a robot dead on, but nothing happens, almost as if the robot had absorbed the energy.

Jones: "Target seems to be absorbing disruptor fire. This will make things a little harder."

Beck: "Got it."

The two robots coordinate fire over the desk, narrowly missing her.

>shoot sculpture
Jones fires the disruptor into the sculpture's main support cable, snapping it. The huge crystal blob starts to sag, straining the other cables. In quick succession they break as well, and the whole installation plummets to the ground, right on top of the hapless guard robots.
 _________      __                     _____                     
 __/ ____/___ _/ /___ __  ____  __     __/ /___  ____  ___  _____
 _/ / __/ __ `/ / __ `/ |/ / / / /____ _/ / __ \/ __ \/ _ \/ ___/
 / /_/ / /_/ / / /_/ />  </ /_/ / _/ /_/ / /_/ / / / /  __(__  ) 
 \____/\__,_/_/\__,_/_/|_|\__, /  _\____/\____/_/ /_/\___/____/  
 _____________________________/ 

[Your score has just gone up by one point.]

Beck: "What was that crash? What's going on?"

Jones: "That, my friend, was what you'd call a work of art. Targets terminated."

>unfo
I didn't understand that sentence.

>undo
Galaxy Jones is in the lobby.
[Previous turn undone.]

>shoot robot
Jones only uses violent means when absolutely necessary.

>shoot
What should Jones shoot?

I beg your pardon?

>restart
Are you sure you want to restart?

* * *

>z
Suddenly two robot guards, green and red, emerge from niches in the back wall! Jones dives behind the front desk and draws her disruptor pistol.

Jones shouts, "I'm under fire from two ugly robot things!"

Beck responds, "Monitoring your suit radar."

>shoot robot
Oops! Jones misses.

Jones: "I could use some ideas here!"

>shoot robots
A barrage of fire from the robots prevents Jones from firing.

>shoot green robot
Oof. Big miss.

Beck: "How's it going in there?"

"Jones: "You know -- like all art, it's hit or miss."

>shoot green robot
Oops! Jones misses.

>shoot green robot
Jones sticks her head out from behind the desk and squeezes off a shot at the red and green guard robots. In her haste it goes wide of the target.

Zip! Disruptor fire scorches a nearby couch.

>shoot green robot
Oof. Big miss.

>shoot green robot
A barrage of fire from the robots prevents Jones from firing.

The robots intone "Destroy Jones" in an eerie drone.

>shoot green robot
Oof. Big miss.

>shoot green robot
A barrage of fire from the robots prevents Jones from firing.

A robot fires a blistering shot into the front desk.

>shoot green robot
Oof. Big miss.

The two robots coordinate fire over the desk, narrowly missing Jones.

>shoot green robot
Jones's shot hits a robot dead on, but nothing happens, almost as if the robot had absorbed the energy.

Jones: "Target seems to be absorbing disruptor fire. This will make things a little harder."

Beck: "Got it."

One of the robots fires directly above her head.

>l
Galaxy Jones is in the lobby. The ground floor of the Viking Building is breathtaking. Low-G architecture means more glass and thinner supports, and the building takes advantage of that. Four walls of glass surround a central pillar in which are set the utility rooms and elevators. In between is an expanse of plants, water features, and stylish seating. Near the entryway is a front desk. A giant crystal sculpture floats above the center of the area, suspended on almost invisible cables. Jones may go east and west from here, north to the elevators, or south out of the building. There are two niches in the central wall from which the guard robots emerged.

Two guard robots, red and green, criss-cross the lobby, stalking her.

The robots intone "Destroy Jones" in an eerie drone.

>shoot sculpture
Jones fires the disruptor into the sculpture's main support cable, snapping it. The huge crystal blob starts to sag, straining the other cables. In quick succession they break as well, and the whole installation plummets to the ground, right on top of the hapless guard robots.
 _________      __                     _____                     
 __/ ____/___ _/ /___ __  ____  __     __/ /___  ____  ___  _____
 _/ / __/ __ `/ / __ `/ |/ / / / /____ _/ / __ \/ __ \/ _ \/ ___/
 / /_/ / /_/ / / /_/ />  </ /_/ / _/ /_/ / /_/ / / / /  __(__  ) 
 \____/\__,_/_/\__,_/_/|_|\__, /  _\____/\____/_/ /_/\___/____/  
 _____________________________/ 

[Your score has just gone up by one point.]

Beck: "What was that crash? What's going on?"

Jones: "That, my friend, was what you'd call a work of art. Targets terminated."

>l
Galaxy Jones is in the lobby. The ground floor of the Viking Building is breathtaking. Low-G architecture means more glass and thinner supports, and the building takes advantage of that. Four walls of glass surround a central pillar in which are set the utility rooms and elevators. In between is an expanse of plants, water features, and stylish seating. Near the entryway is a front desk. Jones may go east and west from here, north to the elevators, or south out of the building. There are two niches in the central wall from which the guard robots emerged.

Spread across the floor in a tangled ruin are the remains of a giant crystal sculpture and two guard robots.

* * *

>shoot cables
Focus on the robots instead.

Suddenly two robot guards, green and red, emerge from niches in the back wall! Jones dives behind the front desk and draws her disruptor pistol.

Jones shouts, "I'm under fire from two ugly robot things!"

Beck responds, "Monitoring your suit radar."

>shoot cables
Focus on the robots instead.

The two robots coordinate fire over the desk, narrowly missing Jones.

Jones: "I could use some ideas here!"

>shoot sculpture
Focus on the robots instead.

The robots intone "Destroy Jones" in an eerie drone.

* * *

>x socket
Suddenly two robot guards, green and red, emerge from niches in the back wall! Jones dives behind the front desk and draws her disruptor pistol.

Jones shouts, "I'm under fire from two ugly robot things!"

Beck responds, "Monitoring your suit radar."

>x socket
The charging station is a socket fitted in a depression contoured to fit one of those robots.

>put pistol in socket
As soon as Jones starts to act, an energy beam zips past her head, forcing her back down behind the desk.

Zip! Disruptor fire scorches a nearby couch.

>shoot cable
Jones fires the disruptor into the sculpture's main support cable, snapping it. The huge crystal blob starts to sag, straining the other cables. In quick succession they break as well, and the whole installation plummets to the ground, right on top of the hapless guard robots.
 _________      __                     _____                     
 __/ ____/___ _/ /___ __  ____  __     __/ /___  ____  ___  _____
 _/ / __/ __ `/ / __ `/ |/ / / / /____ _/ / __ \/ __ \/ _ \/ ___/
 / /_/ / /_/ / / /_/ />  </ /_/ / _/ /_/ / /_/ / / / /  __(__  ) 
 \____/\__,_/_/\__,_/_/|_|\__, /  _\____/\____/_/ /_/\___/____/  
 _____________________________/ 

[Your score has just gone up by one point.]

Beck: "What was that crash? What's going on?"

Jones: "That, my friend, was what you'd call a work of art. Targets terminated."

>put pistol in socket
Jones doesn't play with electrical sockets!

* * *

>z
Suddenly two robot guards, green and red, emerge from niches in the back wall! Jones dives behind the front desk and draws her disruptor pistol.

Jones shouts, "I'm under fire from two ugly robot things!"

Beck responds, "Monitoring your suit radar."

>shoot sculpture
Jones fires the disruptor into the sculpture's main support cable, snapping it. The huge crystal blob starts to sag, straining the other cables. In quick succession they break as well, and the whole installation plummets to the ground, right on top of the hapless guard robots.
 _________      __                     _____                     
 __/ ____/___ _/ /___ __  ____  __     __/ /___  ____  ___  _____
 _/ / __/ __ `/ / __ `/ |/ / / / /____ _/ / __ \/ __ \/ _ \/ ___/
 / /_/ / /_/ / / /_/ />  </ /_/ / _/ /_/ / /_/ / / / /  __(__  ) 
 \____/\__,_/_/\__,_/_/|_|\__, /  _\____/\____/_/ /_/\___/____/  
 _____________________________/ 

[Your score has just gone up by one point.]

Beck: "What was that crash? What's going on?"

Jones: "That, my friend, was what you'd call a work of art. Targets terminated."

>w
Jones crosses the floor carefully, disruptor pistol at the ready.

Galaxy Jones is at the southwest corner of the ground floor. A lush indoor waterfall here contrasts with the dusty red streets of New Reykjavik beyond the glass walls. The ground floor extends north and east.

Admiral Thallium's voice booms from the ceiling. "Little Galaxy thinks she's beaten the big bad Admiral. Sorry dear, that was only a taste."

* * *

>n
Galaxy Jones is on the west side of the ground floor. Semicircular couches open on either side of a central carpeted path leading north and south. Set in the central pillar of the building to the east is a utility door. The city looms beyond the glass wall to the west.

>purloin red card
[Purloined.]

>enter door
(first opening the utility door)
It seems to be locked.

>unlock door
(with the red cardkey)
Jones unlocks the utility door.

>enter utility
Which do you mean, the utility rooms or the utility door?

>door
(first opening the utility door)

Galaxy Jones is in the elevator room. This is a utility room related to the operation of the elevator, on the other side of the east wall here. There is a control panel on the wall, and a door leading west.

Hanging from a hook here is a drop key.

Lying discarded on a table here is a hammer.

>undo
Galaxy Jones is on the west side of the ground floor.
[Previous turn undone.]

>enter rooms
That's not something Jones can enter.

>enter utility room
Which do you mean, the utility rooms or the utility door?

>door
(first opening the utility door)

Galaxy Jones is in the elevator room. This is a utility room related to the operation of the elevator, on the other side of the east wall here. There is a control panel on the wall, and a door leading west.

Hanging from a hook here is a drop key.

Lying discarded on a table here is a hammer.

* * *

>undo
Galaxy Jones is on the west side of the ground floor.
[Previous turn undone.]

>enter closet
There's nothing like that nearby.

>enter elevator room
(first opening the utility door)

Galaxy Jones is in the elevator room. This is a utility room related to the operation of the elevator, on the other side of the east wall here. There is a control panel on the wall, and a door leading west.

Hanging from a hook here is a drop key.

Lying discarded on a table here is a hammer.

>exit
Galaxy Jones is on the west side of the ground floor. Semicircular couches open on either side of a central carpeted path leading north and south. Set in the central pillar of the building to the east is a utility door. The city looms beyond the glass wall to the west.

>exit
But Jones isn't in anything at the moment.

* * *

>take speeder
(the speeder)
Stop being silly.

>take bays
Don't be silly.

>take dock
There's nothing like that nearby.

>take speeder dock
There's nothing like that nearby.

>x speeder dock
Galaxy Jones is in the speeder dock. A safe harbor from the periodic dust storms of Utopia Planitia, the dock features several dozen speeder bays. Only a few are filled right now. The building entryway is to the north, under a red stone façade carved into the likeness of a fearsome Viking.

Jones's speeder, Galaxy One, sits in one of the parking bays.

>x entryway
The entryway is dominated by the towering façade of a Viking king, namesake of the building itself.

>take it
Not gonna happen.

>take utopia planitia
There's nothing like that nearby.

>x it
The entryway is dominated by the towering façade of a Viking king, namesake of the building itself.

>x utopia
There's nothing like that nearby.

>x facade
The entryway is dominated by the towering façade of a Viking king, namesake of the building itself.

>n
Jones approaches the Viking Building entryway, the dramatic façade towering over her.

Galaxy Jones is at the entry doorway. A glass revolving door leads into a large open space north of here. The speeder dock is to the south.

Jones looks up at the 100 stories of glass and steel. "What do you want to bet Thallium's got Europa all the way at the top?"

Beck: "Oh, no doubt."

>x glass
The entryway is dominated by the towering façade of a Viking king, namesake of the building itself.

>take beck
Beck is just a voice in Jones's ear.

* * *

>e
The elevator is to the west, and the hall leads into the penthouse to the north and south. A marble staircase leads to the roof.

>d
Is jones going to burrow downward?

>e
The elevator is to the west, and the hall leads into the penthouse to the north and south. A marble staircase leads to the roof.

>u
Jones opens the door and steps through onto the roof. The door crashes shut, and a lock audibly clicks.
 _________      __                     _____                     
 __/ ____/___ _/ /___ __  ____  __     __/ /___  ____  ___  _____
 _/ / __/ __ `/ / __ `/ |/ / / / /____ _/ / __ \/ __ \/ _ \/ ___/
 / /_/ / /_/ / / /_/ />  </ /_/ / _/ /_/ / /_/ / / / /  __(__  ) 
 \____/\__,_/_/\__,_/_/|_|\__, /  _\____/\____/_/ /_/\___/____/  
 _____________________________/ 

[Your score has just gone up by one point.]

Jones walks out onto the luxurious penthouse roof. Admiral Thallium turns from the railing to face her. He is dressed in an absurd elaboration of a Martian Admiral's uniform. He looks Jones up and down with a lecherous leer. "Ah, Galaxy Jones, as lovely as ever. If it weren't so unbearably cliché I'd ask you to join me in my rise to greatness. But alas, you are too habituated to the smug high of 'goodness'." He sighs dramatically. "We've trodden similar ground before; no need to discuss it further. Although I would challenge any of your various amoureux to conjugate 'tread' correctly.

"Anyway, I guess this is the time where you do something predictably undignified and violent. Before you do I feel I should inform you that your sidearm has been rendered quite ineffective by my personal security field. But do go ahead and try it."

Jones sneers. "I wouldn't give you the satisfaction," she says, looking around. "I see you don't have any of your robot pets up here. How are you going to stop me from rescuing Europa?"

"Oh please, while we're trying things, try that too. I wish you luck breaking the silnium bars of the cage."

"What's silnium?"

"A superstrong material invented here in my Martian Chemical laboratory. We had a press conference for it -- weren't you watching?"

"Couldn't be bothered."

"Oh for frotz sake, Jones, you're so frustrating!"

Thallium turns his back on Jones and stares out over the city.

Galaxy Jones is on the penthouse roof. It is an extravagant and opulent space, designed to showcase Thallium's wealth and power. Much of the rooftop is devoted to an outdoor lounge area, with comfortable seating and a fire pit, centered around a hot tub and flanked by a bar. All around is the city of New Reykjavik, and beyond that the red Martian landscape. Around the entirety of the roof is an electrostatic field designed to keep air in and particulates out. To the north is a large cage, and to the west is a landing pad. Jones can distantly see a woman lying on the floor of the cage. A green and black flyer sits on the landing pad.

Admiral Thallium is sulking.

>shoot thallium
(Admiral Thallium)
Jones's disruptor does nothing. Looks like Thallium was telling the truth.

>w
Thallium trails after Jones.

"Um, Jones -- that harlot you're so bent on freeing from captivity is over there. Now get out of the way, I'm trying to escape."

Thallium pushes past Jones. She attempts to grab his shoulder, but she is thrown back by an unseen force.

Thallium smirks. "Personal security field, remember? Now I must be off."

Jones watches as Thallium boards the flyer. It takes off a moment later.

Galaxy Jones is on the flyer pad. This is what one would expect from a rooftop flyer pad: landing lights surrounding a large letter F painted in white on a red background. Europa's cage is to the northeast and the rest of the rooftop is to the east.

>shoot flyer
Jones's disruptor does nothing. Looks like Thallium was telling the truth.

Thallium's flyer hovers over the rooftop. "Jones!"  he bellows. "Play time is over. I grow weary of your intransigence. In a moment this roof will be swarmed by guard robots -- of many different colors -- so many robots you couldn't possibly vandalize them all.  Say your prayers, Jones, or whatever you do when you're about to die."

Jones rolls her eyes.

A little ways off, another flyer, small and red, aims for the rooftop and accelerates.

>shoot flyer
Which do you mean, the red flyer or the green flyer?

>green
Jones's disruptor does nothing. Looks like Thallium was telling the truth.

>x thallium
Hovering above Jones, Thallium's flyer is distinctly menacing. It's not visibly armed, but it conveys the impression of a beast about to strike. It's flying low, the rails of its landing gear just a few feet above Jones's head.

>hook cable to rails
Jones is not close enough to do that.

>throw cable at rails
Jones throws the cable, but it comes up short. She gathers it up again.

Thallium's flyer is circling you not too far away. "Give up, Jones! You'll never get through my silnium bars, haha!"

* * *

>x speeders
None of these are half as cool as Galaxy One.

>x speeder
(the speeder)
Galaxy One is a Dust Runner, a top-of-the-line model from Olympus Speedworks. It's deep crimson with tinted windows. Powerful turbines adorn vestigial wings that sweep back in severe rearward arcs.

>x bays
Most of the parking bays are unfilled.

>x bay
Galaxy One is a Dust Runner, a top-of-the-line model from Olympus Speedworks. It's deep crimson with tinted windows. Powerful turbines adorn vestigial wings that sweep back in severe rearward arcs.

>n
Jones approaches the Viking Building entryway, the dramatic façade towering over her.

Galaxy Jones is at the entry doorway. A glass revolving door leads into a large open space north of here. The speeder dock is to the south.

Jones looks up at the 100 stories of glass and steel. "What do you want to bet Thallium's got Europa all the way at the top?"

Beck: "Oh, no doubt."

>x doorway
(the entry door)
A glass revolving door emblazoned with the symbol of a Viking king astride the planet Mars.