>n
Galaxy Jones is in the northern corner of the penthouse. This is Thallium's bedroom. Apart from the expansive round bed in the center of the room, notable features include the line of dummies displaying his various suits of clothes, a large vanity table, and the complete lack of mirrors on the ceiling, thankfully. One may leave the room to the southwest, south, and southeast.

>x window
Looking down at New Reykjavik, one can trace the history of the city, as it expanded radially from its original domes, the multiple frontiers colliding and interfering like ripples in a pond, until eventually, the map gave way to rectangular regularity. The Viking Building stands near the periphery, overlooking the vast red plain of Utopia Planitia.

>e
The diamond-shaped penthouse bends to the southeast and southwest.

>e
The diamond-shaped penthouse bends to the southeast and southwest.

* * *

>se
Galaxy Jones is in the eastern corner of the penthouse. This is apparently an office. A huge desk constructed of bubinga wood and carved in intricate patterns sits before the panoramic window. Video screens, currently displaying Thallium's logo, line the walls. Jones can go northwest or southwest.

>sw
Galaxy Jones is in the southern corner of the penthouse. This must be Thallium's "treasure room", to go by the obscene display of wealth. The most notable feature is the array of diamonds lining the walls. Everything else here pales in comparison. The penthouse continues to the northwest, north, and northeast.

Thallium seems to speak from all around Jones. "You like diamonds, Jones? Of course you do -- they're a girl's best friend, after all."

Jones snorts, "Sure, Thallium."

* * *

>x window
Looking down at New Reykjavik, one can trace the history of the city, as it expanded radially from its original domes, the multiple frontiers colliding and interfering like ripples in a pond, until eventually, the map gave way to rectangular regularity. The Viking Building stands near the periphery, overlooking the vast red plain of Utopia Planitia.

>x windows
There's nothing like that nearby.

>x city
There's nothing like that nearby.

* * *

>gonear catering
Galaxy Jones is on the east side of the ground floor. Apparently some kind of function was happening here before Admiral Thallium emptied the building, for there is an array of canapes on a catering table here. The floor stretches north and south, and there's a closet door to the west.

Beck: "Blueprints indicate a closet to the west of you. Might be useful."

>push 234
An indicator light blinks red.

Jones: "it's not 234..."

>push 0
An indicator light blinks red.

Jones: "it's not 0..."

Beck: "I don't think you'll get it just typing random numbers."

>purloin note
Which do you mean, the note or the present?

>the note
Which do you mean, the note or the present?

>s
I only understood you as far as wanting to purloin south.

>s
Galaxy Jones is at the southeast corner of the ground floor. The centerpiece of this area is the actual Viking 2 lander, which landed right here on Utopia Planitia. The glass walls look out onto the city. Jones can go north or west from here.

>w
Galaxy Jones is in the lobby. The ground floor of the Viking Building is breathtaking. Low-G architecture means more glass and thinner supports, and the building takes advantage of that. Four walls of glass surround a central pillar in which are set the utility rooms and elevators. In between is an expanse of plants, water features, and stylish seating. Near the entryway is a front desk. A giant crystal sculpture floats above the center of the area, suspended on almost invisible cables. Jones may go east and west from here, north to the elevators, or south out of the building.

Suddenly two robot guards, green and red, emerge from niches in the back wall! She dives behind the front desk and draws her disruptor pistol.

Jones shouts, "I'm under fire from two ugly robot things!"

Beck responds, "Monitoring your suit radar."

>x desk
There's not much on the desk other than a note that says "0".

Beck: "Robot on your right!"

One robot tries to flank Jones, but a shot from her disruptor sends it scurrying back.

>e
Trying to reach an exit would surely get Jones shot.

Jones: "I'm pinned down here!"

>shoot art
Jones fires the disruptor into the sculpture's main support cable, snapping it. The huge crystal blob starts to sag, straining the other cables. In quick succession they break as well, and the whole installation plummets to the ground, right on top of the hapless guard robots.
 _________      __                     _____                     
 __/ ____/___ _/ /___ __  ____  __     __/ /___  ____  ___  _____
 _/ / __/ __ `/ / __ `/ |/ / / / /____ _/ / __ \/ __ \/ _ \/ ___/
 / /_/ / /_/ / / /_/ />  </ /_/ / _/ /_/ / /_/ / / / /  __(__  ) 
 \____/\__,_/_/\__,_/_/|_|\__, /  _\____/\____/_/ /_/\___/____/  
 _____________________________/ 

[Your score has just gone up by one point.]

Beck: "What was that crash? What's going on?"

Jones: "That, my friend, was what you'd call a work of art. Targets terminated."

* * *

>e
Jones crosses the floor carefully, disruptor pistol at the ready.

Galaxy Jones is at the southeast corner of the ground floor. The centerpiece of this area is the actual Viking 2 lander, which landed right here on Utopia Planitia. The glass walls look out onto the city. She can go north or west from here.

Admiral Thallium's voice booms from the ceiling. "Little Galaxy thinks she's beaten the big bad Admiral. Sorry dear, that was only a taste."

>n
Galaxy Jones is on the east side of the ground floor. Apparently some kind of function was happening here before Admiral Thallium emptied the building, for there is an array of canapes on a catering table here. The floor stretches north and south, and there's a closet door to the west.

>push 0
An indicator light glows green.

Jones: "I've unlocked the east side utility door."

* * *

>gonear catering
Galaxy Jones is on the east side of the ground floor. Apparently some kind of function was happening here before Admiral Thallium emptied the building, for there is an array of canapes on a catering table here. The floor stretches north and south, and there's a closet door to the west.

Beck: "Blueprints indicate a closet to the west of you. Might be useful."

>push 3423
The elevator quickly arrives at its destination.

Galaxy Jones is on the east side of the ground floor. Apparently some kind of function was happening here before Admiral Thallium emptied the building, for there is an array of canapes on a catering table here. The floor stretches north and south, and there's a closet door to the west.

>actions
Actions listing on.

>push 3423
[button pushing 3423]
The elevator quickly arrives at its destination.

[(1) looking]
Galaxy Jones is on the east side of the ground floor. Apparently some kind of function was happening here before Admiral Thallium emptied the building, for there is an array of canapes on a catering table here. The floor stretches north and south, and there's a closet door to the west.

[(1) looking - succeeded]

[button pushing 3423 - succeeded]

>actions off
Actions listing off.

>rules
Rules tracing now switched on. Type "rules off" to switch it off again, or "rules all" to include even rules which do not apply.

[Rule "reset conversed this turn rule" applies.]
[Rule "clear LPR rule" applies.]

>actions off
[Rule "declare everything initially unmentioned rule" applies.]
[Rule "assign alternative door targets rule" applies.]
Actions listing off.

[Rule "reset conversed this turn rule" applies.]
[Rule "clear LPR rule" applies.]

* * *

>gonear ground hall
Galaxy Jones is in the ground floor elevator hall. This hallway between the north and south ends of the ground floor is home to the elevator to the west. To the east is the entrance to a stairwell.

>x elevator
(the elevator door)
A gleaming gold elevator door. There is a hole near the top for inserting a drop key.

>gonear cybernetica office
Galaxy Jones is in the Cybernetica office. It's spacious and luxurious, designed to make developers forget how spent they are from months of overwork and abuse. Ergonomic desks and chairs fill space like a furniture fractal, before giving way to an open area, presumably for group activities.

As soon as Jones steps into the office, a shot zaps just past her nose. She dives to the ground, protected by the maze of desks and chairs. Peeking through the mesh back of one of the chairs, she takes notice of both the purple guard robot training its disruptor on the room, and the chair's fine construction and lumbar support.

Jones (whispering): "We've got another one! I'm out of sight for now, but it's going to be hard to get a shot off at this 'bot."

Beck: "What's the situation?"

Jones: "I'm on the floor with desks and chairs all around. The target is a few yards off, coming this way. I might get a shot in, but it might just absorb it anyway."

Beck: "Well, see if you can sneak up on it. Maybe close up you can find a way past its defenses."

>stand up
Jones starts to stand, and a shot zips by, way too close. She hits the deck.

>sneak up on robot
Jones creeps a little ways toward the guard robot.

* * *

>stand up
The atmosphere is too thin out there. Jones needs protective gear.

>actions
Actions listing on.

>stand up
[exiting]
[(1) going outside]
The atmosphere is too thin out there. Jones needs protective gear.
[(1) going outside - ended without result]

[exiting - failed the convert exit into go out rule]

>out
[exiting]
[(1) going outside]
The atmosphere is too thin out there. Jones needs protective gear.
[(1) going outside - ended without result]

[exiting - failed the convert exit into go out rule]

* * *

>n
Galaxy Jones is next to the cage. The closely-set silnium bars seem to dash all hope of a rescue.

Europa Callisto is lying at the center of the cage, out of Jones's reach.

Jones tries the strength of the bars just in case. They don't budge.

South of the cage, Thallium crosses the roof to the flyer pad, where he boards the waiting flyer. The flyer lifts off and moves towards Jones.

>l
Galaxy Jones is next to the cage. The closely-set silnium bars seem to dash all hope of a rescue.

Europa Callisto is lying at the center of the cage, out of Jones's reach.

Admiral Thallium's flyer is hovering above you.

Thallium's flyer hovers over the rooftop. "Jones!"  he bellows. "Play time is over. I grow weary of your intransigence. In a moment this roof will be swarmed by guard robots -- of many different colors -- so many robots you couldn't possibly vandalize them all.  Say your prayers, Jones, or whatever you do when you're about to die."

Jones rolls her eyes.

A little ways off, a small red flyer aims for the rooftop and accelerates.

>e
Jones would plummet to her death that way.

>s
Thallium's flyer floats after Jones.

Jones opens the door and steps through onto the roof. The door crashes shut, and a lock audibly clicks.
 _________      __                     _____                     
 __/ ____/___ _/ /___ __  ____  __     __/ /___  ____  ___  _____
 _/ / __/ __ `/ / __ `/ |/ / / / /____ _/ / __ \/ __ \/ _ \/ ___/
 / /_/ / /_/ / / /_/ />  </ /_/ / _/ /_/ / /_/ / / / /  __(__  ) 
 \____/\__,_/_/\__,_/_/|_|\__, /  _\____/\____/_/ /_/\___/____/  
 _____________________________/ 

[Your score has just gone up by one point.]

Jones walks out onto the luxurious penthouse roof. Admiral Thallium turns from the railing to face her. He is dressed in an absurd elaboration of a Martian Admiral's uniform. He looks Jones up and down with a lecherous leer. "Ah, Galaxy Jones, as lovely as ever. If it weren't so unbearably cliché I'd ask you to join me in my rise to greatness. But alas, you are too habituated to the smug high of 'goodness'." He sighs dramatically. "We've trodden similar ground before; no need to discuss it further. Although I would challenge any of your various amoureux to conjugate 'tread' correctly.

"Anyway, I guess this is the time where you do something predictably undignified and violent. Before you do I feel I should inform you that your sidearm has been rendered quite ineffective by my personal security field. But do go ahead and try it."

Jones sneers. "I wouldn't give you the satisfaction," she says, looking around. "I see you don't have any of your robot pets up here. How are you going to stop me from rescuing Europa?"

"Oh please, while we're trying things, try that too. I wish you luck breaking the silnium bars of the cage."

"What's silnium?"

"A superstrong material invented here in my Martian Chemical laboratory. We had a press conference for it -- weren't you watching?"

"Couldn't be bothered."

"Oh for frotz sake, Jones, you're so frustrating!"

Thallium turns his back on Jones and stares out over the city.

Galaxy Jones is on the penthouse roof. It is an extravagant and opulent space, designed to showcase Thallium's wealth and power. Much of the rooftop is devoted to an outdoor lounge area, with comfortable seating and a fire pit, centered around a hot tub and flanked by a bar. All around is the city of New Reykjavik, and beyond that the red Martian landscape. Around the entirety of the roof is an electrostatic field designed to keep air in and particulates out. To the north is a large cage, and to the west is a landing pad. Jones can distantly see a woman lying on the floor of the cage.

Admiral Thallium's flyer is hovering above you.

>w
Thallium's flyer floats after Jones.

Galaxy Jones is on the flyer pad. This is what one would expect from a rooftop flyer pad: landing lights surrounding a large letter F painted in white on a red background.

Admiral Thallium's flyer is hovering above you.

>e
Thallium's flyer floats after Jones.

Galaxy Jones is on the penthouse roof. It is an extravagant and opulent space, designed to showcase Thallium's wealth and power. Much of the rooftop is devoted to an outdoor lounge area, with comfortable seating and a fire pit, centered around a hot tub and flanked by a bar. All around is the city of New Reykjavik, and beyond that the red Martian landscape. Around the entirety of the roof is an electrostatic field designed to keep air in and particulates out. To the north is a large cage, and to the west is a landing pad. Jones can distantly see a woman lying on the floor of the cage.

Admiral Thallium's flyer is hovering above you.

Thallium's flyer is circling you not too far away. "Give up, Jones! You'll never get through my silnium bars, haha!"

>n
Thallium's flyer floats after Jones.

Galaxy Jones is next to the cage. The closely-set silnium bars seem to dash all hope of a rescue.

Europa Callisto is lying at the center of the cage, out of Jones's reach.

Admiral Thallium's flyer is hovering above you.

>get on cage
Jones gets onto the cage.

>l
Galaxy Jones is standing on the cage. The closely-set silnium bars seem to dash all hope of a rescue.

Europa Callisto is lying at the center of the cage, out of Jones's reach.

Admiral Thallium's flyer is hovering above you.

>throw water at flyer
There's nothing like that nearby.

>purloin water bottle
[Purloined.]

>throw water at flyer
Throwing the full water bottle would hardly be effective.

* * *

>throw water at flyer
There's nothing like that nearby.

>throw cable at flyer
There's nothing like that nearby.

>x flyer
Hovering above Jones, it's distinctly menacing. It's not visibly armed, but it conveys the impression of a beast about to strike. It's flying low, the rails of its landing gear just a few feet above Jones's head.

>purloin cable
[Purloined.]

>throw cable at flyer
 _________      __                     _____                     
 __/ ____/___ _/ /___ __  ____  __     __/ /___  ____  ___  _____
 _/ / __/ __ `/ / __ `/ |/ / / / /____ _/ / __ \/ __ \/ _ \/ ___/
 / /_/ / /_/ / / /_/ />  </ /_/ / _/ /_/ / /_/ / / / /  __(__  ) 
 \____/\__,_/_/\__,_/_/|_|\__, /  _\____/\____/_/ /_/\___/____/  
 _____________________________/ 

[Your score has just gone up by one point.]

Jones throws the cable up to the flyer where it hooks around the rail, and attaches the other end to the cage, then jumps off the cage to escape the aftermath. Seeing his flyer's predicament, Thallium jumps through the door and disappears below the edge of the roof. The flyer reaches the end of its tether and slingshots downwards, slamming into side of the building.

The cage has tilted to the side, one attachment torn loose from the rooftop. Jones crawls into the cage to see to Europa Callisto.

"Europa! Can you hear me? I need you to move to get out of this cage. I can't carry you through that small opening. Europa!"

Europa moans but doesn't show any signs of having understood Jones.

Galaxy Jones is in the cage. The whole structure is tilted, leaving a hole at the eastern end.

Jones is kneeling at Europa Callisto's side, trying to rouse her.

Admiral Thallium's flyer is hovering above you.

The red flyer, now recognizable as Galaxy's own, settles down onto the landing pad.

>pull europa
Jones could pull Europa up to the hole in the cage, but she'd never get her through without help.

>actions
Actions listing on.

>carry europa
[taking Europa Callisto]
Jones could carry Europa to the hole in the cage, but she'd never get her through without help.
[taking Europa Callisto - failed]

Beck sticks his head out of the door of the flyer and yells "C'mon Jones, get Europa and get in the flyer!"

>wake europa
[waking Europa Callisto]
Europa moans but otherwise does not respond.
[waking Europa Callisto - failed]

>exit
[exiting]
Jones can't leave Europa now!
[exiting - failed]

>leave
[exiting]
Jones can't leave Europa now!
[exiting - failed]

>actions off
Actions listing off.

>kiss europa
I didn't understand that sentence.

>lift europa
Jones could carry Europa to the hole in the cage, but she'd never get her through without help.

>kick europa
I didn't understand that sentence.

>hit europa
Jones only uses violent means when absolutely necessary.

>i
Jones is carrying:
  a disruptor pistol

>shoot thallium
There's nothing like that nearby.

* * *

>get on cage
Jones gets onto the cage.

>shoot thallium
Jones's disruptor does nothing. Looks like Thallium was telling the truth.

>hit flyer
Jones only uses violent means when absolutely necessary.

>throw pistol at flyer
That would be counter-productive.

Thallium: "Jones! In a moment I shall leave you to be slaughtered by my minions!"

* * *

>shoot thallium
Jones's disruptor does nothing. Looks like Thallium was telling the truth.

>shoot flyer
Jones's disruptor does nothing. Looks like Thallium was telling the truth.

* * *

>gonear roof
Which do you mean, the roof stairs, the roof access door, or the penthouse roof?

>penthouse
Galaxy Jones is on the penthouse roof. It is an extravagant and opulent space, designed to showcase Thallium's wealth and power. Much of the rooftop is devoted to an outdoor lounge area, with comfortable seating and a fire pit, centered around a hot tub and flanked by a bar. All around is the city of New Reykjavik, and beyond that the red Martian landscape. Around the entirety of the roof is an electrostatic field designed to keep air in and particulates out. To the north is a large cage, and to the west is a landing pad. Jones can distantly see a woman lying on the floor of the cage. A green and black flyer sits on the landing pad.

Admiral Thallium is sulking.

>x field
It can't be seen, but it's comforting to know it's there.

>w
Thallium trails after Jones.

Um, Jones -- that harlot you're so bent on freeing from captivity is over there. Now get out of the way, I'm trying to escape."

Thallium pushes past Jones. She attempts to grab his shoulder, but she is thrown back by an unseen force.

Thallium smirks. "Personal security field, remember? Now I must be off."

Jones watches as Thallium boards the flyer. It takes off a moment later.

Galaxy Jones is on the flyer pad. This is what one would expect from a rooftop flyer pad: landing lights surrounding a large letter F painted in white on a red background.

>x field
It can't be seen, but it's comforting to know it's there.

Thallium's flyer hovers over the rooftop. "Jones!"  he bellows. "Play time is over. I grow weary of your intransigence. In a moment this roof will be swarmed by guard robots -- of many different colors -- so many robots you couldn't possibly vandalize them all.  Say your prayers, Jones, or whatever you do when you're about to die."

Jones rolls her eyes.

A little ways off, a small red flyer aims for the rooftop and accelerates.

>z
Jones stands around and waits.

>z
Jones stands around and waits.

Thallium's flyer is circling you not too far away. "Give up, Jones! You'll never get through my silnium bars, haha!"

>z
Jones stands around and waits.

>z
Jones stands around and waits.

Thallium: "Jones! In a moment I shall leave you to be slaughtered by my minions!"

>z
Jones stands around and waits.

>z
Jones stands around and waits.

Thallium: "Here I go, Jones! Here I go! I'm really leaving this time! Jones! Are you listening? I'm going!"

>z
Jones stands around and waits.

>l
Galaxy Jones is on the flyer pad. This is what one would expect from a rooftop flyer pad: landing lights surrounding a large letter F painted in white on a red background.

>scenes
Scene 'Entire Game' playing (for 27 mins now)
Scene 'Endgame' playing (for 27 mins now)
Scene 'On-Rooftop' ended
Scene 'Thallium alight' ended
Scene 'Thallium ultimatum' playing (for 23 mins now)
(Scene monitoring now switched on. Type "scenes off" to switch it off again.)

* * *

>w
Galaxy Jones is in the elevator car. It's luxurious, with gold-plated walls and crystal lighting on the ceiling. The button panel is lacquered dark mahogany with what look like real ivory buttons. The carpeting is soft and plush. A golden keyhole sits above the buttons.

One of the ceiling panels looks loose.

Admiral Thallium's voice oozes from concealed speakers: "Yes, Jones, that is real ivory. I imported the elephant here myself for a hunt on my estate. You have no idea how much money it takes to simulate an African jungle on Mars. In retrospect I should have gotten an Indian elephant."

>purloin present
[Purloined.]

>open it
Jones rips the package open and discovers a golden key.

>put key in keyhole
Jones puts the key in the keyhole and turns. There is a pleasant chime, and some buttons light up.

Galaxy Jones is in the elevator car. It's luxurious, with gold-plated walls and crystal lighting on the ceiling. The button panel is lacquered dark mahogany with what look like real ivory buttons. The carpeting is soft and plush. A golden key rests in a golden keyhole above the buttons. The buttons 1, 9, 10, and 100 are illuminated.

One of the ceiling panels looks loose.

>take it
Jones removes the ceiling panel, exposing a hole wide enough for her to squeeze through.

>take key
Jones tries to take the key out of the keyhole, but it seems to be stuck there.

>remove key from keyhole
Jones tries to take the key out of the keyhole, but it seems to be stuck there.

* * *

>w
Galaxy Jones is in the elevator car. It's luxurious, with gold-plated walls and crystal lighting on the ceiling. The button panel is lacquered dark mahogany with what look like real ivory buttons. The carpeting is soft and plush. A golden keyhole sits above the buttons.

One of the ceiling panels looks loose.

Admiral Thallium's voice oozes from concealed speakers: "Yes, Jones, that is real ivory. I imported the elephant here myself for a hunt on my estate. You have no idea how much money it takes to simulate an African jungle on Mars. In retrospect I should have gotten an Indian elephant."

>purloin golden key
[Purloined.]

>put it in keyhole
Jones puts the key in the keyhole and turns. There is a pleasant chime, and some buttons light up.

Galaxy Jones is in the elevator car. It's luxurious, with gold-plated walls and crystal lighting on the ceiling. The button panel is lacquered dark mahogany with what look like real ivory buttons. The carpeting is soft and plush. A golden key rests in a golden keyhole above the buttons. The buttons 1, 9, 10, and 100 are illuminated.

One of the ceiling panels looks loose.

>u
Jones can neither climb walls nor fly.

>open ceiling panels
There's nothing like that nearby.

>open ceiling panel
Jones removes the ceiling panel, exposing a hole wide enough for her to squeeze through.

>u
Galaxy Jones is on the top of the elevator car. The elevator shaft extends many hundreds of feet above her  . She can see down into the elevator car from here.

>x shaft
The shaft extends far up into the darkness. The ladder here is missing, making it impossible to climb up to the eleventh floor and beyond.

>x ladder
The shaft extends far up into the darkness. The ladder here is missing, making it impossible to climb up to the eleventh floor and beyond.

>d
Galaxy Jones is in the elevator car. It's luxurious, with gold-plated walls and crystal lighting on the ceiling. The button panel is lacquered dark mahogany with what look like real ivory buttons. The carpeting is soft and plush. A golden key rests in a golden keyhole above the buttons. The buttons 1, 9, 10, and 100 are illuminated. There is a hole in the ceiling big enough for Jones to squeeze through.

>press 1
The elevator quickly arrives at its destination.

Galaxy Jones is in the elevator car. It's luxurious, with gold-plated walls and crystal lighting on the ceiling. The button panel is lacquered dark mahogany with what look like real ivory buttons. The carpeting is soft and plush. A golden key rests in a golden keyhole above the buttons. The buttons 1, 9, 10, and 100 are illuminated. There is a hole in the ceiling big enough for Jones to squeeze through.

>u
Galaxy Jones is on the top of the elevator car. The elevator shaft extends many hundreds of feet above her  . She can see down into the elevator car from here.

>x shaft
The shaft extends far up into the darkness. There is ladder here, but there's no reason to use it when the elevator is working.

>x ladder
The shaft extends far up into the darkness. There is ladder here, but there's no reason to use it when the elevator is working.

>d
Galaxy Jones is in the elevator car. It's luxurious, with gold-plated walls and crystal lighting on the ceiling. The button panel is lacquered dark mahogany with what look like real ivory buttons. The carpeting is soft and plush. A golden key rests in a golden keyhole above the buttons. The buttons 1, 9, 10, and 100 are illuminated. There is a hole in the ceiling big enough for Jones to squeeze through.

>press 9
The elevator quickly arrives at its destination.

Galaxy Jones is in the elevator car. It's luxurious, with gold-plated walls and crystal lighting on the ceiling. The button panel is lacquered dark mahogany with what look like real ivory buttons. The carpeting is soft and plush. A golden key rests in a golden keyhole above the buttons. The buttons 1, 9, 10, and 100 are illuminated. There is a hole in the ceiling big enough for Jones to squeeze through.

>u
Galaxy Jones is on the top of the elevator car. The elevator shaft extends many hundreds of feet above her  . She can see down into the elevator car from here.

* * *

>x shaft
The shaft extends far up into the darkness. The ladder here is missing, making it impossible to climb up to the eleventh floor and beyond.

>d
Galaxy Jones is in the elevator car. It's luxurious, with gold-plated walls and crystal lighting on the ceiling. The button panel is lacquered dark mahogany with what look like real ivory buttons. The carpeting is soft and plush. A golden key rests in a golden keyhole above the buttons. The buttons 1, 9, 10, and 100 are illuminated. There is a hole in the ceiling big enough for Jones to squeeze through.

>u
Galaxy Jones is on the top of the elevator car. The elevator shaft extends many hundreds of feet above her  . She can see down into the elevator car from here.

>x ladder
The shaft extends far up into the darkness. The ladder here is missing, making it impossible to climb up to the eleventh floor and beyond.

* * *

>d
Galaxy Jones is in the elevator car. It's luxurious, with gold-plated walls and crystal lighting on the ceiling. The button panel is lacquered dark mahogany with what look like real ivory buttons. The carpeting is soft and plush. A golden key rests in a golden keyhole above the buttons. The buttons 1, 9, 10, and 100 are illuminated. There is a hole in the ceiling big enough for Jones to squeeze through.

>press 100
The elevator accelerates upwards at a frightening rate. The numbers climb towards 100. Soon the elevator slows, and the door opens on the 100th floor.

Jones: "Holy - This thing goes fast."

Galaxy Jones is in the elevator car. It's luxurious, with gold-plated walls and crystal lighting on the ceiling. The button panel is lacquered dark mahogany with what look like real ivory buttons. The carpeting is soft and plush. A golden key rests in a golden keyhole above the buttons. The buttons 1, 9, 10, and 100 are illuminated. There is a hole in the ceiling big enough for Jones to squeeze through.

>u
Galaxy Jones is on the top of the elevator car. She is right at the top of the shaft. She can see down into the elevator car from here.

>x shaft
This is the top of the shaft.

>x ldder
There's nothing like that nearby.

>x ladder
This is the top of the shaft.

>out
But Jones isn't in anything at the moment.

>e
Jones can't go that way.

>w
Jones can't go that way.

>d
Galaxy Jones is in the elevator car. It's luxurious, with gold-plated walls and crystal lighting on the ceiling. The button panel is lacquered dark mahogany with what look like real ivory buttons. The carpeting is soft and plush. A golden key rests in a golden keyhole above the buttons. The buttons 1, 9, 10, and 100 are illuminated. There is a hole in the ceiling big enough for Jones to squeeze through.

>out
Galaxy Jones is in the 100th floor elevator hall. The luxury is staggering.  The walls are made of polished black marble, and the floors are covered in plush black carpeting that muffles the sound of footsteps. The ceiling is high and adorned with a crystal chandelier. The elevator doors to the west are gold-plated. Sumptuous living quarters are visible to the north and south.

>x windows
There's nothing like that nearby.

>n
Galaxy Jones is in the northern corner of the penthouse. This is Thallium's bedroom. Apart from the expansive round bed in the center of the room, notable features include the line of dummies displaying his various suits of clothes, a large vanity table, and the complete lack of mirrors on the ceiling, thankfully. One may leave the room to the southwest, south, and southeast.

>x windows
There's nothing like that nearby.

* * *

>push 3
Nothing happens.

* * *

I beg your pardon?

>e
Galaxy Jones is on the roof stairs. Thick slabs of marble lead from the hall to the west to the rooftop door above.

* * *

>i
Jones is carrying:
  a screwdriver
  a black cardkey
  a full water bottle
  a hammer
  an elevator drop key
  a safety pin
  a garish medal
  a fork
  a red cardkey
  an Atmo-Suit
  a cable with hooks at either end
  a disruptor pistol

* * *

>e
Galaxy Jones is on the roof stairs. Thick slabs of marble lead from the hall to the west to the rooftop door above.

>undo
Galaxy Jones is in the 100th floor elevator hall.
[Previous turn undone.]

>u
Galaxy Jones is on the roof stairs. Thick slabs of marble lead from the hall to the west to the rooftop door above.

* * *

>n
Galaxy Jones is next to the cage. The closely-set silnium bars seem to dash all hope of a rescue.

Europa Callisto is lying at the center of the cage, out of Jones's reach.

Jones tries the strength of the bars just in case. They don't budge.

South of the cage, Thallium crosses the roof to the flyer pad, where he boards the waiting flyer. The flyer lifts off and moves towards Jones.

>i
Jones is carrying:
  a screwdriver
  a black cardkey
  a full water bottle
  a hammer
  an elevator drop key
  a safety pin
  a garish medal
  a fork
  a red cardkey
  an Atmo-Suit
  a cable with hooks at either end
  a disruptor pistol

Thallium's flyer hovers over the rooftop. "Jones!"  he bellows. "Play time is over. I grow weary of your intransigence. In a moment this roof will be swarmed by guard robots -- of many different colors -- so many robots you couldn't possibly vandalize them all.  Say your prayers, Jones, or whatever you do when you're about to die."

Jones rolls her eyes.

A little ways off, a small red flyer aims for the rooftop and accelerates.

>throw screwdriver at thallium
It would just bounce off.

>throw cable at thallium
Jones throws the cable, but it comes up short. She gathers it up again.

>hook cable to cage
It doesn't seem useful to attach the cable to this part of the cage.

>u
Jones gets onto the cage.

Thallium's flyer is circling you not too far away. "Give up, Jones! You'll never get through my silnium bars, haha!"

>climb cage
Jones gets onto the cage.

* * *

>u
Jones gets onto the cage.

Thallium's flyer is circling you not too far away. "Give up, Jones! You'll never get through my silnium bars, haha!"

>hook cable to cage
 _________      __                     _____                     
 __/ ____/___ _/ /___ __  ____  __     __/ /___  ____  ___  _____
 _/ / __/ __ `/ / __ `/ |/ / / / /____ _/ / __ \/ __ \/ _ \/ ___/
 / /_/ / /_/ / / /_/ />  </ /_/ / _/ /_/ / /_/ / / / /  __(__  ) 
 \____/\__,_/_/\__,_/_/|_|\__, /  _\____/\____/_/ /_/\___/____/  
 _____________________________/ 

[Your score has just gone up by one point.]

Jones throws the cable up to the flyer where it hooks around the rail, and attaches the other end to the cage, then jumps off the cage to escape the aftermath. Seeing his flyer's predicament, Thallium jumps through the door and disappears below the edge of the roof. The flyer reaches the end of its tether and slingshots downwards, slamming into side of the building.

The cage has tilted to the side, one attachment torn loose from the rooftop. Jones crawls into the cage to see to Europa Callisto.

"Europa! Can you hear me? I need you to move to get out of this cage. I can't carry you through that small opening. Europa!"

Europa moans but doesn't show any signs of having understood Jones.

Galaxy Jones is in the cage. The whole structure is tilted, leaving a hole at the eastern end.

Jones is kneeling at Europa Callisto's side, trying to rouse her.

The red flyer, now recognizable as Galaxy's own, settles down onto the landing pad.

>take callisto
Jones could carry Europa to the hole in the cage, but she'd never get her through without help.

>move europa
Europa Callisto might not like that.

Beck sticks his head out of the door of the flyer and yells "C'mon Jones, get Europa and get in the flyer!"

* * *

>w
Thallium trails after Jones.

Um, Jones -- that harlot you're so bent on freeing from captivity is over there. Now get out of the way, I'm trying to escape."

Thallium pushes past Jones. She attempts to grab his shoulder, but she is thrown back by an unseen force.

Thallium smirks. "Personal security field, remember? Now I must be off."

Jones watches as Thallium boards the flyer. It takes off a moment later.

Galaxy Jones is on the flyer pad. This is what one would expect from a rooftop flyer pad: landing lights surrounding a large letter F painted in white on a red background.

>e
Galaxy Jones is on the penthouse roof. It is an extravagant and opulent space, designed to showcase Thallium's wealth and power. Much of the rooftop is devoted to an outdoor lounge area, with comfortable seating and a fire pit, centered around a hot tub and flanked by a bar. All around is the city of New Reykjavik, and beyond that the red Martian landscape. Around the entirety of the roof is an electrostatic field designed to keep air in and particulates out. To the north is a large cage, and to the west is a landing pad. Jones can distantly see a woman lying on the floor of the cage.

Thallium's flyer hovers over the rooftop. "Jones!"  he bellows. "Play time is over. I grow weary of your intransigence. In a moment this roof will be swarmed by guard robots -- of many different colors -- so many robots you couldn't possibly vandalize them all.  Say your prayers, Jones, or whatever you do when you're about to die."

Jones rolls her eyes.

A little ways off, a small red flyer aims for the rooftop and accelerates.

>get on cage
There's nothing like that nearby.

>n
Thallium's flyer floats after Jones.

Galaxy Jones is next to the cage. The closely-set silnium bars seem to dash all hope of a rescue.

Europa Callisto is lying at the center of the cage, out of Jones's reach.

Jones tries the strength of the bars just in case. They don't budge.

>get on cage
Jones gets onto the cage.

>throw cable at rails
 _________      __                     _____                     
 __/ ____/___ _/ /___ __  ____  __     __/ /___  ____  ___  _____
 _/ / __/ __ `/ / __ `/ |/ / / / /____ _/ / __ \/ __ \/ _ \/ ___/
 / /_/ / /_/ / / /_/ />  </ /_/ / _/ /_/ / /_/ / / / /  __(__  ) 
 \____/\__,_/_/\__,_/_/|_|\__, /  _\____/\____/_/ /_/\___/____/  
 _____________________________/ 

[Your score has just gone up by one point.]

Jones throws the cable up to the flyer where it hooks around the rail, and attaches the other end to the cage, then jumps off the cage to escape the aftermath. Seeing his flyer's predicament, Thallium jumps through the door and disappears below the edge of the roof. The flyer reaches the end of its tether and slingshots downwards, slamming into side of the building.

The cage has tilted to the side, one attachment torn loose from the rooftop. Jones crawls into the cage to see to Europa Callisto.

"Europa! Can you hear me? I need you to move to get out of this cage. I can't carry you through that small opening. Europa!"

Europa moans but doesn't show any signs of having understood Jones.

Galaxy Jones is in the cage. The whole structure is tilted, leaving a hole at the eastern end.

Jones is kneeling at Europa Callisto's side, trying to rouse her.

The red flyer, now recognizable as Galaxy's own, settles down onto the landing pad.

>ask europa about beck
She's too out of it to respond.

* * *

>u
Jones can neither climb walls nor fly.

>n
Thallium's flyer floats after Jones.

Galaxy Jones is next to the cage. The closely-set silnium bars seem to dash all hope of a rescue.

Europa Callisto is lying at the center of the cage, out of Jones's reach.

Jones tries the strength of the bars just in case. They don't budge.

* * *

>get on cage
Jones gets onto the cage.

>z
Jones stands around and waits.

Thallium's flyer is circling you not too far away. "Give up, Jones! You'll never get through my silnium bars, haha!"

>throw cable at thallium
There's nothing like that nearby.

>throw cable at thallium;s
There's nothing like that nearby.

>throw cable at thallium's
 _________      __                     _____                     
 __/ ____/___ _/ /___ __  ____  __     __/ /___  ____  ___  _____
 _/ / __/ __ `/ / __ `/ |/ / / / /____ _/ / __ \/ __ \/ _ \/ ___/
 / /_/ / /_/ / / /_/ />  </ /_/ / _/ /_/ / /_/ / / / /  __(__  ) 
 \____/\__,_/_/\__,_/_/|_|\__, /  _\____/\____/_/ /_/\___/____/  
 _____________________________/ 

[Your score has just gone up by one point.]

Jones throws the cable up to the flyer where it hooks around the rail, and attaches the other end to the cage, then jumps off the cage to escape the aftermath. Seeing his flyer's predicament, Thallium jumps through the door and disappears below the edge of the roof. The flyer reaches the end of its tether and slingshots downwards, slamming into side of the building.

The cage has tilted to the side, one attachment torn loose from the rooftop. Jones crawls into the cage to see to Europa Callisto.

"Europa! Can you hear me? I need you to move to get out of this cage. I can't carry you through that small opening. Europa!"

Europa moans but doesn't show any signs of having understood Jones.

Galaxy Jones is in the cage. The whole structure is tilted, leaving a hole at the eastern end.

Jones is kneeling at Europa Callisto's side, trying to rouse her.

The red flyer, now recognizable as Galaxy's own, settles down onto the landing pad.

>z
Jones stands around and waits.

* * *

>z
Jones stands around and waits.

Beck sticks his head out of the door of the flyer and yells "C'mon Jones, get Europa and get in the flyer!"

>z
Jones stands around and waits.

* * *

>open panel
(the ceiling panel)
Jones removes the ceiling panel, exposing a hole wide enough for her to squeeze through.

>u
Galaxy Jones is on the top of the elevator car. The elevator shaft extends many hundreds of feet above here. She can see down into the elevator car from here.

>look up
There's nothing in that direction.

>climb up
You must name something more substantial.

>go up
Jones can neither climb walls nor fly.

>climb up shaft
Little is to be achieved by that.

>actions
Actions listing on.

>climb up shaft
[climbing the elevator shaft]
Little is to be achieved by that.
[climbing the elevator shaft - failed the block climbing rule]

>climb ladder
There's nothing like that nearby.

* * *

>press buttons
You have to specify what button, from 1 to 100.

>press 100
Nothing happens.

>press 101
Nothing happens.

>press 3.4
Nothing happens.

I didn't understand that sentence.

>actions
Actions listing on.

>press 3.4
[button pushing 3]
Nothing happens.
[button pushing 3 - failed the Check button pushing a number when the number understood is not listed in { 1 , 9 , 10 , 100 } or the elevator car-room is not in running mode]

I didn't understand that sentence.

* * *

>e
Galaxy Jones is in the tenth floor elevator hall. The elevator car to the west stands open. There is a stairwell to the east. The hall runs north and south into a sumptuous corporate office.

>s
Galaxy Jones is on the south side of the Consolidated Microthings office. This is reception. It has a great view of the New Reykjavik Botanic Dome. Couches are lined up to take advantage. The floor extends east and west, and north to the elevator.

>w
Galaxy Jones is at the southwest corner of the Consolidated Microthings office. This looks like the IT area of the office. Numerous desks and an abundance of computer parts are here. Jones can go north or east from here.

There is a present with a note attached sitting on a desk here.

>get present
Taken.

>open it
Jones rips the package open and discovers a golden key.

>e
Galaxy Jones is on the south side of the Consolidated Microthings office. This is reception. It has a great view of the New Reykjavik Botanic Dome. Couches are lined up to take advantage. The floor extends east and west, and north to the elevator.

>n
Galaxy Jones is in the tenth floor elevator hall. The elevator car to the west stands open. There is a stairwell to the east. The hall runs north and south into a sumptuous corporate office.

>w
Galaxy Jones is in the elevator car. It's luxurious, with gold-plated walls and crystal lighting on the ceiling. The button panel is lacquered dark mahogany with what look like real ivory buttons. The carpeting is soft and plush. A golden keyhole sits above the buttons. There is a hole in the ceiling big enough for Jones to squeeze through.

The remains of the mauve guard robot are sprawled on the ground.

>put golden key in keyhole
Jones puts the key in the keyhole and turns. There is a pleasant chime, and some buttons light up.

Galaxy Jones is in the elevator car. It's luxurious, with gold-plated walls and crystal lighting on the ceiling. The button panel is lacquered dark mahogany with what look like real ivory buttons. The carpeting is soft and plush. A golden key rests in a golden keyhole above the buttons. The buttons 1, 9, 10, and 100 are illuminated. There is a hole in the ceiling big enough for Jones to squeeze through.

The remains of the mauve guard robot are sprawled on the ground.

* * *

>jump on robot
Jones drops down through the ceiling and on to the guard robot. It swings around looking for her, obviously panicked that it can't bring its gun to bear on its attacker. Jones manages to hang on.

The mauve guard robot struggles against her hold on it, to no avail.

>undo
Galaxy Jones is on the top of the elevator car.
[Previous turn undone.]

>touch robot
Jones can't reach the mauve guard robot.

>jump on robot
Jones drops down through the ceiling and on to the guard robot. It swings around looking for her, obviously panicked that it can't bring its gun to bear on its attacker. Jones manages to hang on.

The mauve guard robot struggles against her hold on it, to no avail.

* * *

>rules
Rules tracing now switched on. Type "rules off" to switch it off again, or "rules all" to include even rules which do not apply.

[Rule "reset conversed this turn rule" applies.]
[Rule "clear LPR rule" applies.]

>jump on roboy
[Rule "After deciding the scope of the player when the location is top of the elevator car" applies.]
[Rule "After deciding the scope of the player" applies.]
[Rule "After deciding the scope of the player" applies.]
[Rule "After deciding the scope of the player" applies.]
There's nothing like that nearby.
[Rule "clear LPR rule" applies.]

>jump on robot
[Rule "After deciding the scope of the player when the location is top of the elevator car" applies.]
[Rule "After deciding the scope of the player" applies.]
[Rule "After deciding the scope of the player" applies.]
[Rule "After deciding the scope of the player" applies.]
[Rule "declare everything initially unmentioned rule" applies.]
[Rule "assign alternative door targets rule" applies.]
[Rule "announce items from multiple object lists rule" applies.]
[Rule "set pronouns from items from multiple object lists rule" applies.]
[Rule "before stage rule" applies.]
[Rule "check object is interactible rule" applies.]
Jones can't reach the mauve guard robot.

[Rule "A first turn sequence rule" applies.]
[Rule "every turn stage rule" applies.]
[Rule "Every turn when the mauve guard robot is in the tenth-floor-region and the mauve guard robot is not under attack" applies.]
[Rule "reset protocol rule" applies.]
[Rule "A last turn sequence rule" applies.]
[Rule "notify score changes rule" applies.]
[Rule "show us the people rule" applies.]
[Rule "reset conversed this turn rule" applies.]
[Rule "clear LPR rule" applies.]