>gonear air
(the air handling room)
PronounNotice1PronounNotice2Galaxy Jones is in the air handling room.

>w
(first opening the air handling door)

Galaxy Jones is on the north side of the Consolidated Microthings office.

>s
Galaxy Jones is in the tenth floor elevator hall.

>s
Galaxy Jones is on the south side of the Consolidated Microthings office. 

Jones sees the mauve guard robot to the west.

>n
Galaxy Jones is in the tenth floor elevator hall. 

The mauve guard robot appears to the south, heading east.

>n
Galaxy Jones is on the north side of the Consolidated Microthings office. 

The mauve guard robot appears to the south, heading north.

>e
Galaxy Jones is in the air handling room.

>z
Jones stands around and waits.

>w
Galaxy Jones is on the north side of the Consolidated Microthings office. 

The mauve guard robot appears to the south, heading north.

>w
Galaxy Jones is at the northwest corner of the Consolidated Microthings office. 

The mauve guard robot appears to the east, heading north.

>s
Galaxy Jones is on the west side of the Consolidated Microthings office. 

The mauve guard robot appears to the north, heading west.

>s
Galaxy Jones is at the southwest corner of the Consolidated Microthings office. 

To the north, the mauve guard robot heads south.

>e
Galaxy Jones is on the south side of the Consolidated Microthings office. 

The mauve guard robot appears to the west, heading south.

>e
Galaxy Jones is at the southeast corner of the Consolidated Microthings office. 

To the west, the mauve guard robot heads east.

I beg your pardon?

>n
Galaxy Jones is on the east side of the Consolidated Microthings office. 

The mauve guard robot appears to the south, heading east.

>nw
Galaxy Jones is on the north side of the Consolidated Microthings office. 

The mauve guard robot appears to the southeast, heading north.

>e
Galaxy Jones is in the air handling room.

* * *

>w
Galaxy Jones is on the north side of the Consolidated Microthings office. 

The mauve guard robot appears to the south, heading north.

>e
Galaxy Jones is in the air handling room.

* * *

>z
Jones stands around and waits.

>w
Galaxy Jones is on the north side of the Consolidated Microthings office. 

The mauve guard robot approaches from the south.

>w
Galaxy Jones is at the northwest corner of the Consolidated Microthings office. 

Jones sees the mauve guard robot to the east.

>s
Galaxy Jones is on the west side of the Consolidated Microthings office. 

The mauve guard robot appears to the north, heading west.

* * *

>s
Galaxy Jones is at the southwest corner of the Consolidated Microthings office. 

To the north, the mauve guard robot heads south.

>z
Jones stands around and waits.

The mauve guard robot approaches from the north.

>z
Jones stands around and waits.

The robot slaughters Jones.

    *** The End ***

In that game you scored 0 out of a possible 0, in 32 turns.

Would you like to RESTART, RESTORE a saved game, QUIT, or UNDO the last command?

* * *

>n
Galaxy Jones is in the tenth floor elevator hall. 

The mauve guard robot appears to the south, heading east.

>w
Galaxy Jones is in the elevator car.

* * *

>s
Galaxy Jones is in the tenth floor elevator hall.

>w
Galaxy Jones is in the elevator car.

>u
Galaxy Jones is on the top of the elevator car.

>d
Galaxy Jones is in the elevator car.

>n
Jones can't go that way. The obvious exits are east (to the tenth floor elevator hall) and up (to the top of the elevator car).

>e
Galaxy Jones is in the tenth floor elevator hall.

>n
Galaxy Jones is on the north side of the Consolidated Microthings office.

>w
Galaxy Jones is at the northwest corner of the Consolidated Microthings office. 

Jones sees the mauve guard robot to the south.

>e
Galaxy Jones is on the north side of the Consolidated Microthings office.

>s
Galaxy Jones is in the tenth floor elevator hall. 

The mauve guard robot approaches from the south.
The robot slaughters Jones.

    *** The End ***

In that game you scored 0 out of a possible 0, in 12 turns.

Would you like to RESTART, RESTORE a saved game, QUIT, or UNDO the last command?

>undo
the north side of the Consolidated Microthings office
[Previous turn undone.]

>w
Galaxy Jones is at the northwest corner of the Consolidated Microthings office.

>s
Galaxy Jones is on the west side of the Consolidated Microthings office.

>s
Galaxy Jones is at the southwest corner of the Consolidated Microthings office.

>e
Galaxy Jones is on the south side of the Consolidated Microthings office. 

The mauve guard robot appears to the north, heading south.

>w
Galaxy Jones is at the southwest corner of the Consolidated Microthings office. 

The mauve guard robot appears to the east, heading south.

>restart
Are you sure you want to restart?

* * *

>gonear air
(the air handling room)
Galaxy Jones is in the air handling room.

>w
(first opening the air handling door)

Galaxy Jones is on the north side of the Consolidated Microthings office.

>w
Galaxy Jones is at the northwest corner of the Consolidated Microthings office. 

Jones sees the mauve guard robot to the south.

* * *

>e
Galaxy Jones is on the north side of the Consolidated Microthings office.

>w
Galaxy Jones is at the northwest corner of the Consolidated Microthings office.

* * *

>s
Galaxy Jones is at the southwest corner of the Consolidated Microthings office.

>n
Galaxy Jones is on the west side of the Consolidated Microthings office.

>n
Galaxy Jones is at the northwest corner of the Consolidated Microthings office.

>e
Galaxy Jones is on the north side of the Consolidated Microthings office.

>s
Galaxy Jones is in the tenth floor elevator hall.

* * *

>w
Galaxy Jones is in the elevator car.

>e
Galaxy Jones is in the tenth floor elevator hall.

>s
Galaxy Jones is on the south side of the Consolidated Microthings office. 

Jones sees the mauve guard robot to the west.

* * *

>n
Galaxy Jones is on the north side of the Consolidated Microthings office. 

The mauve guard robot appears to the south, heading north.

>w
Galaxy Jones is at the northwest corner of the Consolidated Microthings office. 

The mauve guard robot appears to the east, heading north.

* * *

>e
Galaxy Jones is at the southeast corner of the Consolidated Microthings office. 

To the west, the mauve guard robot heads east.

>n
Galaxy Jones is on the east side of the Consolidated Microthings office. 

The mauve guard robot appears to the south, heading east.

* * *

>z
Jones stands around and waits.

>w
Galaxy Jones is on the north side of the Consolidated Microthings office.

>w
Galaxy Jones is at the northwest corner of the Consolidated Microthings office.

>z
Jones stands around and waits.

The mauve guard robot appears to the east, heading north.

>e
Galaxy Jones is on the north side of the Consolidated Microthings office. 

The robot slaughters Jones.

    *** The End ***

In that game you scored 0 out of a possible 0, in 32 turns.

Would you like to RESTART, RESTORE a saved game, QUIT, or UNDO the last command?

>undo
the northwest corner of the Consolidated Microthings office
[Previous turn undone.]

>s
Galaxy Jones is on the west side of the Consolidated Microthings office. 

The mauve guard robot appears to the north, heading west.

* * *

>d
Galaxy Jones is in the elevator car.

>u
Galaxy Jones is on the top of the elevator car.

* * *

>scope
1: an elevator car (791499)
2: Jones (787627)
3: a disruptor pistol (787659)
4: a mauve guard robot (790475)
5: you, the player (787371)

>shoot robot
[** Programming error: tried to find the "." of (something) **]

>rules
Rules tracing now switched on. Type "rules off" to switch it off again, or "rules all" to include even rules which do not apply.

[Rule "clear LPR rule" applies.]

>shoot robot
[Rule "After deciding the scope of the player when the location is top of the elevator car" applies.]
[Rule "After deciding the scope of the player" applies.]
[Rule "After deciding the scope of the player" applies.]
[Rule "declare everything initially unmentioned rule" applies.]
[Rule "Rule for supplying a missing second noun while shooting" applies.]
[Rule "After deciding the scope of the player when the location is top of the elevator car" applies.]
[Rule "After deciding the scope of the player" applies.]
[Rule "After deciding the scope of the player" applies.]
[Rule "assign alternative door targets rule" applies.]
[Rule "announce items from multiple object lists rule" applies.]
[Rule "set pronouns from items from multiple object lists rule" applies.]
[Rule "before stage rule" applies.]

[** Programming error: tried to find the "." of (something) **]
[Rule "Rule for reaching inside the elevator car-room when the location is top of the elevator and the mauve guard robot is in the elevator car-room" applies.]
[Rule "keychain-aware carrying requirements rule" applies.]
[Rule "instead stage rule" applies.]
[Rule "investigate player's awareness before action rule" applies.]
[Rule "player aware of his own actions rule" applies.]
[Rule "check stage rule" applies.]
[Rule "Check shooting something with the disruptor pistol" applies.]
[Rule "carry out stage rule" applies.]
[Rule "after stage rule" applies.]
[Rule "investigate player's awareness after action rule" applies.]
[Rule "report stage rule" applies.]
[Rule "last specific action-processing rule" applies.]
[Rule "A first turn sequence rule" applies.]
[Rule "every turn stage rule" applies.]
[Rule "A last turn sequence rule" applies.]
[Rule "new notify score changes rule" applies.]
[Rule "clear LPR rule" applies.]

* * *

>z
Jones stands around and waits.

* * *

>e
Galaxy Jones is on the north side of the Consolidated Microthings office.

>e
Galaxy Jones is in the air handling room.

>se
Jones can't go that way. The obvious exits are west (to the north side of the consolidated microthings office) and inside.

>zz
That's not a verb I recognise.

>z
Jones stands around and waits.

>w
Galaxy Jones is on the north side of the Consolidated Microthings office. 

To the south, the mauve guard robot heads north.

>se
Galaxy Jones is on the east side of the Consolidated Microthings office. 

The mauve guard robot appears to the northwest, heading north.

>s
Galaxy Jones is at the southeast corner of the Consolidated Microthings office. 

The mauve guard robot appears to the north, heading southeast.

>w
Galaxy Jones is on the south side of the Consolidated Microthings office. 

The mauve guard robot appears to the east, heading south.

>n
Galaxy Jones is in the tenth floor elevator hall. 

The mauve guard robot appears to the south, heading west.

>w
Galaxy Jones is in the elevator car. 

The mauve guard robot appears to the east, heading north.

>u
Galaxy Jones is on the top of the elevator car.

>shoot robot
You must supply a second noun.

>shoot mauve guard robot with pistol
There's nothing like that nearby.

>undo
top of the elevator car
[Previous turn undone.]

>undo
top of the elevator car
[Previous turn undone.]

>shoot mauve guard robot with pistol
There's nothing like that nearby.

>showme mauve
mauve guard robot - guard robot
location: in the elevator car
singular-named, improper-named, unused; unlit, inedible, portable, male, female, nomale, unseen, unfamiliar, enemy; list grouping key: none
printed name: "mauve guard robot"
printed plural name: "guard robots"
indefinite article: none
most recent reference: nominal
third singular pronoun: Singular-they-pronoun
conversation: none
description: "Definitely not a friendly android. More of a spiny killer with a disruptor barrel mounted on its head."
initial appearance: none
third-plural-pronoun: They-pronoun
carrying capacity: 100
first-singular-pronoun: I-pronoun
first-plural-pronoun: We-pronoun
second-singular-pronoun: Singular-you-pronoun
second-plural-pronoun: Plural-you-pronoun
notable action: doing nothing
original location: tenth floor elevator hall
new location: elevator car
goal: elevator car
homebase: the southwest corner of the Consolidated Microthings office

>scope
1: a mauve guard robot (819864)
2: you, the player (816760)

>x robot
Definitely not a friendly android. More of a spiny killer with a disruptor barrel mounted on its head.

>shoot robot
You must supply a second noun.

>shoot robot with disruptor
There's nothing like that nearby.

>i
Jones is carrying:
  a disruptor pistol

>undo
top of the elevator car
[Previous turn undone.]

>scope
1: you, the player (816760)

>undo
top of the elevator car
[Previous turn undone.]

>undo
elevator car
[Previous turn undone.]

>u
Galaxy Jones is on the top of the elevator car.

>scope
1: a mauve guard robot (819864)
2: you, the player (816760)

>fire pistol at guard
There's nothing like that nearby.

>undo
top of the elevator car
[Previous turn undone.]

>actions
Actions listing on.

>fire pistol at guard
There's nothing like that nearby.

* * *

>undo
top of the elevator car
[Previous turn undone.]

>scope
1: a mauve guard robot (819864)
2: you, the player (816760)

>actions off
Actions listing off.

>trace 5
[Parser tracing set to level 5.]

>fire pistol at guard
[ "fire" fire / "pistol" pistol / "at" at / "guard" guard ]
[Parsing for the verb 'fire' (3 lines)]

[line 0 * 'at' noun -> A89_shooting_it_with]
 [line 0 token 1 word 2 : 'at']
  [token resulted in failure with error type 1]

[line 1 * held 'at' noun -> A89_shooting_it_with reverse]
 [line 1 token 1 word 2 : held]
  [Object list from word 2]
   [NounDomain called at word 2
   seeking definite object
    Trying the mauve guard robot (819864) at word 2
Parse_name called
Pass 1: 0 Pass 2: 0 Pass 3: 0
    Trying you, the player (816760) at word 2
Parse_name called
Pass 1: 0 Pass 2: 0 Pass 3: 0
   [ND made 0 matches]
  [token resulted in failure with error type 5]

[line 2 * 'at' noun 'with' held -> A89_shooting_it_with]
 [line 2 token 1 word 2 : 'at']
  [token resulted in failure with error type 1]
There's nothing like that nearby.

>undo
top of the elevator car
[Previous turn undone.]

>shoot guard with pistol
[ "shoot" shoot / "guard" guard / "with" with / "pistol" pistol ]
[Parsing for the verb 'shoot' (3 lines)]

[line 0 * Routine(492078) noun -> A89_shooting_it_with]
 [line 0 token 1 word 2 : Routine(492078)]
  [Outside parsing routine returned 0]
  [token resulted in success]
 [line 0 token 2 word 2 : noun]
  [Object list from word 2]
  [Calling NounDomain on location and actor]
   [NounDomain called at word 2
   seeking definite object
    Trying the mauve guard robot (819864) at word 2
Parse_name called
Pass 1: 1 Pass 2: 1 Pass 3: 1
    Matched (1)
    Trying you, the player (816760) at word 2
Parse_name called
Pass 1: 0 Pass 2: 0 Pass 3: 0
   [ND made 1 matches]
  [ND returned the mauve guard robot]
  [token resulted in success]
 [line 0 token 3 word 3 : END]

[line 1 * held 'at' noun -> A89_shooting_it_with reverse]
 [line 1 token 1 word 2 : held]
  [Object list from word 2]
   [NounDomain called at word 2
   seeking definite object
    Trying the mauve guard robot (819864) at word 2
Parse_name called
Pass 1: 1 Pass 2: 1 Pass 3: 1
    Matched (1)
    Trying you, the player (816760) at word 2
Parse_name called
Pass 1: 0 Pass 2: 0 Pass 3: 0
   [ND made 1 matches]
  [Allowing object the mauve guard robot for now]
  [token resulted in success]
 [line 1 token 2 word 3 : 'at']
  [token resulted in failure with error type 1]

[line 2 * Routine(492121) noun 'with' held -> A89_shooting_it_with]
 [line 2 token 1 word 2 : Routine(492121)]
  [Outside parsing routine returned 0]
  [token resulted in success]
 [line 2 token 2 word 2 : noun]
  [Object list from word 2]
  [Calling NounDomain on location and actor]
   [NounDomain called at word 2
   seeking definite object
    Trying the mauve guard robot (819864) at word 2
Parse_name called
Pass 1: 1 Pass 2: 1 Pass 3: 1
    Matched (1)
    Trying you, the player (816760) at word 2
Parse_name called
Pass 1: 0 Pass 2: 0 Pass 3: 0
   [ND made 1 matches]
  [ND returned the mauve guard robot]
  [token resulted in success]
 [line 2 token 3 word 3 : 'with']
  [token resulted in success]
 [line 2 token 4 word 4 : held]
  [Object list from word 4]
   [NounDomain called at word 4
   seeking definite object
    Trying the mauve guard robot (819864) at word 4
Parse_name called
Pass 1: 0 Pass 2: 0 Pass 3: 0
    Trying you, the player (816760) at word 4
Parse_name called
Pass 1: 0 Pass 2: 0 Pass 3: 0
   [ND made 0 matches]
  [token resulted in failure with error type 5]
There's nothing like that nearby.

* * *

>e
Galaxy Jones is on the north side of the Consolidated Microthings office.

>s
Galaxy Jones is in the tenth floor elevator hall. 

The mauve guard robot appears to the north, heading east.

>s
Galaxy Jones is on the south side of the Consolidated Microthings office. 

The mauve guard robot is not far to the west.

The guard robot moves east.

The mauve guard robot arrives from the west.

>n
Galaxy Jones is in the tenth floor elevator hall. 

The mauve guard robot is not far to the south.

The guard robot moves north.

The mauve guard robot arrives from the south.

>w
Galaxy Jones is in the elevator car. 

The mauve guard robot is not far to the east.

The guard robot moves west.

The mauve guard robot arrives from the east.

>e
Galaxy Jones is in the tenth floor elevator hall. 

The mauve guard robot is not far to the west.

The guard robot moves east.

The mauve guard robot arrives from the west.

>n
Galaxy Jones is on the north side of the Consolidated Microthings office. 

The mauve guard robot is not far to the south.

The guard robot moves north.

The mauve guard robot arrives from the south.

* * *

>n
Galaxy Jones is in the tenth floor elevator hall. 

The mauve guard robot is not far to the south.

The guard robot moves north.

The mauve guard robot arrives from the south.

>z
Jones stands around and waits.

* * *

>s
Galaxy Jones is in the tenth floor elevator hall. 

The mauve guard robot appears to the north, heading east.

>w
Galaxy Jones is in the elevator car. 

The mauve guard robot appears to the east, heading south.

>u
Galaxy Jones is on the top of the elevator car.

>showme mauve
mauve guard robot - guard robot
location: in the elevator car
singular-named, improper-named, unused; unlit, inedible, portable, male, female, nomale, unseen, unfamiliar, enemy; list grouping key: none
printed name: "mauve guard robot"
printed plural name: "guard robots"
indefinite article: none
most recent reference: nominal
third singular pronoun: Singular-they-pronoun
conversation: none
description: "Definitely not a friendly android. More of a spiny killer with a disruptor barrel mounted on its head."
initial appearance: none
third-plural-pronoun: They-pronoun
carrying capacity: 100
first-singular-pronoun: I-pronoun
first-plural-pronoun: We-pronoun
second-singular-pronoun: Singular-you-pronoun
second-plural-pronoun: Plural-you-pronoun
notable action: doing nothing
original location: tenth floor elevator hall
new location: elevator car
goal: elevator car
homebase: the west side of the Consolidated Microthings office

>z
Jones stands around and waits.

>showme mauve
mauve guard robot - guard robot
location: in the elevator car
singular-named, improper-named, unused; unlit, inedible, portable, male, female, nomale, unseen, unfamiliar, enemy; list grouping key: none
printed name: "mauve guard robot"
printed plural name: "guard robots"
indefinite article: none
most recent reference: nominal
third singular pronoun: Singular-they-pronoun
conversation: none
description: "Definitely not a friendly android. More of a spiny killer with a disruptor barrel mounted on its head."
initial appearance: none
third-plural-pronoun: They-pronoun
carrying capacity: 100
first-singular-pronoun: I-pronoun
first-plural-pronoun: We-pronoun
second-singular-pronoun: Singular-you-pronoun
second-plural-pronoun: Plural-you-pronoun
notable action: doing nothing
original location: tenth floor elevator hall
new location: elevator car
goal: the west side of the Consolidated Microthings office
homebase: the west side of the Consolidated Microthings office

>z
Jones stands around and waits.

>showme mauve
mauve guard robot - guard robot
location: in the tenth floor elevator hall
singular-named, improper-named, unused; unlit, inedible, portable, male, female, nomale, unseen, unfamiliar, enemy; list grouping key: none
printed name: "mauve guard robot"
printed plural name: "guard robots"
indefinite article: none
most recent reference: nominal
third singular pronoun: Singular-they-pronoun
conversation: none
description: "Definitely not a friendly android. More of a spiny killer with a disruptor barrel mounted on its head."
initial appearance: none
third-plural-pronoun: They-pronoun
carrying capacity: 100
first-singular-pronoun: I-pronoun
first-plural-pronoun: We-pronoun
second-singular-pronoun: Singular-you-pronoun
second-plural-pronoun: Plural-you-pronoun
notable action: doing nothing
original location: elevator car
new location: tenth floor elevator hall
goal: the west side of the Consolidated Microthings office
homebase: the west side of the Consolidated Microthings office

* * *

>w
Galaxy Jones is in the elevator car. 

The mauve guard robot appears to the east, heading south.

>z
Jones stands around and waits.

The mauve guard robot arrives from the south.

>e
Galaxy Jones is on the north side of the Consolidated Microthings office. 

The mauve guard robot is not far to west.

The mauve guard robot arrives from the west.

>se
Galaxy Jones is on the east side of the Consolidated Microthings office. 

The mauve guard robot is not far to northwest.

The mauve guard robot arrives from the northwest.

>nw
Galaxy Jones is on the north side of the Consolidated Microthings office. 

The mauve guard robot is not far to southeast.

The mauve guard robot arrives from the southeast.

>e
Galaxy Jones is in the air handling room.

* * *

>w
Galaxy Jones is on the north side of the Consolidated Microthings office.

>rules
Rules tracing now switched on. Type "rules off" to switch it off again, or "rules all" to include even rules which do not apply.

[Rule "clear LPR rule" applies.]

* * *

>e
Galaxy Jones is on the north side of the Consolidated Microthings office.

>se
Galaxy Jones is on the east side of the Consolidated Microthings office.

>nw
Galaxy Jones is on the north side of the Consolidated Microthings office.

>s
Galaxy Jones is in the tenth floor elevator hall.

* * *

>u
Galaxy Jones is on the top of the elevator car.

>d
Galaxy Jones is in the elevator car. 

The robot slaughters Jones.

    *** The End ***

In that game you scored 0 out of a possible 0, in 10 turns.

Would you like to RESTART, RESTORE a saved game, QUIT, or UNDO the last command?

>undo
top of the elevator car
[Previous turn undone.]

>touch robot
[** Programming error: tried to find the "." of (something) **]
The mauve guard robot might not like that.

>undo
top of the elevator car
[Previous turn undone.]

>rules
Rules tracing now switched on. Type "rules off" to switch it off again, or "rules all" to include even rules which do not apply.

[Rule "clear LPR rule" applies.]

>touch robot
[Rule "After deciding the scope of the player when the location is top of the elevator car" applies.]
[Rule "After deciding the scope of the player" applies.]
[Rule "After deciding the scope of the player" applies.]
[Rule "After deciding the scope of the player" applies.]
[Rule "declare everything initially unmentioned rule" applies.]
[Rule "assign alternative door targets rule" applies.]
[Rule "announce items from multiple object lists rule" applies.]
[Rule "set pronouns from items from multiple object lists rule" applies.]
[Rule "before stage rule" applies.]
[Rule "Before doing something" applies.]

[** Programming error: tried to find the "." of (something) **]
[Rule "Rule for reaching inside the elevator car-room when the location is top of the elevator and the mauve guard robot is in the elevator car-room" applies.]
[Rule "keychain-aware carrying requirements rule" applies.]
[Rule "instead stage rule" applies.]
[Rule "investigate player's awareness before action rule" applies.]
[Rule "player aware of his own actions rule" applies.]
[Rule "check stage rule" applies.]
[Rule "carry out stage rule" applies.]
[Rule "after stage rule" applies.]
[Rule "investigate player's awareness after action rule" applies.]
[Rule "report stage rule" applies.]
[Rule "report touching yourself rule" applies.]
[Rule "report touching other people rule" applies.]
The mauve guard robot might not like that.
[Rule "last specific action-processing rule" applies.]

[Rule "A first turn sequence rule" applies.]
[Rule "every turn stage rule" applies.]
[Rule "Every turn when the mauve guard robot is in the tenth-floor-region" applies.]
[Rule "A last turn sequence rule" applies.]
[Rule "new notify score changes rule" applies.]
[Rule "show us the people rule" applies.]
[Rule "clear LPR rule" applies.]

* * *

>rules 5
I only understood you as far as wanting to rules.
[Rule "clear LPR rule" applies.]

* * *

>u
Galaxy Jones is on the top of the elevator car.

>jump
Jones jumps on the spot.

>undo
top of the elevator car
[Previous turn undone.]

* * *

>rules
Rules tracing now switched on. Type "rules off" to switch it off again, or "rules all" to include even rules which do not apply.

[Rule "clear LPR rule" applies.]

>jump
[Rule "declare everything initially unmentioned rule" applies.]
[Rule "assign alternative door targets rule" applies.]
[Rule "announce items from multiple object lists rule" applies.]
[Rule "set pronouns from items from multiple object lists rule" applies.]
[Rule "before stage rule" applies.]
[Rule "Before doing something" applies.]
[Rule "keychain-aware carrying requirements rule" applies.]
[Rule "instead stage rule" applies.]
[Rule "investigate player's awareness before action rule" applies.]
[Rule "player aware of his own actions rule" applies.]
[Rule "check stage rule" applies.]
[Rule "carry out stage rule" applies.]
[Rule "after stage rule" applies.]
[Rule "investigate player's awareness after action rule" applies.]
[Rule "report stage rule" applies.]
[Rule "report jumping rule" applies.]
Jones jumps on the spot.
[Rule "last specific action-processing rule" applies.]

[Rule "A first turn sequence rule" applies.]
[Rule "every turn stage rule" applies.]
[Rule "Every turn when the mauve guard robot is in the tenth-floor-region" applies.]
[Rule "A last turn sequence rule" applies.]
[Rule "new notify score changes rule" applies.]
[Rule "show us the people rule" applies.]
[Rule "clear LPR rule" applies.]

* * *

>scope
1: a mauve guard robot (819864)
2: you, the player (816760)

>shoot guard robot
You must supply a second noun.

>shoot guard robot with pistol
There's nothing like that nearby.

>x pistol
There's nothing like that nearby.

>i
Jones is carrying:
  a disruptor pistol

>scope
1: you, the player (816760)

>d
That's not a verb I recognise.

>d
That's not a verb I recognise.

>down
That's not a verb I recognise.

>go down
There's nothing like that nearby.

>u
That's not a verb I recognise.

>e
That's not a verb I recognise.

>w
That's not a verb I recognise.

>x me
You, the player, issue the commands to make Galaxy Jones go.

>x you
There's nothing like that nearby.

>x joes
There's nothing like that nearby.

>x jones
There's nothing like that nearby.

* * *

>u
Galaxy Jones is on the top of the elevator car.

>shoot robot
PronounNotice1PronounNotice2
[** Programming error: tried to find the "." of (something) **]

>rules
Rules tracing now switched on. Type "rules off" to switch it off again, or "rules all" to include even rules which do not apply.

[Rule "clear LPR rule" applies.]

* * *

>undo
top of the elevator car
[Previous turn undone.]

* * *

>shoot robot
PronounNotice1PronounNotice2
[** Programming error: tried to find the "." of (something) **]

>scope
1: an elevator car (821144)
2: Jones (817272)
3: a disruptor pistol (817304)
4: a mauve guard robot (820120)
5: you, the player (817016)

>rules
Rules tracing now switched on. Type "rules off" to switch it off again, or "rules all" to include even rules which do not apply.

[Rule "clear LPR rule" applies.]

* * *

>shoot robot
PronounNotice1PronounNotice2
[** Programming error: tried to find the "." of (something) **]

>touch me
Jones can't see 'me' (nothing) at the moment.

* * *

>shoot robot
PronounNotice1PronounNotice2
[** Programming error: tried to find the "." of (something) **]

>undo
top of the elevator car
[Previous turn undone.]

* * *

>rules
Rules tracing now switched on. Type "rules off" to switch it off again, or "rules all" to include even rules which do not apply.

[Rule "clear LPR rule" applies.]

>shoot robot
[Rule "After deciding the scope of the player when the location is top of the elevator car" applies.]
[Rule "After deciding the scope of the player" applies.]
[Rule "After deciding the scope of the player" applies.]
[Rule "After deciding the scope of the player" applies.]
[Rule "declare everything initially unmentioned rule" applies.]
[Rule "Rule for supplying a missing second noun while shooting" applies.]
[Rule "After deciding the scope of the player when the location is top of the elevator car" applies.]
[Rule "After deciding the scope of the player" applies.]
[Rule "After deciding the scope of the player" applies.]
[Rule "After deciding the scope of the player" applies.]
[Rule "assign alternative door targets rule" applies.]
[Rule "announce items from multiple object lists rule" applies.]
[Rule "set pronouns from items from multiple object lists rule" applies.]
[Rule "before stage rule" applies.]
[Rule "Before doing something" applies.]
foobar

[** Programming error: tried to find the "." of (something) **]
[Rule "Rule for reaching inside the elevator car-room" applies.]
[Rule "keychain-aware carrying requirements rule" applies.]
[Rule "instead stage rule" applies.]
[Rule "investigate player's awareness before action rule" applies.]
[Rule "player aware of his own actions rule" applies.]
[Rule "check stage rule" applies.]
[Rule "Check shooting something with the disruptor pistol" applies.]
[Rule "carry out stage rule" applies.]
[Rule "after stage rule" applies.]
[Rule "investigate player's awareness after action rule" applies.]
[Rule "report stage rule" applies.]
[Rule "last specific action-processing rule" applies.]
[Rule "A first turn sequence rule" applies.]
[Rule "every turn stage rule" applies.]
[Rule "Every turn when the mauve guard robot is in the tenth-floor-region" applies.]
[Rule "A last turn sequence rule" applies.]
[Rule "new notify score changes rule" applies.]
[Rule "show us the people rule" applies.]
[Rule "clear LPR rule" applies.]

* * *

>u
Galaxy Jones is on the top of the elevator car.

>touch me
[** Programming error: tried to find the "." of (something) **]
Jones, or the narrator (that's the one who's talking right now), are unable to interact with you in any way, other than via keyboard and text, that is.

>x me
You, the player, issue the commands to make Galaxy Jones go.

>i
Jones is carrying:
  a disruptor pistol

>touch me
[** Programming error: tried to find the "." of (something) **]
Jones, or the narrator (that's the one who's talking right now), are unable to interact with you in any way, other than via keyboard and text, that is.

>scope
1: an elevator car (821144)
2: Jones (817272)
3: a disruptor pistol (817304)
4: you, the player (817016)

>jump
Jones jumps on the spot.

* * *

>x me
You, the player, issue the commands to make Galaxy Jones go.

>touch me
[** Programming error: tried to find the "." of (something) **]
Jones, or the narrator (that's the one who's talking right now), are unable to interact with you in any way, other than via keyboard and text, that is.

>touch me
[** Programming error: tried to find the "." of (something) **]
Jones, or the narrator (that's the one who's talking right now), are unable to interact with you in any way, other than via keyboard and text, that is.

>showme
top of the elevator car - room
    elevator car - backdrop
    Jones - person
        disruptor pistol

>scope
1: an elevator car (808952)
2: Jones (805080)
3: a disruptor pistol (805112)
4: you, the player (804824)

* * *

>u
Galaxy Jones is on the top of the elevator car.

>touch robot
considering the mauve guard robot

[** Programming error: tried to find the "." of (something) **]
The mauve guard robot might not like that.

>touch me
considering you, the player

[** Programming error: tried to find the "." of (something) **]
Jones, or the narrator (that's the one who's talking right now), are unable to interact with you in any way, other than via keyboard and text, that is.

* * *

>touch robot
considering the mauve guard robot

[** Programming error: tried to find the "." of (something) **]
The mauve guard robot might not like that.

>undo
top of the elevator car
[Previous turn undone.]

>shoot robot
[Rule "After deciding the scope of the player when the location is top of the elevator car" applies.]
[Rule "After deciding the scope of the player" applies.]
[Rule "After deciding the scope of the player" applies.]
[Rule "After deciding the scope of the player" applies.]
[Rule "declare everything initially unmentioned rule" applies.]
[Rule "Rule for supplying a missing second noun while shooting" applies.]
[Rule "After deciding the scope of the player when the location is top of the elevator car" applies.]
[Rule "After deciding the scope of the player" applies.]
[Rule "After deciding the scope of the player" applies.]
[Rule "After deciding the scope of the player" applies.]
[Rule "assign alternative door targets rule" applies.]
[Rule "announce items from multiple object lists rule" applies.]
[Rule "set pronouns from items from multiple object lists rule" applies.]
[Rule "before stage rule" applies.]
[Rule "Before doing something" applies.]

[** Programming error: tried to find the "." of (something) **]
[Rule "Rule for reaching inside the elevator car-room when the location is top of the elevator and the mauve guard robot is in the elevator car-room" applies.]
[Rule "keychain-aware carrying requirements rule" applies.]
[Rule "instead stage rule" applies.]
[Rule "investigate player's awareness before action rule" applies.]
[Rule "player aware of his own actions rule" applies.]
[Rule "check stage rule" applies.]
[Rule "Check shooting something with the disruptor pistol" applies.]
[Rule "carry out stage rule" applies.]
[Rule "after stage rule" applies.]
[Rule "investigate player's awareness after action rule" applies.]
[Rule "report stage rule" applies.]
[Rule "last specific action-processing rule" applies.]
[Rule "A first turn sequence rule" applies.]
[Rule "every turn stage rule" applies.]
[Rule "Every turn when the mauve guard robot is in the tenth-floor-region" applies.]
[Rule "A last turn sequence rule" applies.]
[Rule "new notify score changes rule" applies.]
[Rule "show us the people rule" applies.]
[Rule "clear LPR rule" applies.]

>undo
top of the elevator car
[Previous turn undone.]

* * *

>u
Galaxy Jones is on the top of the elevator car.

>x pistol
There's nothing like that nearby.

>scope
1: a mauve guard robot (819864)
2: you, the player (816760)

>d
That's not a verb I recognise.

>r
That's not a verb I recognise.

>gonear air
(the air handling room)
Galaxy Jones is in the air handling room.

>w
Galaxy Jones is on the north side of the Consolidated Microthings office. 

The mauve guard robot appears to the south, heading east.

>s
Galaxy Jones is in the tenth floor elevator hall. 

The robot slaughters Jones.

    *** The End ***

In that game you scored 0 out of a possible 0, in 12 turns.

Would you like to RESTART, RESTORE a saved game, QUIT, or UNDO the last command?

>undo
the north side of the Consolidated Microthings office
[Previous turn undone.]

>e
Galaxy Jones is in the air handling room.

* * *

>z
Jones stands around and waits.

>w
Galaxy Jones is on the north side of the Consolidated Microthings office. 

The mauve guard robot appears to the south, heading east.

>w
Galaxy Jones is at the northwest corner of the Consolidated Microthings office. 

The mauve guard robot appears to the south, heading west.

>e
Galaxy Jones is on the north side of the Consolidated Microthings office. 

The mauve guard robot appears to the south, heading east.

>se
Galaxy Jones is on the east side of the Consolidated Microthings office. 

The mauve guard robot appears to the south, heading east.

>nw
Galaxy Jones is on the north side of the Consolidated Microthings office. 

The mauve guard robot appears to the southeast, heading north.

>s
Galaxy Jones is in the tenth floor elevator hall. 

The mauve guard robot appears to the north, heading northwest.

>w
Galaxy Jones is in the elevator car. 

The mauve guard robot appears to the east, heading south.

* * *

>u
Galaxy Jones is on the top of the elevator car.

>d
That's not a verb I recognise.

>restart
Are you sure you want to restart?

* * *

>d
That's not a verb I recognise.

>trace 5
[Parser tracing set to level 5.]

>d
[ "d" d ]
   [NounDomain called at word 1
   seeking definite object
    Trying you, the player (816760) at word 1
Parse_name called
Pass 1: 0 Pass 2: 0 Pass 3: 0
   [ND made 0 matches]
That's not a verb I recognise.

>restart
[ "restart" restart ]
[Parsing for the verb 'restart' (1 lines)]

[line 0 * -> Restart]
 [line 0 token 1 word 2 : END]
[Line successfully parsed]
Are you sure you want to restart?

* * *

>gonear air
(the air handling room)
Galaxy Jones is in the air handling room.

>scope
1: an air handling door (820088)
2: Jones (817016)
3: a vent access door (820152)
4: a disruptor pistol (817048)
5: you, the player (816760)

>x door
Which do you mean, the air handling door or the vent access door?

>w
I only understood you as far as wanting to examine west.

>w
(first opening the air handling door)

Galaxy Jones is on the north side of the Consolidated Microthings office.

* * *

>u
Galaxy Jones is on the top of the elevator car.

>u
That's not a verb I recognise.

>d
That's not a verb I recognise.

>e
That's not a verb I recognise.

* * *

>e
Galaxy Jones is on the north side of the Consolidated Microthings office.

>w
Galaxy Jones is at the northwest corner of the Consolidated Microthings office. 

The mauve guard robot appears to the south, heading west.

* * *

>e
Galaxy Jones is on the north side of the Consolidated Microthings office. 

The mauve guard robot appears to the south, heading east.

>e
Galaxy Jones is in the air handling room.

* * *

>se
Jones can't go that way. The obvious exits are west (to the north side of the consolidated microthings office) and inside.

>w
Galaxy Jones is on the north side of the Consolidated Microthings office. 

The robot slaughters Jones.

    *** The End ***

In that game you scored 0 out of a possible 0, in 9 turns.

Would you like to RESTART, RESTORE a saved game, QUIT, or UNDO the last command?

* * *

>nw
Galaxy Jones is on the north side of the Consolidated Microthings office. 

The mauve guard robot appears to the southeast, heading north.

>w
Galaxy Jones is at the northwest corner of the Consolidated Microthings office. 

The mauve guard robot appears to the east, heading northwest.

>s
Galaxy Jones is on the west side of the Consolidated Microthings office. 

The mauve guard robot appears to the north, heading west.

>s
Galaxy Jones is at the southwest corner of the Consolidated Microthings office. 

Also here is a present.

To the north, the mauve guard robot heads south.

>take present
Taken.

The mauve guard robot approaches from the north.
The robot slaughters Jones.

    *** The End ***

In that game you scored 0 out of a possible 0, in 12 turns.

Would you like to RESTART, RESTORE a saved game, QUIT, or UNDO the last command?

>undo
the southwest corner of the Consolidated Microthings office
[Previous turn undone.]

>e
Galaxy Jones is on the south side of the Consolidated Microthings office. 

The mauve guard robot appears to the west, heading south.

>n
Galaxy Jones is in the tenth floor elevator hall. 

The mauve guard robot appears to the south, heading east.

>w
Galaxy Jones is in the elevator car. 

The mauve guard robot appears to the east, heading north.

* * *

>u
Galaxy Jones is on the top of the elevator car.

>shoot mauve robot
There's nothing like that nearby.

* * *

>w
Galaxy Jones is at the northwest corner of the Consolidated Microthings office. 

Jones sees the mauve guard robot to the south.

>e
Galaxy Jones is on the north side of the Consolidated Microthings office. 

The mauve guard robot appears to the west, heading north.

>s
Galaxy Jones is in the tenth floor elevator hall. 

The mauve guard robot appears to the north, heading east.

* * *

>w
Galaxy Jones is at the northwest corner of the Consolidated Microthings office. 

The mauve guard robot appears to the south, heading west.

>s
Galaxy Jones is on the west side of the Consolidated Microthings office.

>s
Galaxy Jones is at the southwest corner of the Consolidated Microthings office. 

Also here is a present.

>take present
Taken.

>e
Galaxy Jones is on the south side of the Consolidated Microthings office. 

The mauve guard robot approaches from the north.
The robot slaughters Jones.

    *** The End ***

In that game you scored 0 out of a possible 0, in 9 turns.

Would you like to RESTART, RESTORE a saved game, QUIT, or UNDO the last command?

>undo
the southwest corner of the Consolidated Microthings office
[Previous turn undone.]

>n
Galaxy Jones is on the west side of the Consolidated Microthings office.

>n
Galaxy Jones is at the northwest corner of the Consolidated Microthings office. 

The mauve guard robot appears to the south, heading west.

>e
Galaxy Jones is on the north side of the Consolidated Microthings office.

* * *

>undo
the north side of the Consolidated Microthings office
[Previous turn undone.]

>showme maube
There seems to be no such object anywhere in the model world.

>showme mauve
mauve guard robot - guard robot
location: in the south side of the Consolidated Microthings office
singular-named, improper-named, unused; unlit, inedible, portable, male, female, nomale, unseen, unfamiliar, enemy; list grouping key: none
printed name: "mauve guard robot"
printed plural name: "guard robots"
indefinite article: none
most recent reference: nominal
third singular pronoun: Singular-they-pronoun
conversation: none
description: "Definitely not a friendly android. More of a spiny killer with a disruptor barrel mounted on its head."
initial appearance: none
third-plural-pronoun: They-pronoun
carrying capacity: 100
first-singular-pronoun: I-pronoun
first-plural-pronoun: We-pronoun
second-singular-pronoun: Singular-you-pronoun
second-plural-pronoun: Plural-you-pronoun
notable action: doing nothing
original location: the southwest corner of the Consolidated Microthings office
new location: the south side of the Consolidated Microthings office
goal: the north side of the Consolidated Microthings office
homebase: the southwest corner of the Consolidated Microthings office

>undo
the north side of the Consolidated Microthings office
[Previous turn undone.]

>s
Galaxy Jones is in the tenth floor elevator hall. 

The mauve guard robot approaches from the south.
The robot slaughters Jones.

    *** The End ***

In that game you scored 0 out of a possible 0, in 12 turns.

Would you like to RESTART, RESTORE a saved game, QUIT, or UNDO the last command?

* * *

>undo
the north side of the Consolidated Microthings office
[Previous turn undone.]

>showme mauve
mauve guard robot - guard robot
location: in the south side of the Consolidated Microthings office
singular-named, improper-named, unused; unlit, inedible, portable, male, female, nomale, unseen, unfamiliar, enemy; list grouping key: none
printed name: "mauve guard robot"
printed plural name: "guard robots"
indefinite article: none
most recent reference: nominal
third singular pronoun: Singular-they-pronoun
conversation: none
description: "Definitely not a friendly android. More of a spiny killer with a disruptor barrel mounted on its head."
initial appearance: none
third-plural-pronoun: They-pronoun
carrying capacity: 100
first-singular-pronoun: I-pronoun
first-plural-pronoun: We-pronoun
second-singular-pronoun: Singular-you-pronoun
second-plural-pronoun: Plural-you-pronoun
notable action: doing nothing
original location: the southwest corner of the Consolidated Microthings office
new location: the south side of the Consolidated Microthings office
goal: the north side of the Consolidated Microthings office
homebase: the southwest corner of the Consolidated Microthings office

* * *

>undo
the north side of the Consolidated Microthings office
[Previous turn undone.]

>undo
the north side of the Consolidated Microthings office
[Previous turn undone.]

>undo
the northwest corner of the Consolidated Microthings office
[Previous turn undone.]

>e
Galaxy Jones is on the north side of the Consolidated Microthings office.

>showme mauve
mauve guard robot - guard robot
location: in the south side of the Consolidated Microthings office
singular-named, improper-named, unused; unlit, inedible, portable, male, female, nomale, unseen, unfamiliar, enemy; list grouping key: none
printed name: "mauve guard robot"
printed plural name: "guard robots"
indefinite article: none
most recent reference: nominal
third singular pronoun: Singular-they-pronoun
conversation: none
description: "Definitely not a friendly android. More of a spiny killer with a disruptor barrel mounted on its head."
initial appearance: none
third-plural-pronoun: They-pronoun
carrying capacity: 100
first-singular-pronoun: I-pronoun
first-plural-pronoun: We-pronoun
second-singular-pronoun: Singular-you-pronoun
second-plural-pronoun: Plural-you-pronoun
notable action: doing nothing
original location: the southwest corner of the Consolidated Microthings office
new location: the south side of the Consolidated Microthings office
goal: the north side of the Consolidated Microthings office
homebase: the southwest corner of the Consolidated Microthings office

* * *

>take present
Taken.

>n
Galaxy Jones is on the west side of the Consolidated Microthings office.

* * *

>z
Jones stands around and waits.

>x present
There seems to be nothing special about it.

>w
Galaxy Jones is on the north side of the Consolidated Microthings office. 

The robot slaughters Jones.

    *** The End ***

In that game you scored 0 out of a possible 0, in 15 turns.

Would you like to RESTART, RESTORE a saved game, QUIT, or UNDO the last command?

>undo
air handling room
[Previous turn undone.]

>z
Jones stands around and waits.

* * *

>w
Galaxy Jones is on the north side of the Consolidated Microthings office.

>s
Galaxy Jones is in the tenth floor elevator hall.

* * *

>w
Galaxy Jones is in the elevator car. 

The mauve guard robot appears to the east, heading north.

>z
Jones stands around and waits.

The mauve guard robot approaches from the east.
The robot slaughters Jones.

    *** The End ***

In that game you scored 0 out of a possible 0, in 24 turns.

Would you like to RESTART, RESTORE a saved game, QUIT, or UNDO the last command?

>undo
elevator car
[Previous turn undone.]

* * *

>u
Galaxy Jones is on the top of the elevator car.

>look down
Jones sees the elevator car in that direction.

>showme mauve
mauve guard robot - guard robot
location: in the elevator car
singular-named, improper-named, unused; unlit, inedible, portable, male, female, nomale, unseen, unfamiliar, enemy; list grouping key: none
printed name: "mauve guard robot"
printed plural name: "guard robots"
indefinite article: none
most recent reference: nominal
third singular pronoun: Singular-they-pronoun
conversation: none
description: "Definitely not a friendly android. More of a spiny killer with a disruptor barrel mounted on its head."
initial appearance: none
third-plural-pronoun: They-pronoun
carrying capacity: 100
first-singular-pronoun: I-pronoun
first-plural-pronoun: We-pronoun
second-singular-pronoun: Singular-you-pronoun
second-plural-pronoun: Plural-you-pronoun
notable action: doing nothing
original location: tenth floor elevator hall
new location: elevator car
goal: the southwest corner of the Consolidated Microthings office

>z
Jones stands around and waits.

>showme mauve
mauve guard robot - guard robot
location: in the tenth floor elevator hall
singular-named, improper-named, unused; unlit, inedible, portable, male, female, nomale, unseen, unfamiliar, enemy; list grouping key: none
printed name: "mauve guard robot"
printed plural name: "guard robots"
indefinite article: none
most recent reference: nominal
third singular pronoun: Singular-they-pronoun
conversation: none
description: "Definitely not a friendly android. More of a spiny killer with a disruptor barrel mounted on its head."
initial appearance: none
third-plural-pronoun: They-pronoun
carrying capacity: 100
first-singular-pronoun: I-pronoun
first-plural-pronoun: We-pronoun
second-singular-pronoun: Singular-you-pronoun
second-plural-pronoun: Plural-you-pronoun
notable action: doing nothing
original location: elevator car
new location: tenth floor elevator hall
goal: the southwest corner of the Consolidated Microthings office

>z
Jones stands around and waits.

>showme mauve
mauve guard robot - guard robot
location: in the south side of the Consolidated Microthings office
singular-named, improper-named, unused; unlit, inedible, portable, male, female, nomale, unseen, unfamiliar, enemy; list grouping key: none
printed name: "mauve guard robot"
printed plural name: "guard robots"
indefinite article: none
most recent reference: nominal
third singular pronoun: Singular-they-pronoun
conversation: none
description: "Definitely not a friendly android. More of a spiny killer with a disruptor barrel mounted on its head."
initial appearance: none
third-plural-pronoun: They-pronoun
carrying capacity: 100
first-singular-pronoun: I-pronoun
first-plural-pronoun: We-pronoun
second-singular-pronoun: Singular-you-pronoun
second-plural-pronoun: Plural-you-pronoun
notable action: doing nothing
original location: tenth floor elevator hall
new location: the south side of the Consolidated Microthings office
goal: the southwest corner of the Consolidated Microthings office

>z
Jones stands around and waits.

>showme mauve
mauve guard robot - guard robot
location: in the southwest corner of the Consolidated Microthings office
singular-named, improper-named, unused; unlit, inedible, portable, male, female, nomale, unseen, unfamiliar, enemy; list grouping key: none
printed name: "mauve guard robot"
printed plural name: "guard robots"
indefinite article: none
most recent reference: nominal
third singular pronoun: Singular-they-pronoun
conversation: none
description: "Definitely not a friendly android. More of a spiny killer with a disruptor barrel mounted on its head."
initial appearance: none
third-plural-pronoun: They-pronoun
carrying capacity: 100
first-singular-pronoun: I-pronoun
first-plural-pronoun: We-pronoun
second-singular-pronoun: Singular-you-pronoun
second-plural-pronoun: Plural-you-pronoun
notable action: doing nothing
original location: the south side of the Consolidated Microthings office
new location: the southwest corner of the Consolidated Microthings office
goal: the southwest corner of the Consolidated Microthings office

>i
Jones is carrying:
  a present
  a disruptor pistol

* * *

>e
Galaxy Jones is on the north side of the Consolidated Microthings office.

>z
Jones stands around and waits.

>e
Galaxy Jones is in the air handling room.

>w
Galaxy Jones is on the north side of the Consolidated Microthings office.

>se
Galaxy Jones is on the east side of the Consolidated Microthings office.

>s
Galaxy Jones is at the southeast corner of the Consolidated Microthings office. 

The mauve guard robot is on the other end of the building to the west.

The guard robot moves east.

>n
Galaxy Jones is on the east side of the Consolidated Microthings office.

>s
Galaxy Jones is at the southeast corner of the Consolidated Microthings office. 

The mauve guard robot is on the other end of the building to the west.

The guard robot moves east.

>w
Galaxy Jones is on the south side of the Consolidated Microthings office. 

Also here is a mauve guard robot.

The robot slaughters Jones.

The mauve guard robot goes west.

    *** The End ***

In that game you scored 0 out of a possible 0, in 12 turns.

Would you like to RESTART, RESTORE a saved game, QUIT, or UNDO the last command?

* * *

>z
Jones stands around and waits.

>undo
the north side of the Consolidated Microthings office
[Previous turn undone.]

>se
Galaxy Jones is on the east side of the Consolidated Microthings office. 

The mauve guard robot is not far to northwest.

The mauve guard robot arrives from the northwest.

>s
Galaxy Jones is at the southeast corner of the Consolidated Microthings office. 

The mauve guard robot is not far to north.

The mauve guard robot arrives from the north.

* * *

>w
Galaxy Jones is at the northwest corner of the Consolidated Microthings office. 

Jones sees the mauve guard robot to the south.

>restart
Are you sure you want to restart?

* * *

>gonear air
(the air handling room)
Galaxy Jones is in the air handling room.

>rules
Rules tracing now switched on. Type "rules off" to switch it off again, or "rules all" to include even rules which do not apply.

[Rule "clear LPR rule" applies.]

>w
[Rule "After deciding the scope of the player" applies.]
[Rule "After deciding the scope of the player" applies.]
[Rule "After deciding the scope of the player" applies.]
[Rule "declare everything initially unmentioned rule" applies.]
[Rule "standard set going variables rule" applies.]
[Rule "assign alternative door targets rule" applies.]
[Rule "announce items from multiple object lists rule" applies.]
[Rule "set pronouns from items from multiple object lists rule" applies.]
[Rule "before stage rule" applies.]
[Rule "opening doors before entering rule" applies.]
(first opening the air handling door)
[Rule "assign alternative door targets rule" applies.]
[Rule "announce items from multiple object lists rule" applies.]
[Rule "set pronouns from items from multiple object lists rule" applies.]
[Rule "before stage rule" applies.]
[Rule "Before doing something" applies.]
[Rule "keychain-aware carrying requirements rule" applies.]
[Rule "instead stage rule" applies.]
[Rule "investigate player's awareness before action rule" applies.]
[Rule "player aware of his own actions rule" applies.]
[Rule "check stage rule" applies.]
[Rule "can't open unless openable rule" applies.]
[Rule "can't open what's locked rule" applies.]
[Rule "can't open what's already open rule" applies.]
[Rule "carry out stage rule" applies.]
[Rule "standard opening rule" applies.]
[Rule "after stage rule" applies.]
[Rule "investigate player's awareness after action rule" applies.]
[Rule "report stage rule" applies.]
[Rule "last specific action-processing rule" applies.]
[Rule "Before doing something" applies.]
[Rule "keychain-aware carrying requirements rule" applies.]
[Rule "instead stage rule" applies.]
[Rule "investigate player's awareness before action rule" applies.]
[Rule "player aware of his own actions rule" applies.]
[Rule "check stage rule" applies.]
[Rule "can't travel in what's not a vehicle rule" applies.]
[Rule "can't go through undescribed doors rule" applies.]
[Rule "can't go through closed doors rule" applies.]
[Rule "determine map connection rule" applies.]
[Rule "can't go that way rule" applies.]
[Rule "carry out stage rule" applies.]
[Rule "move player and vehicle rule" applies.]
[Rule "move floating objects rule" applies.]
[Rule "check light in new location rule" applies.]
[Rule "after stage rule" applies.]
[Rule "After going somewhere when the player is in tenth-floor-region and the mauve guard robot is somewhere" applies.]
[Rule "A first turn sequence rule" applies.]
[Rule "every turn stage rule" applies.]
[Rule "Every turn when the mauve guard robot is in the tenth-floor-region" applies.]
[Rule "A last turn sequence rule" applies.]
[Rule "new notify score changes rule" applies.]
[Rule "show us the people rule" applies.]
[Rule "clear LPR rule" applies.]

>w
[Rule "After deciding the scope of the player" applies.]
[Rule "After deciding the scope of the player" applies.]
[Rule "After deciding the scope of the player" applies.]
[Rule "declare everything initially unmentioned rule" applies.]
[Rule "standard set going variables rule" applies.]
[Rule "assign alternative door targets rule" applies.]
[Rule "announce items from multiple object lists rule" applies.]
[Rule "set pronouns from items from multiple object lists rule" applies.]
[Rule "before stage rule" applies.]
[Rule "Before going somewhere when the player is in tenth-floor-region and the mauve guard robot is somewhere" applies.]

[** Programming error:  (object number 816076)  has no property component_parent to write **]

[** Programming error:  (object number 816076)  has no property component_sibling to write **]
[Rule "Before doing something" applies.]
[Rule "keychain-aware carrying requirements rule" applies.]
[Rule "instead stage rule" applies.]
[Rule "investigate player's awareness before action rule" applies.]
[Rule "player aware of his own actions rule" applies.]
[Rule "check stage rule" applies.]
[Rule "can't travel in what's not a vehicle rule" applies.]
[Rule "can't go through undescribed doors rule" applies.]
[Rule "can't go through closed doors rule" applies.]
[Rule "determine map connection rule" applies.]
[Rule "can't go that way rule" applies.]
[Rule "carry out stage rule" applies.]
[Rule "move player and vehicle rule" applies.]
[Rule "move floating objects rule" applies.]
[Rule "check light in new location rule" applies.]
[Rule "after stage rule" applies.]
[Rule "After going somewhere when the player is in tenth-floor-region and the mauve guard robot is somewhere" applies.]
[Rule "A first turn sequence rule" applies.]
[Rule "every turn stage rule" applies.]
[Rule "Every turn when the mauve guard robot is in the tenth-floor-region" applies.]
[Rule "A last turn sequence rule" applies.]
[Rule "new notify score changes rule" applies.]
[Rule "show us the people rule" applies.]
Jones sees the mauve guard robot to the south. 

[Rule "clear LPR rule" applies.]

* * *

>w
Galaxy Jones is at the northwest corner of the Consolidated Microthings office. 

Jones sees the mauve guard robot to the south.

>s
Jones sees the mauve guard robot to the south.

>s
The robot slaughters Jones.

    *** The End ***

In that game you scored 0 out of a possible 0, in 5 turns.

Would you like to RESTART, RESTORE a saved game, QUIT, or UNDO the last command?

>e
Galaxy Jones is on the south side of the Consolidated Microthings office. 

Jones see the mauve guard robot to the west.

>e
Galaxy Jones is at the southeast corner of the Consolidated Microthings office. 

Jones see the mauve guard robot to the west.

>ne
Jones can't go that way. The obvious exits are north and west (to the south side of the consolidated microthings office).

Jones see the mauve guard robot to the west.

>n
Galaxy Jones is on the east side of the Consolidated Microthings office.

>nw
Galaxy Jones is on the north side of the Consolidated Microthings office.

* * *

>e
Galaxy Jones is on the south side of the Consolidated Microthings office. 

Jones see the mauve guard robot to the west.

>w
Galaxy Jones is at the southwest corner of the Consolidated Microthings office. 

Also here is a mauve guard robot.

>z
Jones stands around and waits.

* * *

>s
The robot slaughters Jones.

    *** The End ***

In that game you scored 0 out of a possible 0, in 5 turns.

Would you like to RESTART, RESTORE a saved game, QUIT, or UNDO the last command?

>n
Galaxy Jones is on the west side of the Consolidated Microthings office. 

Jones sees the mauve guard robot to the south.

>n
Galaxy Jones is at the northwest corner of the Consolidated Microthings office. 

Jones sees the mauve guard robot to the south.

I beg your pardon?

* * *

I beg your pardon?

I beg your pardon?

>e
Galaxy Jones is on the north side of the Consolidated Microthings office.

* * *

>s
The robot slaughters Jones.

    *** The End ***

In that game you scored 0 out of a possible 0, in 5 turns.

Would you like to RESTART, RESTORE a saved game, QUIT, or UNDO the last command?

>z
Jones stands around and waits.

* * *

>w
Galaxy Jones is at the northwest corner of the Consolidated Microthings office. 

Jones sees the mauve guard robot to the south.

>z
Jones stands around and waits.

To the south, the mauve guard robot heads north.

>e
The mauve guard robot appears to the west, heading north.

>e
Galaxy Jones is in the air handling room.

>w
The robot slaughters Jones.

    *** The End ***

In that game you scored 0 out of a possible 0, in 7 turns.

Would you like to RESTART, RESTORE a saved game, QUIT, or UNDO the last command?

>undo
air handling room
[Previous turn undone.]

* * *

>z
Jones stands around and waits.

>w
The robot slaughters Jones.

    *** The End ***

In that game you scored 0 out of a possible 0, in 8 turns.

Would you like to RESTART, RESTORE a saved game, QUIT, or UNDO the last command?

>undo
air handling room
[Previous turn undone.]

* * *

>e
The mauve guard robot appears to the north, heading south.

* * *

>e
The mauve guard robot appears to the west, heading north.

>s
Galaxy Jones is in the tenth floor elevator hall. 

The mauve guard robot arrives from the north.

>w
Galaxy Jones is in the elevator car.

* * *

>gonear air handler
There seems to be no such object anywhere in the model world.

>gonear air
(the air handling room)
Galaxy Jones is in the air handling room.

* * *

>s
Galaxy Jones is in the tenth floor elevator hall.

>s
Galaxy Jones is on the south side of the Consolidated Microthings office. 

The mauve guard robot is not far to the west.

The guard robot moves east.

The mauve guard robot arrives from the west.

>e
Galaxy Jones is at the southeast corner of the Consolidated Microthings office. 

The mauve guard robot is not far to the west.

The guard robot moves east.

The mauve guard robot arrives from the west.

>n
Galaxy Jones is on the east side of the Consolidated Microthings office. 

The mauve guard robot is not far to the south.

The guard robot moves north.

The mauve guard robot arrives from the south.

>nw
Galaxy Jones is on the north side of the Consolidated Microthings office. 

The mauve guard robot is not far to the southeast.

The guard robot moves northwest.

The mauve guard robot arrives from the southeast.

>s
Galaxy Jones is in the tenth floor elevator hall. 

The mauve guard robot arrives from the north.

>z
Jones stands around and waits.

>l
Galaxy Jones is in the tenth floor elevator hall. 

Also here is a mauve guard robot.

>z
Jones stands around and waits.

>n
Galaxy Jones is on the north side of the Consolidated Microthings office.

>z
Jones stands around and waits.

* * *

>gonear air handling
(the air handling room)
Galaxy Jones is in the air handling room.

>w
(first opening the air handling door)

Galaxy Jones is on the north side of the Consolidated Microthings office.

>w
Galaxy Jones is at the northwest corner of the Consolidated Microthings office. 

The mauve guard robot is not far to south.

The mauve guard robot arrives from the south.

>e
Galaxy Jones is on the north side of the Consolidated Microthings office. 

The mauve guard robot is not far to west.

The mauve guard robot arrives from the west.

>s
Jones can't go that way. The obvious exits are southeast, east (to the air handling room) and west (to the northwest corner of the consolidated microthings office).

The mauve guard robot goes west.

>z
Jones stands around and waits.

The mauve guard robot arrives from the west.

* * *

>w
Galaxy Jones is at the northwest corner of the Consolidated Microthings office. 

The mauve guard robot is not far to south.

The mauve guard robot arrives from the south.

>s
Galaxy Jones is on the west side of the Consolidated Microthings office. 

Also here is a mauve guard robot.

>s
Galaxy Jones is at the southwest corner of the Consolidated Microthings office. 

The mauve guard robot is not far to north.

>e
Galaxy Jones is on the south side of the Consolidated Microthings office.

* * *

>gonear top of
PronounNotice1PronounNotice2Galaxy Jones is on the top of the elevator car.

>rules
Rules tracing now switched on. Type "rules off" to switch it off again, or "rules all" to include even rules which do not apply.

[Rule "clear LPR rule" applies.]

>touch me
[Rule "After deciding the scope of the player when the location is top of the elevator car" applies.]
[Rule "After deciding the scope of the player" applies.]
[Rule "After deciding the scope of the player" applies.]
[Rule "After deciding the scope of the player" applies.]
PronounNotice1[Rule "declare everything initially unmentioned rule" applies.]
[Rule "assign alternative door targets rule" applies.]
[Rule "announce items from multiple object lists rule" applies.]
[Rule "set pronouns from items from multiple object lists rule" applies.]
[Rule "before stage rule" applies.]
[Rule "Before doing something" applies.]

[** Programming error: tried to find the "." of (something) **]
[Rule "Rule for reaching inside the room of stuff" applies.]
[Rule "keychain-aware carrying requirements rule" applies.]
[Rule "instead stage rule" applies.]
[Rule "Instead of doing something other than examining to player-actual" applies.]
Jones, or the narrator (that's the one who's talking right now), are unable to interact with you in any way, other than via keyboard and text, that is.

[Rule "A first turn sequence rule" applies.]
[Rule "every turn stage rule" applies.]
[Rule "Every turn when the mauve guard robot is in the tenth-floor-region" applies.]
[Rule "A last turn sequence rule" applies.]
[Rule "new notify score changes rule" applies.]
[Rule "show us the people rule" applies.]
[Rule "clear LPR rule" applies.]

* * *

>gonear top of
PronounNotice1PronounNotice2Galaxy Jones is on the top of the elevator car.

>scope
1: an elevator car (807276)
2: Jones (803404)
3: a disruptor pistol (803436)
4: you, the player (803148)

* * *

>gonear top of
PronounNotice1PronounNotice2Galaxy Jones is on the top of the elevator car.

>showme me
you, the player - thing
location: in the room of stuff
singular-named, proper-named, unused; unlit, inedible, portable, neuter, unseen, unfamiliar
list grouping key: none
printed name: "you, the player"
printed plural name: none
indefinite article: none
most recent reference: nominal
third singular pronoun: It-pronoun
conversation: none
description: "You, the player, issue the commands to make Galaxy Jones go."
initial appearance: none
third-plural-pronoun: They-pronoun

>x me
You, the player, issue the commands to make Galaxy Jones go.

>showme me
you, the player - thing
location: in the room of stuff
singular-named, proper-named, unused; unlit, inedible, portable, neuter, seen, familiar
list grouping key: none
printed name: "you, the player"
printed plural name: none
indefinite article: none
most recent reference: nominal
third singular pronoun: It-pronoun
conversation: none
description: "You, the player, issue the commands to make Galaxy Jones go."
initial appearance: none
third-plural-pronoun: They-pronoun

>touch me
[** Programming error: tried to find the "." of (something) **]
Jones, or the narrator (that's the one who's talking right now), are unable to interact with you in any way, other than via keyboard and text, that is.

* * *

>gonear top of
PronounNotice1PronounNotice2Galaxy Jones is on the top of the elevator car.

>touch me
PronounNotice1
[** Programming error: tried to find the "." of (something) **]
Jones, or the narrator (that's the one who's talking right now), are unable to interact with you in any way, other than via keyboard and text, that is.

>d
Galaxy Jones is in the elevator car.

>touch me
[** Programming error: tried to find the "." of (something) **]
Jones, or the narrator (that's the one who's talking right now), are unable to interact with you in any way, other than via keyboard and text, that is.

>e
Galaxy Jones is in the tenth floor elevator hall.

>u
Jones can't go that way. The obvious exits are north, south, east and west (to the elevator car).

>touch me
[** Programming error: tried to find the "." of (something) **]
Jones, or the narrator (that's the one who's talking right now), are unable to interact with you in any way, other than via keyboard and text, that is.

>n
Galaxy Jones is on the north side of the Consolidated Microthings office.

>e
(first opening the air handling door)

Galaxy Jones is in the air handling room.

>touch me
[** Programming error: tried to find the "." of (something) **]
Jones, or the narrator (that's the one who's talking right now), are unable to interact with you in any way, other than via keyboard and text, that is.

* * *

>touch me
PronounNotice1
[** Programming error: tried to find the "." of (something) **]
Jones, or the narrator (that's the one who's talking right now), are unable to interact with you in any way, other than via keyboard and text, that is.

>gonear speeder
Which do you mean, the speeder dock or the speeder?

>dock
Galaxy Jones is in the speeder dock. A safe harbor from the periodic dust storms of Utopia Planitia, the dock features several dozen speeder bays. Only a few are filled right now. The building entryway is to the north, under a red stone façade carved into the likeness of a fearsome Viking.

Jones's speeder, Galaxy One, sits in one of the parking bays.

>touch me
Jones, or the narrator (that's the one who's talking right now), are unable to interact with you in any way, other than via keyboard and text, that is.

* * *

>touch me
PronounNotice1
[** Programming error: tried to find the "." of (something) **]
Jones, or the narrator (that's the one who's talking right now), are unable to interact with you in any way, other than via keyboard and text, that is.

>pronouns
At the moment, "it" means the speeder, "him" is unset, "her" means JonesPronounNotice1PronounNotice2, and "them" is unset.

>x me
PronounNotice1You, the player, issue the commands to make Galaxy Jones go.

>pronouns
At the moment, "it" means the speeder, "him" is unset, "her" means JonesPronounNotice1PronounNotice2, and "them" is unset.

* * *

>x jones
Galaxy Jones stands at the ready.

* * *

>touch me
[** Programming error: tried to find the "." of (something) **]
She can't reach into the room of stuff.

>i
She is carrying:
  a disruptor pistol

>touch pistol
She feels nothing unexpected.

>x me
You, the player, issue the commands to make Galaxy Jones go.

* * *

>x jones
Galaxy Jones stands at the ready.

>x me
You, the player, issue the commands to make Galaxy Jones go.

* * *

>gonear top of
PronounNotice1PronounNotice2Galaxy Jones is on the top of the elevator car.

>x me
You, the player, issue the commands to make Galaxy Jones go.

>x jones
Galaxy Jones stands at the ready.

* * *

>gonear top of the
 is on the top of the elevator car.

>touch me
[** Programming error: tried to find the "." of (something) **]
 can't reach into the room of stuff.

>x car
Jones is standing on top of the elevator car.

* * *

>l
Galaxy Jones is in the speeder dock. A safe harbor from the periodic dust storms of Utopia Planitia, the dock features several dozen speeder bays. Only a few are filled right now. The building entryway is to the north, under a red stone façade carved into the likeness of a fearsome Viking.

Jones's speeder, Galaxy One, sits in one of the parking bays.

fooJones's handler Beck comes over her headset. "Alright, what's going on?"

She replies, "I'm in the speeder dock. No movement. What can I expect inside?"

"Blueprints show the ground floor is one big empty space with elevators in the center. Not a lot of places for resistance to hide, but you can never tell. Be careful."

* * *

>n
Jones approaches the Viking Building entryway, the dramatic façade towering over her.

Galaxy Jones is at the entry doorway. A glass revolving door leads into a large open space north of here. The speeder dock is to the south.

Jones peers upwards at the 100 stories of glass and steel. "What do you want to bet Thallium's got Europa all the way at the top?"

Beck: "Oh, no doubt."

>n
Jones takes a deep breath. "I'm going in."

Beck replies, "Be careful, Galaxy."

Jones passes through the revolving door and into the lobby, alert to any defenses.

Galaxy Jones is in the lobby. The ground floor of the Viking Building is breathtaking. Low-G architecture means more glass and thinner supports, and the building takes advantage of that. Four walls of glass surround a central pillar in which are set the utility rooms and elevators. In between is an expanse of plants, water installations, and stylish seating. Near the entryway is a front desk. Above it floats, suspended on almost invisible cables, a giant crystal sculpture. She may go east and west from here, north to the elevators, or south out of the building.

>drop pistol
Before Jones gets a chance to do anything, two robot guards emerge from niches in the back wall! She dives behind the front desk and draws her disruptor pistol.

Jones shouts, "I'm under fire from two ugly robot things!"

Beck responds, "Monitoring lifesigns."

>drop pistol
That would be ill-advised.

The green robot tries to flank Jones, but a shot from her disruptor sends it scurrying back.

>purloin drop key
Which do you mean, the elevator drop key or the drop key hole?

>elevator
Which do you mean, the elevator drop key or the drop key hole?

>gonear control panel
Which do you mean, the elevator control panel or the scaffold control panel?

>elevator
Galaxy Jones is in the elevator room. This is a utility room related to the operation of the elevator, on the other side of the east wall here. There is a control panel on the wall, and a door leading west.

Hanging from a hook here is an elevator drop key.

Red and green guard robots criss-cross the lobby, stalking Jones.

>take key
As soon as Jones starts to act, an energy beam zips past her head, forcing her back down behind the desk.

The robots intone "Destroy Jones" in an eerie drone.

>shoot art
There's nothing like that nearby.

>purloin red key
[Purloined.]

>drop key
(the red key card)
Dropped.

The robots intone "Destroy Jones" in an eerie drone.

>drop key
Which do you mean, the red key card or the elevator drop key?

>drop key
Which do you mean, the red key card or the elevator drop key?

>drop
(the disruptor pistol)
That would be ill-advised.

The two robots coordinate fire over the desk, narrowly missing Jones.

>restart
Are you sure you want to restart?

* * *

>drop pistol
That would be ill-advised.

The green robot tries to flank Jones, but a shot from her disruptor sends it scurrying back.

>shoot red robot
(first taking the disruptor pistol)
As soon as Jones starts to act, an energy beam zips past her head, forcing her back down behind the desk.

The red robot tries to flank her, but a shot from her disruptor sends it scurrying back.

>i
Jones is carrying nothing.

One of the robots fires directly above her head.

>l
Galaxy Jones is in the lobby. The ground floor of the Viking Building is breathtaking. Low-G architecture means more glass and thinner supports, and the building takes advantage of that. Four walls of glass surround a central pillar in which are set the utility rooms and elevators. In between is an expanse of plants, water installations, and stylish seating. Near the entryway is a front desk. Above it floats, suspended on almost invisible cables, a giant crystal sculpture. Jones may go east and west from here, north to the elevators, or south out of the building. There are two niches in the central wall from which the guard robots emerged.

Also here is a disruptor pistol.

Red and green guard robots criss-cross the lobby, stalking her.

* * *

>shoot red robot
(first taking the disruptor pistol)
As soon as Jones starts to act, an energy beam zips past her head, forcing her back down behind the desk.

The red robot tries to flank her, but a shot from her disruptor sends it scurrying back.

>shoot red robot
(with the disruptor pistol)
(first taking the disruptor pistol)
As soon as Jones starts to act, an energy beam zips past her head, forcing her back down behind the desk.

Oof. Big miss.

The robots intone "Destroy Jones" in an eerie drone.

>shoot robot with pistol
Which do you mean, the green guard robot or the red guard robot?

>green
A barrage of fire from the robots prevents Jones from firing.

Zip! Disruptor fire scorches a nearby couch.

>i
Jones is carrying nothing.

* * *

>drop pistol
Before Jones gets a chance to do anything, two robot guards emerge from niches in the back wall! She dives behind the front desk and draws her disruptor pistol.

Jones shouts, "I'm under fire from two ugly robot things!"

Beck responds, "Monitoring lifesigns."

>g
Dropped.

>shoot red robot
(with the disruptor pistol)
(first taking the disruptor pistol)
As soon as Jones starts to act, an energy beam zips past her head, forcing her back down behind the desk.

(first taking the disruptor pistol)
As soon as she starts to act, an energy beam zips past her head, forcing her back down behind the desk.

The red robot fires a blistering shot into the front desk.

* * *

>s
Before Jones gets a chance to do anything, two robot guards emerge from niches in the back wall! She dives behind the front desk and draws her disruptor pistol.

Jones shouts, "I'm under fire from two ugly robot things!"

Beck responds, "Monitoring lifesigns."

>s
Trying to reach an exit would surely get Jones shot.

Jones: "I'm pinned down here!"

>shoot at red robot
Jones sticks her head out from behind the desk and squeezes off a shot at the red guard robot. In her haste it goes wide of the target.

The red robot fires a blistering shot into the front desk.

>shoot at red robot
A perfect shot! Yet, somehow, the robot is unscathed.

Jones: "Target seems to be absorbing disruptor fire. This will make things a little harder."

The green robot fires a blistering shot into the front desk.

>shoot art
Jones fires the disruptor into the sculpture's main support cable, snapping it. The huge crystal blob starts to sag, straining the other cables. In quick succession they break as well, and the whole installation plummets to the ground, right on top of the hapless guard robots.

Beck: "What was that crash? What's going on?"

Jones: "That, my friend, was what you'd call a work of art. Targets terminated."

 _________      __                     _____                     
 __/ ____/___ _/ /___ __  ____  __     __/ /___  ____  ___  _____
 _/ / __/ __ `/ / __ `/ |/ / / / /____ _/ / __ \/ __ \/ _ \/ ___/
 / /_/ / /_/ / / /_/ />  </ /_/ / _/ /_/ / /_/ / / / /  __(__  ) 
 \____/\__,_/_/\__,_/_/|_|\__, /  _\____/\____/_/ /_/\___/____/  
 _____________________________/ 

[Your score has just gone up by one point.]

>restart
Are you sure you want to restart?

>y
The phone rings. Galaxy Jones, the solar system's greatest hero, rolls over in bed and presses the talk button.

"Yes?" she says in a voice thick with sleep.

"Hello, is this Galaxy Jones?" comes the voice from the speaker.

"Yes, this is she. To whom am I speaking?"

"Oh, hi, Ms Jones. This is Patty, I work for Admiral P. X. Thallium, CEO of Diversified Entanglements, LLC. He asked me to forward a message to you."

"He did, did he? Now what would the Admiral want to say to me?"

"Oh, it's not from the Admiral himself. It's from one Miss Europa Callisto. I must say, the Admiral was quite surprised when I said I didn't know who she is. Apparently she's famous."

"Yes, quite famous, but why would she send a message to me, and why on Mars would she send it through Thallium? But never mind, what's the message?"

Patty can be heard rustling paper. "Let's see... it's here somewhere. Oh yes, here it is. The message is 'Help.'"

Ten minutes later, Galaxy Jones, in her speeder Galaxy One, races across the desolate expanse of Utopia Planitia, Mars. Her nemesis, the thoroughly execrable Admiral Thallium, has taken the exquisite Europa Callisto, singer and actress renowned throughout a dozen solar systems, hostage. As Patty has quite helpfully explained, Miss Callisto is imprisoned at the top of the Viking Building in New Reykjavik, guarded by an impressive number of killer robots and other diabolical instruments of Jones's inevitable demise. The Admiral has invited Ms Jones most cordially to break into his building and attempt a rescue.

"Oh I will," Galaxy mutters to herself. This time, she vows silently, Thallium won't escape.

Plus she'll get to meet Europa Callisto. That'll be totally sweet.

 _________      __                     _____                     
 __/ ____/___ _/ /___ __  ____  __     __/ /___  ____  ___  _____
 _/ / __/ __ `/ / __ `/ |/ / / / /____ _/ / __ \/ __ \/ _ \/ ___/
 / /_/ / /_/ / / /_/ />  </ /_/ / _/ /_/ / /_/ / / / /  __(__  ) 
 \____/\__,_/_/\__,_/_/|_|\__, /  _\____/\____/_/ /_/\___/____/  
 _____________________________/ 

An Interactive Fiction by Phil Riley
Release 1 / Serial number 230226 / Inform 7 build 6M62 (I6/v6.34 lib 6/12N) SD

A sleek dark red speeder roars into the dock of the Viking Building. A tall, strong woman in a battle-ready jumpsuit climbs out of it: Galaxy Jones.

Galaxy Jones is in the speeder dock. A safe harbor from the periodic dust storms of Utopia Planitia, the dock features several dozen speeder bays. Only a few are filled right now. The building entryway is to the north, under a red stone façade carved into the likeness of a fearsome Viking.

Jones's speeder, Galaxy One, sits in one of the parking bays.

* * *

>n
Jones approaches the Viking Building entryway, the dramatic façade towering over her.

Galaxy Jones is at the entry doorway. A glass revolving door leads into a large open space north of here. The speeder dock is to the south.

Jones peers upwards at the 100 stories of glass and steel. "What do you want to bet Thallium's got Europa all the way at the top?"

Beck: "Oh, no doubt."

>x door
A glass revolving door emblazoned with the symbol of a Viking kind astride the planet Mars.

>x door
A glass revolving door emblazoned with the symbol of a Viking kind astride the planet Mars.

>x doorway
The entryway is dominated by the towering façade of a Viking king, namesake of the building itself.

>x viking
The entryway is dominated by the towering façade of a Viking king, namesake of the building itself.

>n
Jones takes a deep breath. "I'm going in."

Beck replies, "Be careful, Galaxy."

Jones passes through the revolving door and into the lobby, alert to any defenses.

Galaxy Jones is in the lobby. The ground floor of the Viking Building is breathtaking. Low-G architecture means more glass and thinner supports, and the building takes advantage of that. Four walls of glass surround a central pillar in which are set the utility rooms and elevators. In between is an expanse of plants, water installations, and stylish seating. Near the entryway is a front desk. Above it floats, suspended on almost invisible cables, a giant crystal sculpture. She may go east and west from here, north to the elevators, or south out of the building.

>x red
There's nothing like that nearby.

>x viking
Before Jones gets a chance to do anything, two robot guards emerge from niches in the back wall! She dives behind the front desk and draws her disruptor pistol.

Jones shouts, "I'm under fire from two ugly robot things!"

Beck responds, "Monitoring lifesigns."

>x viking
The entryway (exit actually) leads out to the speeder dock.

Zip! Disruptor fire scorches a nearby couch.

>shoot robot
Who do you mean, the green guard robot or the red guard robot?

>green
Jones sticks her head out from behind the desk and squeezes off a shot at the green guard robot. In Jones's haste it goes wide of the target.

The two robots coordinate fire over the desk, narrowly missing her.

>g
Oof. Big miss.

>g
Jones sticks her head out from behind the desk and squeezes off a shot at the green guard robot. In Jones's haste it goes wide of the target.

>g
Jones's shot hits the green guard robot dead on, but nothing happens, almost as if the robot had absorbed the energy.

Jones: "Target seems to be absorbing disruptor fire. This will make things a little harder."

>g
Oops! Jones misses.

One of the robots fires directly above her head.

>g
Jones's shot hits the green guard robot dead on, but nothing happens, almost as if the robot had absorbed the energy.

>g
A barrage of fire from the robots prevents Jones from firing.

>g
Oof. Big miss.

The green robot fires a blistering shot into the front desk.

>shoot couch
Shooting that would accomplish nothing.

>shoot desk
Shooting that would accomplish nothing.

The robots intone "Destroy Jones" in an eerie drone.

>shoot art
Jones fires the disruptor into the sculpture's main support cable, snapping it. The huge crystal blob starts to sag, straining the other cables. In quick succession they break as well, and the whole installation plummets to the ground, right on top of the hapless guard robots.

Beck: "What was that crash? What's going on?"

Jones: "That, my friend, was what you'd call a work of art. Targets terminated."

 _________      __                     _____                     
 __/ ____/___ _/ /___ __  ____  __     __/ /___  ____  ___  _____
 _/ / __/ __ `/ / __ `/ |/ / / / /____ _/ / __ \/ __ \/ _ \/ ___/
 / /_/ / /_/ / / /_/ />  </ /_/ / _/ /_/ / /_/ / / / /  __(__  ) 
 \____/\__,_/_/\__,_/_/|_|\__, /  _\____/\____/_/ /_/\___/____/  
 _____________________________/ 

[Your score has just gone up by one point.]

>x art
Jones digs through the ruins and finds a thingy, which she takes.

>x art
Jones searches some more, but nothing further turns up.

>search art
Jones searches some more, but nothing further turns up.

>w
Jones crosses the floor carefully, disruptor pistol at the ready.

Galaxy Jones is at the southwest corner of the ground floor. A lush waterfall here contrasts with the dusty red streets of New Reykjavik beyond the glass walls. The ground floor extends north and east.

* * *

>x waterfall
The waterfall descends the length of an artificial rock formation fringed by wide-leaved Earth plants and ferns. The water collects in a basin at the bottom, where it begins its journey again. A single coin sits on the bottom of the basin.

>take coin
Taken.

>x waterfall
The waterfall descends the length of an artificial rock formation fringed by wide-leaved Earth plants and ferns. The water collects in a basin at the bottom, where it begins its journey again.

>n
Galaxy Jones is on the west side of the ground floor. Semicircular couches open on either side of a central carpeted path leading north and south. Set in the central pillar of the building to the east is a utility door. The city looms beyond the glass wall to the west.

>x couches
You can't use multiple objects with that verb.

>x couch
Which do you mean, the east semicircular couch or the west semicircular couch?

>east
An inoffensive beige couch, shaped in a half-circle, opening towards the west.

>x door
It's a white metal door, completely typical. It has a swipe card lock right above the handle.

>swipe card
That's not a verb I recognise.

>unlock door with card
There's nothing like that nearby.

>n
Galaxy Jones is at the northwest corner of the ground floor. A large relief map of mars is mounted on the north wall here. One can leave here to the south or east.

* * *

>x map
The map is crafted of bronze and sports a star at the site of New Reykjavik.

>e
Galaxy Jones is on the north side of the ground floor. The area is dominated by a towering statue of Admiral Thallium against the north wall. The ground floor extends west and east from here. The elevator is to the south.

* * *

>e
Galaxy Jones is at the northeast corner of the ground floor. The area is dedicated to celebrating the military career of Admiral Thallium. Uniforms, medals, ribbons, and other miscellanea are mounted on the wall or in showcases. All this despite the fact that no one has turned up any evidence that Thallium served in any navy of any country on any planet. One can escape to the west or south.

>x medal
Jones yawns looking over the assortment of faux honors. They're all behind glass, but one of the display cases is partly open, leaving the rather garish medal inside unprotected.

>x medal
(the medals, ribbons, and all)
Jones yawns looking over the assortment of faux honors. They're all behind glass, but one of the display cases is partly open, leaving the rather garish medal inside unprotected.

>take medal
(the garish medal)
Taken.

>x it
While the front looks authentic, the reverse is engraved with Thallium's personal motto "Planetas Vincam". The ribbon conceals a safety pin. It looks like it could be removed.

* * *

>take pin
Taken.

>x medal
(the garish medal)
While the front looks authentic, the reverse is engraved with Thallium's personal motto "Planetas Vincam". Earlier Jones removed the safety pin.

>s
Galaxy Jones is on the east side of the ground floor. Apparently some kind of function was happening here before Admiral Thallium emptied the building, for there is an array of canapes on a catering table here. The floor stretches north and south, and there's a closet door to the west.

>x table
The table is covered with a wide array of treats from the ridiculously expensive, such as shrimp tea sandwiches (where do you get shrimp on Mars?), to the just plain ridiculous, like poached ostrich eggs in jelly. A good number of forks are laid out to one side.

Jones: "Well, at least the Admiral treats his guests right. Except me. And Europa."

>take fork
Taken.

>take shrimp
Taken.

>take egg
There's nothing like that nearby.

>take eggs
Don't even.

>x eggs
Definitely not to Jones's taste.

Jones: "You ever have poached ostrich eggs, Beck?"

Beck: "No, but I'll take you for some when you're done there."

Jones: "Oh, thanks."

>w
(first opening the closet door)
(first unlocking the closet door)
Jones will have to enter the correct code on the keypad.

Jones: "Door on the east side has a keypad lock."

>type 0
(on the keypad)
An indicator light glows green.

Jones: "I've unlocked the east side utility door."

>w
(first opening the closet door)

Galaxy Jones is in the maintenance closet. 

There is an Atmo-Suit hanging from a hook here.

On the shelf is a red key card.

>take all
Atmo-Suit: Taken.
red key card: Taken.

>e
Galaxy Jones is on the east side of the ground floor. Apparently some kind of function was happening here before Admiral Thallium emptied the building, for there is an array of canapes on a catering table here. The floor stretches north and south, and there's a closet door to the west.

* * *

>s
Galaxy Jones is at the southeast corner of the ground floor. The centerpiece of this area is the actual Viking 2 lander, which landed right here on Utopia Planitia. The glass walls look out onto the city. Jones can go north or west from here.

>x lander
The lander is such a big, ungainly object it's hard to imagine it was once a pinnacle of human achievement.

>search it
Jones finds nothing of interest.

>w
Galaxy Jones is in the lobby. The ground floor of the Viking Building is breathtaking. Low-G architecture means more glass and thinner supports, and the building takes advantage of that. Four walls of glass surround a central pillar in which are set the utility rooms and elevators. In between is an expanse of plants, water installations, and stylish seating. Near the entryway is a front desk. Jones may go east and west from here, north to the elevators, or south out of the building. There are two niches in the central wall from which the guard robots emerged.

Spread across the floor in a tangled ruin are the remains of a giant crystal sculpture and two guard robots.

>w
Galaxy Jones is at the southwest corner of the ground floor. A lush waterfall here contrasts with the dusty red streets of New Reykjavik beyond the glass walls. The ground floor extends north and east.

* * *

>n
Galaxy Jones is on the west side of the ground floor. Semicircular couches open on either side of a central carpeted path leading north and south. Set in the central pillar of the building to the east is a utility door. The city looms beyond the glass wall to the west.

>e
(first opening the utility door)
(first unlocking the utility door)
(with the red key card)

Galaxy Jones is in the elevator room. This is a utility room related to the operation of the elevator, on the other side of the east wall here. There is a control panel on the wall, and a door leading west.

Hanging from a hook here is an elevator drop key.

>open door
(first unlocking the utility door)
Jones lacks a key that fits the utility door.

>i
Jones is carrying:
  a red key card
  an Atmo-Suit
  a shrimp tea sandwich
  a fork
  a safety pin
  a garish medal
  a coin
  a thingy
  a disruptor pistol

>unlock door with key card
The red key card does not fit the utility door.

* * *

>e
(first opening the utility door)
(first unlocking the utility door)
(with the red key card)

Galaxy Jones is in the elevator room. This is a utility room related to the operation of the elevator, on the other side of the east wall here. There is a control panel on the wall, and a door leading west.

Hanging from a hook here is an elevator drop key.

>take all
elevator drop key: Taken.

>x panel
From the looks of it, elevator technology hasn't evolved much since it was first developed. This control panel is a primitive collection of wires, circuit boards, indicator lights, and other components. It also seems to be completely inactive -- none of the lights are on.

>w
Galaxy Jones is on the west side of the ground floor. Semicircular couches open on either side of a central carpeted path leading north and south. Set in the central pillar of the building to the east is a utility door. The city looms beyond the glass wall to the west.

* * *

>s
Galaxy Jones is at the southwest corner of the ground floor. A lush waterfall here contrasts with the dusty red streets of New Reykjavik beyond the glass walls. The ground floor extends north and east.

>e
Galaxy Jones is in the lobby. The ground floor of the Viking Building is breathtaking. Low-G architecture means more glass and thinner supports, and the building takes advantage of that. Four walls of glass surround a central pillar in which are set the utility rooms and elevators. In between is an expanse of plants, water installations, and stylish seating. Near the entryway is a front desk. Jones may go east and west from here, north to the elevators, or south out of the building. There are two niches in the central wall from which the guard robots emerged.

Spread across the floor in a tangled ruin are the remains of a giant crystal sculpture and two guard robots.

>n
Galaxy Jones is in the ground floor elevator hall. This hallway between the north and south ends of the ground floor is home to the elevator to the west. To the east is the entrance to a stairwell.

>e
As soon as Jones enters the stairwell, a disruptor blast from above zings past her shoulder, and she beats a hasty retreat. She won't be going up the stairs until she can clear out the resistance, and she can't do that from here.

Galaxy Jones is in the ground floor elevator hall. This hallway between the north and south ends of the ground floor is home to the elevator to the west. To the east is the entrance to a stairwell.

>w
(first opening the elevator door)
Jones can't just open the elevator with her hands.

>open door
Jones can't just open the elevator with her hands.

>use elevator drop key
(the elevator drop key)
Jones inserts the elevator drop key into the drop key hole and turns it, disengaging the lock mechanism. Then she slides the door open.

>w
Jones climbs into the elevator shaft

Galaxy Jones is in the ground floor elevator shaft. She is at the bottom of a dark well. Shining her suit light up, she can see that the elevator car is several floors up, unmoving. There is a ladder on the west wall.

>u
Galaxy Jones is in the second floor elevator shaft.

>open door
Jones is unable to open the door. Perhaps it's blocked from the other side.

Jones: "No luck trying to open the elevator door."

Beck: "Try another."

Jones: "Thanks for the advice."

>u
Galaxy Jones is in the third floor elevator shaft.

>open door
Jones is unable to open the door. Perhaps it's blocked from the other side.

>u
Galaxy Jones is in the fourth floor elevator shaft.

>open door
Jones is unable to open the door. Perhaps it's blocked from the other side.

>u
Galaxy Jones is in the fifth floor elevator shaft.

>open door
Jones is unable to open the door. Perhaps it's blocked from the other side.

>u
Galaxy Jones is in the sixth floor elevator shaft.

>open door
Jones is unable to open the door. Perhaps it's blocked from the other side.

>u
Galaxy Jones is in the seventh floor elevator shaft.

>open door
Jones is unable to open the door. Perhaps it's blocked from the other side.

>u
Galaxy Jones is in the eighth floor elevator shaft.

>open door
Jones is unable to open the door. Perhaps it's blocked from the other side.

>u
Galaxy Jones is in the ninth floor elevator shaft.

>open door
Jones opens the ninth floor elevator door.

>e
Jones: "Finally out of the shaft. That was quite a climb."

Beck: "This floor is just offices. Check the building management office to the west. It might have some useful stuff."

 _________      __                     _____                     
 __/ ____/___ _/ /___ __  ____  __     __/ /___  ____  ___  _____
 _/ / __/ __ `/ / __ `/ |/ / / / /____ _/ / __ \/ __ \/ _ \/ ___/
 / /_/ / /_/ / / /_/ />  </ /_/ / _/ /_/ / /_/ / / / /  __(__  ) 
 \____/\__,_/_/\__,_/_/|_|\__, /  _\____/\____/_/ /_/\___/____/  
 _____________________________/ 

[Your score has just gone up by one point.]

>w
Galaxy Jones is in the ninth floor elevator shaft.

>e
Galaxy Jones is in the ninth floor elevator hall.

>n
Galaxy Jones is in the ninth floor north hallway.

>e
(first opening the Cybernetica door)
(first unlocking the Cybernetica door)
Jones lacks a key that fits the Cybernetica door.

>w
(first opening the north building management door)

Galaxy Jones is at the north end of the building management office.

>s
Galaxy Jones is at the south end of the building management office. 

A screwdriver sits atop the filing cabinet.

>e
(first opening the south building management door)

Galaxy Jones is in the ninth floor south hallway.

>s
Jones can't go that way. The obvious exits are north (to the ninth floor elevator hall), east and west (to the south end of the building management office).

>e
(first opening the Chronicle door)
(first unlocking the Chronicle door)
Jones lacks a key that fits the Chronicle door.

>w
Galaxy Jones is at the south end of the building management office. 

A screwdriver sits atop the filing cabinet.

>take screwdriver
Jones reaches for the screwdriver, but she fumbles it and it rolls off the back of the filing cabinet.

Jones: "Damn."

Beck: "What? What's going on?"

Jones: "Just being clumsy is all."

>look behind cabinet
(taking the screwdriver)
Jones reaches behind the cabinet to retrieve the screwdriver. A swipe and a hiss make her recoil.

Jones: "Holy --!"

Beck: "What now?"

Jones: "There's a cat here! Behind a filing cabinet. Gotta get behind there to get a screwdriver, so I need a way to drive off the cat."

>x cat
It's really a beautiful cat, sleek and black.

>look behind cabinet
(taking the screwdriver)
Forget it. Jones isn't getting another scratch.

>drop shrim[
There's nothing like that nearby.

>drop shrimp
Sensing food, the black cat pokes its head out, grabs the shrimp in its jaws, and races off.

Jones: "Aha! No creature is too fearsome for Galaxy Jones!"

Beck: "Congratulations on your victory."

 _________      __                     _____                     
 __/ ____/___ _/ /___ __  ____  __     __/ /___  ____  ___  _____
 _/ / __/ __ `/ / __ `/ |/ / / / /____ _/ / __ \/ __ \/ _ \/ ___/
 / /_/ / /_/ / / /_/ />  </ /_/ / _/ /_/ / /_/ / / / /  __(__  ) 
 \____/\__,_/_/\__,_/_/|_|\__, /  _\____/\____/_/ /_/\___/____/  
 _____________________________/ 

[Your score has just gone up by one point.]

>take screwdriver
Taken.

>n
Galaxy Jones is at the north end of the building management office.

>l
Galaxy Jones is at the north end of the building management office.

>x desk
There seems to be nothing special about it.

>open it
(first unlocking the large desk)
Jones lacks a key that fits the large desk.

>open it with pin
Jones pushes the pin into the keyhole and wiggles it around. After a few seconds the desk drawer pops open. It contains a black card key.

>take key
(the black card key)
Taken.

>e
Galaxy Jones is in the ninth floor north hallway.

>e
(first opening the Cybernetica door)
(first unlocking the Cybernetica door)
(with the black card key)

Galaxy Jones is in the Cybernetica office. It's spacious and luxurious, designed to make developers forget how spent they are from months of overwork and abuse. Ergonomic desks and chairs fill space like a furniture fractal, before giving way to an open area, presumably for group activities. At the south end of the room is a door labeled "Inspiration Chamber".

As soon as Jones steps into the office, a shot zaps just past her nose. She dives to the ground, protected by the maze of desks and chairs. Peeking through the mesh back of one of the chairs, she takes notice of both the purple guard robot training its disruptor on the room, and the chair's fine construction and lumbar support.

Jones (whispering): "We've got another one! I'm out of sight for now, but it's going to be hard to get a shot off at this 'bot."

Beck: "What's the situation?"

Jones: "I'm on the floor with desks and chairs all around. The target is a few yards off, coming this way. I might get a shot in, but it might just absorb it anyway."

Beck: "Well, see if you can sneak up on it. Maybe close up you can find a way past its defenses."

>shoot robot
Jones raises her head and fires wide. The robot fires back. Jones ducks and crawls off among the labyrinth of desks.

>shoot robot
Jones raises her head and fires wide. The robot fires back. Jones ducks and crawls off among the labyrinth of desks.

>sneak up on robot
Jones creeps a little ways toward the guard robot.

* * *

>sneak up on robot
Jones is right up next to the robot, crouched beneath a desk. She'll never get a better shot.

>shoot robot
Jones aims the pistol upward under the robot's enhanced armor. She flinches back when the robot's innards explode downward in a shower of sparks. It topples over, dead.

Jones: "Better than a video game. "

Beck: "Nice, but don't forget to credit your handler."

Jones: "Yes, yes, thanks for helping me not get killed."

Beck: "You're welcome."

 _________      __                     _____                     
 __/ ____/___ _/ /___ __  ____  __     __/ /___  ____  ___  _____
 _/ / __/ __ `/ / __ `/ |/ / / / /____ _/ / __ \/ __ \/ _ \/ ___/
 / /_/ / /_/ / / /_/ />  </ /_/ / _/ /_/ / /_/ / / / /  __(__  ) 
 \____/\__,_/_/\__,_/_/|_|\__, /  _\____/\____/_/ /_/\___/____/  
 _____________________________/ 

[Your score has just gone up by one point.]

>l
Galaxy Jones is in the Cybernetica office. It's spacious and luxurious, designed to make developers forget how spent they are from months of overwork and abuse. Ergonomic desks and chairs fill space like a furniture fractal, before giving way to an open area, presumably for group activities. At the south end of the room is a door labeled "Inspiration Chamber". One of the windows along the east side of the office is broken.

>s
Galaxy Jones is in the Inspiration Chamber. One of the most unique features of the office is the "inspiration chamber," a specialized room designed to stimulate creativity and innovation. The room is filled with advanced technology, including AI-generated art, interactive displays, and sensory stimulation devices that can help employees think outside the box and come up with new ideas.

Jones: "This is some real B.S. here."

Beck: "What's that?"

Jones: "Never mind."

>n
Galaxy Jones is in the Cybernetica office. It's spacious and luxurious, designed to make developers forget how spent they are from months of overwork and abuse. Ergonomic desks and chairs fill space like a furniture fractal, before giving way to an open area, presumably for group activities. At the south end of the room is a door labeled "Inspiration Chamber". One of the windows along the east side of the office is broken.

>search robot
There's nothing like that nearby.

>drop screwdriver
Dropped.

>e
Jones: "I'm going out the window to see if I can find a way to get up to the tenth floor."

Beck: "Whoa whoa whoa, Jones. You know you're not good with heights."

Jones: "Ask Thallium how how much that matters once I've kicked his ass."

(first donning the Atmo-Suit)
Jones climbs out the window.

Galaxy Jones is on a ledge.

>d
Jones can't go that way. The only obvious exit is west (to the cybernetica office).

>l
Galaxy Jones is on a ledge.

>look up
There's nothing in that direction.

>look east
There's nothing in that direction.

>look west
Jones sees the Cybernetica office in that direction.

>look down
Jones is afraid of heights.

>look down
Really, really afraid of heights.

>look down
Okay, fine. Jones look down, slowly, slowly... and there's a window cleaner's scaffold, about six feet below her.

Jones: "Okay, so. There's a window washing platform right below me. I might be able to drop down to it, but I won't be able to get back up."

Beck: "Careful, Jones."

>d
Jones drops off the ledge onto the scaffold. It rocks unnervingly for a moment.

Galaxy Jones is on a window washing scaffold. It's lined up with the eighth floor window. There doesn't seem to be any way to get into the building here. Mounted on the scaffold is a control panel with two buttons: one indicating up and one indicating down.

>press up button
Jones presses the button, and the scaffold begins to rise.

Galaxy Jones is on a window washing scaffold. It's lined up with the ninth floor window. She could climb back into the building through the window here. Mounted on the scaffold is a control panel with two buttons: one indicating up and one indicating down.

Jones: "Beck?"

Beck: "Yes?"

Jones: "I hate it out here."

Beck: "Well, there's the open window right next to you."

>press up button
Jones presses the button, and the scaffold begins to rise.

Galaxy Jones is on a window washing scaffold. It's lined up with the tenth floor. Instead of a window, there's what appears to be an exhaust vent. If it's for forced air, though, the fan is currently not running. Mounted on the scaffold is a control panel with two buttons: one indicating up and one indicating down.

Jones: "Alright, I'm by the tenth floor now. What's this grill thing here?"

Beck: "That's an exhaust vent. There's an air handling room on this floor which it leads into. If you can get the cover off you should be able to access the whole floor from here."

>press up button
Nothing happens.

>w
Jones can't go that way. There are no obvious exits.

>open vent
Jones will need to remove the screws.

>remove screws
(the exhaust vent)
Jones doesn't have anything to remove the screws with.

>unscrew exhaust vent
You must supply a second noun.

>w
Jones can't go that way. There are no obvious exits.

>press down button
Jones presses the button, and the scaffold begins to descend.

Galaxy Jones is on a window washing scaffold. It's lined up with the ninth floor window. She could climb back into the building through the window here. Mounted on the scaffold is a control panel with two buttons: one indicating up and one indicating down.

>w
Galaxy Jones is in the Cybernetica office. It's spacious and luxurious, designed to make developers forget how spent they are from months of overwork and abuse. Ergonomic desks and chairs fill space like a furniture fractal, before giving way to an open area, presumably for group activities. At the south end of the room is a door labeled "Inspiration Chamber". One of the windows along the east side of the office is broken.

Also here is a screwdriver.

Jones doffs the Atmo-Suit.

>take screwdriver
Taken.

>e
(first donning the Atmo-Suit)

Galaxy Jones is on a window washing scaffold. It's lined up with the ninth floor window. Jones could climb back into the building through the window here. Mounted on the scaffold is a control panel with two buttons: one indicating up and one indicating down.

>press up button
Jones presses the button, and the scaffold begins to rise.

Galaxy Jones is on a window washing scaffold. It's lined up with the tenth floor. Instead of a window, there's what appears to be an exhaust vent. If it's for forced air, though, the fan is currently not running. Mounted on the scaffold is a control panel with two buttons: one indicating up and one indicating down.

>remove screws
(the exhaust vent)
Jones loosens the screws and removes the grill from the vent.

>w
Jones climbs inside the vent, crawls along a short length of duct work, and emerges through another, hinged grill, into the air handling room.

Galaxy Jones is in the air handling room. 

Jones: "Ha! I'm in!"

Beck: "Be careful, you're likely to run into more resistance here. The floor is all one open office, so any guard robots will have good line of sight."

Jones: "Got it."

Beck: "And Jones? Save your game."

 _________      __                     _____                     
 __/ ____/___ _/ /___ __  ____  __     __/ /___  ____  ___  _____
 _/ / __/ __ `/ / __ `/ |/ / / / /____ _/ / __ \/ __ \/ _ \/ ___/
 / /_/ / /_/ / / /_/ />  </ /_/ / _/ /_/ / /_/ / / / /  __(__  ) 
 \____/\__,_/_/\__,_/_/|_|\__, /  _\____/\____/_/ /_/\___/____/  
 _____________________________/ 

[Your score has just gone up by one point.]

>w
(first opening the air handling door)

Galaxy Jones is on the north side of the Consolidated Microthings office.

* * *

>w
Galaxy Jones is at the northwest corner of the Consolidated Microthings office. 

Jones sees the mauve guard robot to the south.

>e
Galaxy Jones is on the north side of the Consolidated Microthings office. 

The mauve guard robot appears to the south, heading east.

* * *

>e
Galaxy Jones is in the air handling room.

>w
Galaxy Jones is on the north side of the Consolidated Microthings office. 

The mauve guard robot approaches from the south.
The robot slaughters Jones.

    *** The End ***

In that game you scored 5 out of a possible 0, in 150 turns.

Would you like to RESTART, RESTORE a saved game, QUIT, or UNDO the last command?

>undo
air handling room
[Previous turn undone.]

>undo
the north side of the Consolidated Microthings office
[Previous turn undone.]

>se
Galaxy Jones is on the east side of the Consolidated Microthings office. 

The mauve guard robot appears to the south, heading east.

* * *

>s
Galaxy Jones is at the southwest corner of the Consolidated Microthings office. 

Also here is a present.

To the north, the mauve guard robot heads south.

>e
Galaxy Jones is on the south side of the Consolidated Microthings office. 

The mauve guard robot appears to the west, heading south.

* * *

>u
Galaxy Jones is on the top of the elevator car.

>showme mauve
mauve guard robot - guard robot
location: in the elevator car
singular-named, improper-named, unused; unlit, inedible, portable, male, female, nomale, unseen, unfamiliar, enemy; list grouping key: none
printed name: "mauve guard robot"
printed plural name: "guard robots"
indefinite article: none
most recent reference: nominal
third singular pronoun: Singular-they-pronoun
conversation: none
description: "Definitely not a friendly android. More of a spiny killer with a disruptor barrel mounted on its head."
initial appearance: none
third-plural-pronoun: They-pronoun
carrying capacity: 100
first-singular-pronoun: I-pronoun
first-plural-pronoun: We-pronoun
second-singular-pronoun: Singular-you-pronoun
second-plural-pronoun: Plural-you-pronoun
notable action: doing nothing
original location: tenth floor elevator hall
new location: elevator car
goal: elevator car
homebase: the southwest corner of the Consolidated Microthings office

* * *

>rules
Rules tracing now switched on. Type "rules off" to switch it off again, or "rules all" to include even rules which do not apply.

[Rule "clear LPR rule" applies.]

>touch me
[Rule "After deciding the scope of the player" applies.]
[Rule "After deciding the scope of the player" applies.]
[Rule "After deciding the scope of the player" applies.]
[Rule "declare everything initially unmentioned rule" applies.]
[Rule "assign alternative door targets rule" applies.]
[Rule "announce items from multiple object lists rule" applies.]
[Rule "set pronouns from items from multiple object lists rule" applies.]
[Rule "before stage rule" applies.]
[Rule "Before doing something" applies.]
[Rule "Rule for reaching inside the room of stuff" applies.]
[Rule "keychain-aware carrying requirements rule" applies.]
[Rule "instead stage rule" applies.]
[Rule "Instead of doing something other than examining to player-actual" applies.]
Jones, or the narrator (that's the one who's talking right now), are unable to interact with you in any way, other than via keyboard and text, that is.

[Rule "A first turn sequence rule" applies.]
[Rule "every turn stage rule" applies.]
[Rule "Every turn when the mauve guard robot is in the tenth-floor-region" applies.]
[Rule "A last turn sequence rule" applies.]
[Rule "new notify score changes rule" applies.]
[Rule "show us the people rule" applies.]
[Rule "clear LPR rule" applies.]

* * *

>showme me
you, the player - thing
location: in the room of stuff
singular-named, proper-named, unused; unlit, inedible, portable, neuter, unseen, unfamiliar
list grouping key: none
printed name: "you, the player"
printed plural name: none
indefinite article: none
most recent reference: nominal
third singular pronoun: It-pronoun
conversation: none
description: "You, the player, issue the commands to make Galaxy Jones go."
initial appearance: none
third-plural-pronoun: They-pronoun

>touch me
Jones, or the narrator (that's the one who's talking right now), are unable to interact with you in any way, other than via keyboard and text, that is.

>showme me
you, the player - thing
location: in the room of stuff
singular-named, proper-named, unused; unlit, inedible, portable, neuter, unseen, unfamiliar
list grouping key: none
printed name: "you, the player"
printed plural name: none
indefinite article: none
most recent reference: nominal
third singular pronoun: It-pronoun
conversation: none
description: "You, the player, issue the commands to make Galaxy Jones go."
initial appearance: none
third-plural-pronoun: They-pronoun

>scope
1: a building entryway (806828)
2: outside (806604)
3: Jones (803404)
4: a speeder (803468)
5: some windows (806732)
6: some turbines (806764)
7: some wings (806796)
8: some parking bays (803500)
9: a disruptor pistol (803436)
10: you, the player (803148)

* * *

>n
Galaxy Jones is in the ninth floor north hallway.

>e
(first opening the Cybernetica door)

Galaxy Jones is in the Cybernetica office. It's spacious and luxurious, designed to make developers forget how spent they are from months of overwork and abuse. Ergonomic desks and chairs fill space like a furniture fractal, before giving way to an open area, presumably for group activities. At the south end of the room is a door labeled "Inspiration Chamber".

As soon as Jones steps into the office, a shot zaps just past her nose. She dives to the ground, protected by the maze of desks and chairs. Peeking through the mesh back of one of the chairs, she takes notice of both the purple guard robot training its disruptor on the room, and the chair's fine construction and lumbar support.

Jones (whispering): "We've got another one! I'm out of sight for now, but it's going to be hard to get a shot off at this 'bot."

Beck: "What's the situation?"

Jones: "I'm on the floor with desks and chairs all around. The target is a few yards off, coming this way. I might get a shot in, but it might just absorb it anyway."

Beck: "Well, see if you can sneak up on it. Maybe close up you can find a way past its defenses."

>shoot robot
(with the disruptor pistol)
Jones raises her head and fires wide. The robot fires back. Jones ducks and crawls off among the labyrinth of desks.

>sneak up on robot
Jones creeps a little ways toward the guard robot.

>shoot robot
(with the disruptor pistol)
Jones raises her head and fires wide. The robot fires back. Jones ducks and crawls off among the labyrinth of desks.

The guard robot moves a little farther away from her.

>sneak up on robot
Jones creeps a little ways toward the guard robot.

* * *

>sneak up on robot
Slowly, slowly, Jones gets a little closer. Just a little more...

She must have poked up her shoulder or something, for the guard robot fires his disruptor. The shot takes out a window on the east side of the room. The electrostatic field around the building keeps the atmosphere from pouring out.

>z
The guard robot moves a little farther away from Jones.

>sneak up on robot
Slowly, slowly, Jones gets a little closer. Just a little more...

>sneak up on robot
Jones is right up next to the robot, crouched beneath a desk. She'll never get a better shot.

>shoot robot
(with the disruptor pistol)
Jones aims the pistol upward under the robot's enhanced armor. She flinches back when the robot's innards explode downward in a shower of sparks. It topples over, dead.

Jones: "Better than a video game. "

Beck: "Nice, but don't forget to credit your handler."

Jones: "Yes, yes, thanks for helping me not get killed."

Beck: "You're welcome."

 _________      __                     _____                     
 __/ ____/___ _/ /___ __  ____  __     __/ /___  ____  ___  _____
 _/ / __/ __ `/ / __ `/ |/ / / / /____ _/ / __ \/ __ \/ _ \/ ___/
 / /_/ / /_/ / / /_/ />  </ /_/ / _/ /_/ / /_/ / / / /  __(__  ) 
 \____/\__,_/_/\__,_/_/|_|\__, /  _\____/\____/_/ /_/\___/____/  
 _____________________________/ 

[Your score has just gone up by one point.]

>look east
Jones sees the ledge in that direction.

>e
Jones: "I'm going out the window to see if I can find a way to get up to the tenth floor."

Beck: "Whoa whoa whoa, Jones. You know you're not good with heights."

Jones: "Ask Thallium how how much that matters once I've kicked his ass."

(first donning the Atmo-Suit)
Jones climbs out the window.

Galaxy Jones is on a ledge.

>look down
Jones is afraid of heights.

>look d
Really, really afraid of heights.

>look d
Okay, fine. Jones look down, slowly, slowly... and there's a window cleaner's scaffold, about six feet below her.

Jones: "Okay, so. There's a window washing platform right below me. I might be able to drop down to it, but I won't be able to get back up."

Beck: "Careful, Jones."

>d
Jones drops off the ledge onto the scaffold. It rocks unnervingly for a moment.

Galaxy Jones is on a window washing scaffold. It's lined up with the eighth floor window. There doesn't seem to be any way to get into the building here. Mounted on the scaffold is a control panel with two buttons: one indicating up and one indicating down.

>l
Galaxy Jones is on a window washing scaffold. It's lined up with the eighth floor window. There doesn't seem to be any way to get into the building here. Mounted on the scaffold is a control panel with two buttons: one indicating up and one indicating down.

>push green button
Jones presses the button, and the scaffold begins to rise.

Galaxy Jones is on a window washing scaffold. It's lined up with the ninth floor window. She could climb back into the building through the window here. Mounted on the scaffold is a control panel with two buttons: one indicating up and one indicating down.

Jones: "Beck?"

Beck: "Yes?"

Jones: "I hate it out here."

Beck: "Well, there's the open window right next to you."

>w
Galaxy Jones is in the Cybernetica office. It's spacious and luxurious, designed to make developers forget how spent they are from months of overwork and abuse. Ergonomic desks and chairs fill space like a furniture fractal, before giving way to an open area, presumably for group activities. At the south end of the room is a door labeled "Inspiration Chamber". One of the windows along the east side of the office is broken.

Jones doffs the Atmo-Suit.

>e
(first donning the Atmo-Suit)

Galaxy Jones is on a window washing scaffold. It's lined up with the ninth floor window. Jones could climb back into the building through the window here. Mounted on the scaffold is a control panel with two buttons: one indicating up and one indicating down.

>push green button
Jones presses the button, and the scaffold begins to rise.

Galaxy Jones is on a window washing scaffold. It's lined up with the tenth floor. Instead of a window, there's what appears to be an exhaust vent. If it's for forced air, though, the fan is currently not running. Mounted on the scaffold is a control panel with two buttons: one indicating up and one indicating down.

Jones: "Alright, I'm by the tenth floor now. What's this thing here?"

Beck: "That's an exhaust vent. There's an air handling room on this floor which it leads into. If you can get the cover off you should be able to access the whole floor from here."

>w
Jones can't go that way. There are no obvious exits.

>d
Jones can't go that way. There are no obvious exits.

>e
Jones can't go that way. There are no obvious exits.

>push green button
Nothing happens.

>x vent
It's a white metal grill held in place by four screws.

>d
Jones can't go that way. There are no obvious exits.

>push down button
Jones presses the button, and the scaffold begins to descend.

Galaxy Jones is on a window washing scaffold. It's lined up with the ninth floor window. She could climb back into the building through the window here. Mounted on the scaffold is a control panel with two buttons: one indicating up and one indicating down.

>x vent
There's nothing like that nearby.

>w
Galaxy Jones is in the Cybernetica office. It's spacious and luxurious, designed to make developers forget how spent they are from months of overwork and abuse. Ergonomic desks and chairs fill space like a furniture fractal, before giving way to an open area, presumably for group activities. At the south end of the room is a door labeled "Inspiration Chamber". One of the windows along the east side of the office is broken.

Jones doffs the Atmo-Suit.

* * *

>e
(first donning the Atmo-Suit)

Galaxy Jones is on a window washing scaffold. It's lined up with the ninth floor window. Jones could climb back into the building through the window here. Mounted on the scaffold is a control panel with two buttons: one indicating up and one indicating down.

>w
Galaxy Jones is in the Cybernetica office. It's spacious and luxurious, designed to make developers forget how spent they are from months of overwork and abuse. Ergonomic desks and chairs fill space like a furniture fractal, before giving way to an open area, presumably for group activities. At the south end of the room is a door labeled "Inspiration Chamber". One of the windows along the east side of the office is broken.

Jones doffs the Atmo-Suit.

>look east
Jones sees the window washing scaffold in that direction.

>e
(first donning the Atmo-Suit)

Galaxy Jones is on a window washing scaffold. It's lined up with the ninth floor window. Jones could climb back into the building through the window here. Mounted on the scaffold is a control panel with two buttons: one indicating up and one indicating down.

>look west
Jones sees the Cybernetica office in that direction.

>w
Galaxy Jones is in the Cybernetica office. It's spacious and luxurious, designed to make developers forget how spent they are from months of overwork and abuse. Ergonomic desks and chairs fill space like a furniture fractal, before giving way to an open area, presumably for group activities. At the south end of the room is a door labeled "Inspiration Chamber". One of the windows along the east side of the office is broken.

Jones doffs the Atmo-Suit.

>w
Galaxy Jones is in the ninth floor north hallway.

>w
Galaxy Jones is at the north end of the building management office.

>s
Galaxy Jones is at the south end of the building management office.

>n
Galaxy Jones is at the north end of the building management office.

>s
Galaxy Jones is at the south end of the building management office.

>e
Galaxy Jones is in the ninth floor south hallway.

>e
Galaxy Jones is in the Martian Chronicle office.

>u
Jones can't go that way. The only obvious exit is west (to the ninth floor south hallway).

* * *

>touch me
Jones can't see 'me' (nothing) at the moment.

>gonear top of
Galaxy Jones is on the top of the elevator car.

>scope
1: an elevator car (807276)
2: Jones (803404)
3: a disruptor pistol (803436)
4: you, the player (803148)

>touch me
Jones, or the narrator (that's the one who's talking right now), are unable to interact with you in any way, other than via keyboard and text, that is.

>restart
Are you sure you want to restart?

* * *

>gonear top of
Galaxy Jones is on the top of the elevator car.

* * *

>scope
1: an elevator car (807276)
2: Jones (803404)
3: a disruptor pistol (803436)
4: you, the player (803148)

>showme me
you, the player - thing
location: in the room of stuff
singular-named, proper-named, unused; unlit, inedible, portable, neuter, unseen, unfamiliar
list grouping key: none
printed name: "you, the player"
printed plural name: none
indefinite article: none
most recent reference: nominal
third singular pronoun: It-pronoun
conversation: none
description: "You, the player, issue the commands to make Galaxy Jones go."
initial appearance: none
third-plural-pronoun: They-pronoun

>showme
top of the elevator car - room
    elevator car - backdrop
    Jones - person
        disruptor pistol

* * *

>gonear top of
Galaxy Jones is on the top of the elevator car.

>touch me
Jones, or the narrator (that's the one who's talking right now), are unable to interact with you in any way, other than via keyboard and text, that is.

* * *

>showme me
you, the player - thing
location: in the room of stuff
singular-named, proper-named, unused; unlit, inedible, portable, neuter, unseen, unfamiliar
list grouping key: none
printed name: "you, the player"
printed plural name: none
indefinite article: none
most recent reference: nominal
third singular pronoun: It-pronoun
conversation: none
description: "You, the player, issue the commands to make Galaxy Jones go."
initial appearance: none
third-plural-pronoun: They-pronoun

>scope
1: an elevator car (807276)
2: Jones (803404)
3: a disruptor pistol (803436)
4: you, the player (803148)

* * *

>touch me
Jones can't see 'me' (nothing) at the moment.

>x me
Jones can't see 'me' (nothing) at the moment.

>i
Jones is carrying:
  a disruptor pistol

>x jones
Galaxy Jones stands at the ready.

>gonear top of
PronounNotice1PronounNotice2Galaxy Jones is on the top of the elevator car.

>touch me
Jones can't see 'me' (nothing) at the moment.

* * *

>x me
Jones can't see 'me' (nothing) at the moment.

>x jones
Galaxy Jones stands at the ready.

>gonear air
(the air handling room)
Galaxy Jones is in the air handling room.

>x me
You, the player, issue the commands to make Galaxy Jones go.

>touch me
Jones, or the narrator (that's the one who's talking right now), are unable to interact with you in any way, other than via keyboard and text, that is.

>gonear top of
Galaxy Jones is on the top of the elevator car.

>d
Galaxy Jones is in the elevator car.

>touch me
Jones, or the narrator (that's the one who's talking right now), are unable to interact with you in any way, other than via keyboard and text, that is.

>x me
You, the player, issue the commands to make Galaxy Jones go.

>u
Galaxy Jones is on the top of the elevator car.

>touch me
Jones, or the narrator (that's the one who's talking right now), are unable to interact with you in any way, other than via keyboard and text, that is.

* * *

>x me
PronounNotice1You, the player, issue the commands to make Galaxy Jones go.

>pronoun
That's not a verb I recognise.

>pronouns
At the moment, "it" means the speeder, "him" is unset, "her" means JonesPronounNotice1PronounNotice2, and "them" is unset.