>g
You can hardly repeat that.

* * *

>n
Galaxy Jones is next to the cage. The closely-set silnium bars seem to dash all hope of a rescue.

Europa Callisto is lying at the center of the cage, out of Jones's reach.

Jones tries the strength of the bars just in case. They don't budge.

South of the cage, Thallium crosses the roof to the flyer pad, where he boards the waiting flyer. The flyer lifts off and moves towards Jones.

>u
Jones gets onto the cage.

Thallium's flyer hovers over the rooftop. "Jones!"  he bellows. "Play time is over. I grow weary of your intransigence. In a moment this roof will be swarmed by guard robots -- of many different colors -- so many robots you couldn't possibly vandalize them all.  Say your prayers, Jones, or whatever you do when you're about to die."

Jones rolls her eyes.

A little ways off, a small red flyer aims for the rooftop and accelerates.

>throw cable at rails
 _________      __                     _____                     
 __/ ____/___ _/ /___ __  ____  __     __/ /___  ____  ___  _____
 _/ / __/ __ `/ / __ `/ |/ / / / /____ _/ / __ \/ __ \/ _ \/ ___/
 / /_/ / /_/ / / /_/ />  </ /_/ / _/ /_/ / /_/ / / / /  __(__  ) 
 \____/\__,_/_/\__,_/_/|_|\__, /  _\____/\____/_/ /_/\___/____/  
 _____________________________/ 

[Your score has just gone up by one point.]

Jones throws the cable up to the flyer where it hooks around the rail, and attaches the other end to the cage, then jumps off the cage to escape the aftermath. Seeing his flyer's predicament, Thallium jumps out of the craft and disappears below the edge of the roof. The flyer reaches the end of its tether and slingshots downwards, slamming into side of the building.

The cage has tilted to the side, one attachment torn loose from the rooftop. Jones crawls into the cage to see to Europa Callisto.

"Europa! Can you hear me? I need you to move to get out of this cage. I can't carry you through that small opening. Europa!"

Europa moans but doesn't show any signs of having understood Jones.

Galaxy Jones is in the cage. The whole structure is tilted, leaving a hole at the eastern end.

Jones is kneeling at Europa Callisto's side, trying to rouse her.

The red flyer, now recognizable as Galaxy's own, settles down onto the landing pad.

>e
Jones can't leave Europa now!

>w
Jones can't leave Europa now!

Beck sticks his head out of the door of the flyer and yells "C'mon Jones, get Europa and get in the flyer!"

>in
Jones can't leave Europa now!

>out
Jones can't leave Europa now!

* * *

>gonear array of diamonds
Galaxy Jones is in the southern corner of the penthouse. This must be Thallium's "treasure room", to go by the obscene display of wealth. The most notable feature is the array of diamonds lining the walls. Everything else here pales in comparison. The penthouse continues to the northwest, north, and northeast.

Thallium seems to speak from all around Jones. "You like diamonds, Jones? Of course you do -- they're a girl's best friend, after all."

Jones snorts, "Sure, Thallium."

>take diamond
You pry one of the diamonds out of the wall.

Thallium giggles. "Oh, I hope you're not disappointed, Jones."

>take diamond
(the diamond)
Jones already has that.

>take diamonds
Jones has already taken a diamond. Isn't one enough?

>x diamond
(the diamond)

Jones: "Hmm. This is made of glass."

Thallium: "Poor, sad Jones. But here's the thing. There is a real diamond in there; it's just you'll never find it before the building's defenses flood the whole floor with poisonous gas. Or maybe I'm bluffing. Maybe I'm not. Can you afford to gamble?"

Jones tosses the fake away.

>take diamond
Jones will never find the real diamond this way.

>purloin hammer
[Purloined.]

>x diamonds
It's impossible to tell which ones are real and which are glass without prying each one out separately.

>purloin hammer
[Purloined.]

* * *

>smash diamonds
(with the hammer)
Whoa, that's enough.

>smash diamond
(the diamond)
Jones only uses violent means when absolutely necessary.

>nw
Galaxy Jones is in the western corner of the penthouse. The purpose of this room is unclear. Instead of the black carpet that plagues the rest of the penthouse, the floor is fashioned from a striking polished red granite. Instead of windows, there are walls. Thallium's personal insignia, the ten planets in order overlaid with the motto "Planetas Vincam", is carved into the deep red wood outer wall, and inlaid with ebony. In the center of the room is a thin metal pillar ending in a claw, which looks like it's meant to hold something. Finally, there is something that looks like an electronic eye set into the inner wall. One may leave to the northeast or southeast.

>put diamond in claw
As soon as insert the diamond into the claw, laser beams spring from five emitters on the walls. They hit the diamond and join into a single more powerful beam that strikes the electronic eye on the wall. A sound like a sliding door comes from behind Jones, and she spins around to see the red wall slide down into the floor. It exposes a control panel of sorts, featuring a large red button labeled "Press Me".

>take it
Taken.

>i
Jones is carrying:
  a diamond
  a hammer
  a disruptor pistol

>press red button
Thallium's voice startles Jones, and she forgets the button for a moment.

"Yes, yes, press it!", Thallium squeaks.

>press red button
Jones presses the red button, but nothing seems to happen. After a few seconds, however, she starts to feel light-headed, and shortly after she starts to suffocate. It's not a nice way to die.

    *** Galaxy Jones was killed by poison gas. ***

In that game you scored 0 out of a possible 10, in 16 turns.

Would you like to RESTART, RESTORE a saved game, QUIT, or UNDO the last command?

>undo
Galaxy Jones is in the western corner of the penthouse.
[Previous turn undone.]

>se
Galaxy Jones is in the southern corner of the penthouse. This must be Thallium's "treasure room", to go by the obscene display of wealth. The most notable feature is the array of diamonds lining the walls. Everything else here pales in comparison. The penthouse continues to the northwest, north, and northeast.

>s
The diamond-shaped penthouse bends to the northeast and northwest.

>s
The diamond-shaped penthouse bends to the northeast and northwest.

>x diamonds
It's impossible to tell which ones are real and which are glass without prying each one out separately.

>smash diamonds
(with the hammer)
Whoa, that's enough.

* * *

>x diamonds
It's impossible to tell which ones are real and which are glass without prying each one out separately.

>smash diamonds
(with the hammer)
Jones commences to smash all of the diamonds. After destroying several dozen fraudulent gems, she finds one that won't break. She takes the real diamond.

Thallium: "Wow, clever solution. Be careful you don't cut yourself."

Jones: "I appreciate your concern."

>i
Jones is carrying:
  a diamond
  a hammer
  a disruptor pistol

>x diamond
(the diamond)
Maybe 2.5 carats, it's a beautiful gem, if you're into diamonds.

* * *

>gonear tenth hall
Galaxy Jones is in the tenth floor elevator hall. The elevator car to the west stands open. There is a stairwell to the east. The hall runs north and south into a sumptuous corporate office.

>n
Galaxy Jones is on the north side of the Consolidated Microthings office. This is the company cafeteria. The elevator is south, the air handling room is to the east, and the office continues to the west and southeast.

>w
Galaxy Jones is at the northwest corner of the Consolidated Microthings office. Various executive offices line the north and west walls here. Jones can go east or south.

Jones sees the mauve guard robot a couple of steps to the south.

>e
Galaxy Jones is on the north side of the Consolidated Microthings office. This is the company cafeteria. The elevator is south, the air handling room is to the east, and the office continues to the west and southeast.

The mauve guard robot appears to the south, coming from the west.

Beck: "If I only had a heart, indeed."

>e
(first opening the air handling door)

Galaxy Jones is in the air handling room. There is a good number of loud fans and other air handling machinery here. A small hinged vent opening leads into some ductwork, and from there to the outside. A door leads west.

>w
Galaxy Jones is on the north side of the Consolidated Microthings office. This is the company cafeteria. The elevator is south, the air handling room is to the east, and the office continues to the west and southeast.

The mauve guard robot approaches from the south.

The robot slaughters Jones.

    *** Jones was killed by the mauve guard robot ***

In that game you scored 0 out of a possible 10, in 6 turns.

Would you like to RESTART, RESTORE a saved game, QUIT, or UNDO the last command?

>unfo
Please give one of the answers above.

Would you like to RESTART, RESTORE a saved game, QUIT, or UNDO the last command?

>undo
Galaxy Jones is in the air handling room.
[Previous turn undone.]

>z
Jones stands around and waits.

>w
Galaxy Jones is on the north side of the Consolidated Microthings office. This is the company cafeteria. The elevator is south, the air handling room is to the east, and the office continues to the west and southeast.

To the south, the mauve guard robot heads north.

Beck: "I've seen more intimidating kitchen appliances!"

>e
Galaxy Jones is in the air handling room. There is a good number of loud fans and other air handling machinery here. A small hinged vent opening leads into some ductwork, and from there to the outside. A door leads west.

* * *

>w
Galaxy Jones is on the north side of the Consolidated Microthings office. This is the company cafeteria. The elevator is south, the air handling room is to the east, and the office continues to the west and southeast.

>w
Galaxy Jones is at the northwest corner of the Consolidated Microthings office. Various executive offices line the north and west walls here. Jones can go east or south.

Jones sees the mauve guard robot a couple of steps to the south.

>e
Galaxy Jones is on the north side of the Consolidated Microthings office. This is the company cafeteria. The elevator is south, the air handling room is to the east, and the office continues to the west and southeast.

The mauve guard robot appears to the south, coming from the west.

Beck: "I hope you have a warranty, because you're about to be seriously damaged!"

Jones: "Really, Beck? Is this your best material?"

>w
Galaxy Jones is at the northwest corner of the Consolidated Microthings office. Various executive offices line the north and west walls here. Jones can go east or south.

The mauve guard robot appears to the south, coming from the east.

>e
Galaxy Jones is on the north side of the Consolidated Microthings office. This is the company cafeteria. The elevator is south, the air handling room is to the east, and the office continues to the west and southeast.

The mauve guard robot appears to the south, coming from the west.

Beck: "Come and get us, ugly!"

Jones: "'Us'? Seems like I'm the only one with her life on the line."

>se
Galaxy Jones is on the east side of the Consolidated Microthings office. This part of the office is currently unused. Jones can go northwest or south from here.

The mauve guard robot appears nearby to the south, coming from the west.

>nw
Galaxy Jones is on the north side of the Consolidated Microthings office. This is the company cafeteria. The elevator is south, the air handling room is to the east, and the office continues to the west and southeast.

The mauve guard robot appears nearby to the southeast, coming from the south.

>w
Galaxy Jones is at the northwest corner of the Consolidated Microthings office. Various executive offices line the north and west walls here. Jones can go east or south.

The mauve guard robot appears nearby to the east, coming from the southeast.

>s
Galaxy Jones is on the west side of the Consolidated Microthings office. This ocean of desks looks out toward the Utopia Tower, twice the height of the Viking Building, where Jones is now. One can go north or south.

The mauve guard robot appears nearby to the north, coming from the east.

>s
Galaxy Jones is at the southwest corner of the Consolidated Microthings office. This looks like the IT area of the office. Numerous desks and an abundance of computer parts are here. Jones can go north or east from here.

There is a present with a note attached sitting on a desk here.

To the north, the mauve guard robot heads south.

>e
Galaxy Jones is on the south side of the Consolidated Microthings office. This is reception. It has a great view of the New Reykjavik Botanic Dome. Couches are lined up to take advantage. The floor extends east and west, and north to the elevator.

The mauve guard robot appears nearby to the west, coming from the north.

* * *

>gonear tenth hall
Galaxy Jones is in the tenth floor elevator hall. The elevator car to the west stands open. There is a stairwell to the east. The hall runs north and south into a sumptuous corporate office.

>s
Galaxy Jones is on the south side of the Consolidated Microthings office. This is reception. It has a great view of the New Reykjavik Botanic Dome. Couches are lined up to take advantage. The floor extends east and west, and north to the elevator.

Thallium's voice booms over the office PA: "You can run, Jones, but you can't - well, there aren't very many places you can hide."

Jones sees the mauve guard robot nearby to the west.

>n
Galaxy Jones is in the tenth floor elevator hall. The elevator car to the west stands open. There is a stairwell to the east. The hall runs north and south into a sumptuous corporate office.

The mauve guard robot appears to the south, coming from the west.

>n
Galaxy Jones is on the north side of the Consolidated Microthings office. This is the company cafeteria. The elevator is south, the air handling room is to the east, and the office continues to the west and southeast.

To the south, the mauve guard robot heads north.

Thallium: "Jones, you still hanging around with that loser Beck?"

* * *

>gonear tenth hall
Galaxy Jones is in the tenth floor elevator hall. The elevator car to the west stands open. There is a stairwell to the east. The hall runs north and south into a sumptuous corporate office.

>w
Galaxy Jones is in the elevator car. It's luxurious, with gold-plated walls and crystal lighting on the ceiling. The button panel is lacquered dark mahogany with what look like real ivory buttons. The carpeting is soft and plush. A golden keyhole sits above the buttons.

One of the ceiling panels looks loose.

Admiral Thallium's voice oozes from concealed speakers: "Yes, Jones, that is real ivory. I imported the elephant here myself for a hunt on my estate. You have no idea how much money it takes to simulate an African jungle on Mars. In retrospect I should have gotten an Indian elephant."

>e
Galaxy Jones is in the tenth floor elevator hall. The elevator car to the west stands open. There is a stairwell to the east. The hall runs north and south into a sumptuous corporate office.

>n
Galaxy Jones is on the north side of the Consolidated Microthings office. This is the company cafeteria. The elevator is south, the air handling room is to the east, and the office continues to the west and southeast.

>w
Galaxy Jones is at the northwest corner of the Consolidated Microthings office. Various executive offices line the north and west walls here. Jones can go east or south.

Thallium's voice booms over the office PA: "You can run, Jones, but you can't - well, there aren't very many places you can hide."

Jones sees the mauve guard robot a couple of steps to the south.

>e
Galaxy Jones is on the north side of the Consolidated Microthings office. This is the company cafeteria. The elevator is south, the air handling room is to the east, and the office continues to the west and southeast.

The mauve guard robot appears a couple of steps to the south, coming from the west.

Beck: "If I only had a heart, indeed."

>se
Galaxy Jones is on the east side of the Consolidated Microthings office. This part of the office is currently unused. Jones can go northwest or south from here.

The mauve guard robot appears nearby to the south, coming from the west.

* * *

>w
Galaxy Jones is at the northwest corner of the Consolidated Microthings office. Various executive offices line the north and west walls here. Jones can go east or south.

The mauve guard robot appears nearby to the east, coming from the southeast.

>s
Galaxy Jones is on the west side of the Consolidated Microthings office. This ocean of desks looks out toward the Utopia Tower, twice the height of the Viking Building, where Jones is now. One can go north or south.

The mauve guard robot appears nearby to the north, coming from the east.

Thallium: "Jones, you still hanging around with that loser Beck?"

>s
Galaxy Jones is at the southwest corner of the Consolidated Microthings office. This looks like the IT area of the office. Numerous desks and an abundance of computer parts are here. Jones can go north or east from here.

There is a present with a note attached sitting on a desk here.

A couple of steps to the north, the mauve guard robot heads south.

Beck: "I don't think I like Thallium's choice of friends much."

>e
Galaxy Jones is on the south side of the Consolidated Microthings office. This is reception. It has a great view of the New Reykjavik Botanic Dome. Couches are lined up to take advantage. The floor extends east and west, and north to the elevator.

The mauve guard robot appears nearby to the west, coming from the north.

>n
Galaxy Jones is in the tenth floor elevator hall. The elevator car to the west stands open. There is a stairwell to the east. The hall runs north and south into a sumptuous corporate office.

The mauve guard robot appears nearby to the south, coming from the west.

>n
Galaxy Jones is on the north side of the Consolidated Microthings office. This is the company cafeteria. The elevator is south, the air handling room is to the east, and the office continues to the west and southeast.

A couple of steps to the south, the mauve guard robot heads north.

Beck: "Come and get us, ugly!"

Jones: "'Us'? Seems like I'm the only one with her life on the line."

>e
(first opening the air handling door)

Galaxy Jones is in the air handling room. There is a good number of loud fans and other air handling machinery here. A small hinged vent opening leads into some ductwork, and from there to the outside. A door leads west.

>z
Jones stands around and waits.

* * *

>w
Galaxy Jones is on the north side of the Consolidated Microthings office. This is the company cafeteria. The elevator is south, the air handling room is to the east, and the office continues to the west and southeast.

>se
Galaxy Jones is on the east side of the Consolidated Microthings office. This part of the office is currently unused. Jones can go northwest or south from here.

>s
Galaxy Jones is at the southeast corner of the Consolidated Microthings office. This corner of the floor contains the gym and other company amenities. Reception is to the west, and an empty area lies to the north.

Jones sees the mauve guard robot a couple of steps to the west.

>n
Galaxy Jones is on the east side of the Consolidated Microthings office. This part of the office is currently unused. Jones can go northwest or south from here.

>nw
Galaxy Jones is on the north side of the Consolidated Microthings office. This is the company cafeteria. The elevator is south, the air handling room is to the east, and the office continues to the west and southeast.

A couple of steps to the south, the mauve guard robot heads east and out of sight.

>w
Galaxy Jones is at the northwest corner of the Consolidated Microthings office. Various executive offices line the north and west walls here. Jones can go east or south.

>s
Galaxy Jones is on the west side of the Consolidated Microthings office. This ocean of desks looks out toward the Utopia Tower, twice the height of the Viking Building, where Jones is now. One can go north or south.

>s
Galaxy Jones is at the southwest corner of the Consolidated Microthings office. This looks like the IT area of the office. Numerous desks and an abundance of computer parts are here. Jones can go north or east from here.

There is a present with a note attached sitting on a desk here.

The mauve guard robot appears a couple of steps to the east, coming from the north.

Beck: "I hope you have a warranty, because you're about to be seriously damaged!"

Jones: "Really, Beck? Is this your best material?"

>take present
Taken.

A couple of steps to the east, the mauve guard robot heads west.

Thallium: "Don't you just hate it, Jones -- not knowing when death will just jump out at you?"

>n
Galaxy Jones is on the west side of the Consolidated Microthings office. This ocean of desks looks out toward the Utopia Tower, twice the height of the Viking Building, where Jones is now. One can go north or south.

The mauve guard robot appears nearby to the south, coming from the east.

>n
Galaxy Jones is at the northwest corner of the Consolidated Microthings office. Various executive offices line the north and west walls here. Jones can go east or south.

A couple of steps to the south, the mauve guard robot heads north.

>e
Galaxy Jones is on the north side of the Consolidated Microthings office. This is the company cafeteria. The elevator is south, the air handling room is to the east, and the office continues to the west and southeast.

The mauve guard robot appears nearby to the west, coming from the south.

>e
Galaxy Jones is in the air handling room. There is a good number of loud fans and other air handling machinery here. A small hinged vent opening leads into some ductwork, and from there to the outside. A door leads west.

* * *

>w
Galaxy Jones is on the north side of the Consolidated Microthings office. This is the company cafeteria. The elevator is south, the air handling room is to the east, and the office continues to the west and southeast.

>s
Galaxy Jones is in the tenth floor elevator hall. The elevator car to the west stands open. There is a stairwell to the east. The hall runs north and south into a sumptuous corporate office.

Thallium: "I bet you're just dying to meet Europa, right, Jones?"

>w
Galaxy Jones is in the elevator car. It's luxurious, with gold-plated walls and crystal lighting on the ceiling. The button panel is lacquered dark mahogany with what look like real ivory buttons. The carpeting is soft and plush. A golden keyhole sits above the buttons.

One of the ceiling panels looks loose.

Thallium: "Jones, you still hanging around with that loser Beck?"

>open present
Jones rips the package open and discovers a golden key.

>put key in keyhole
Jones puts the key in the keyhole and turns. There is a pleasant chime, and some buttons light up.
 _________      __                     _____                     
 __/ ____/___ _/ /___ __  ____  __     __/ /___  ____  ___  _____
 _/ / __/ __ `/ / __ `/ |/ / / / /____ _/ / __ \/ __ \/ _ \/ ___/
 / /_/ / /_/ / / /_/ />  </ /_/ / _/ /_/ / /_/ / / / /  __(__  ) 
 \____/\__,_/_/\__,_/_/|_|\__, /  _\____/\____/_/ /_/\___/____/  
 _____________________________/ 

[Your score has just gone up by one point.]

Galaxy Jones is in the elevator car. It's luxurious, with gold-plated walls and crystal lighting on the ceiling. The button panel is lacquered dark mahogany with what look like real ivory buttons. The carpeting is soft and plush. A golden key rests in a golden keyhole above the buttons. The buttons 1, 9, 10, and 100 are illuminated.

One of the ceiling panels looks loose.

>open panel
(the ceiling panel)
Jones removes the ceiling panel, exposing a hole wide enough for her to squeeze through.

>purloin gel
Which do you mean, the bottle of Electrofil quick-setting conductive polymer gel or the untakable bottle?

>electrofil
Which do you mean, the bottle of Electrofil quick-setting conductive polymer gel or the untakable bottle?

>both
[Purloined.]
[Purloined.]

>e
Galaxy Jones is in the tenth floor elevator hall. The elevator car to the west stands open. There is a stairwell to the east. The hall runs north and south into a sumptuous corporate office.

>drop untakable bottle
There's nothing like that nearby.

>i
Jones is carrying:
  an untakable bottle
  a bottle of Electrofil quick-setting conductive polymer gel
  a disruptor pistol

Thallium's voice booms over the office PA: "You can run, Jones, but you can't - well, there aren't very many places you can hide."

>drop bottle
Which do you mean, the untakable bottle or the bottle of Electrofil quick-setting conductive polymer gel?

>untakable
There's nothing like that nearby.

>s
Galaxy Jones is on the south side of the Consolidated Microthings office. This is reception. It has a great view of the New Reykjavik Botanic Dome. Couches are lined up to take advantage. The floor extends east and west, and north to the elevator.

Jones sees the mauve guard robot nearby to the west.

>n
Galaxy Jones is in the tenth floor elevator hall. The elevator car to the west stands open. There is a stairwell to the east. The hall runs north and south into a sumptuous corporate office.

The mauve guard robot appears nearby to the south, coming from the west.

Thallium: "Jones, you still hanging around with that loser Beck?"

>w
Galaxy Jones is in the elevator car. It's luxurious, with gold-plated walls and crystal lighting on the ceiling. The button panel is lacquered dark mahogany with what look like real ivory buttons. The carpeting is soft and plush. A golden key rests in a golden keyhole above the buttons. The buttons 1, 9, 10, and 100 are illuminated. There is a hole in the ceiling big enough for Jones to squeeze through.

The mauve guard robot appears nearby to the east, coming from the south.

Thallium's voice booms over the office PA: "You can run, Jones, but you can't - well, there aren't very many places you can hide."

>u
Galaxy Jones is on the top of the elevator car. The elevator shaft extends many hundreds of feet above her. She can see down into the elevator car from here.

The mauve guard robot enters the elevator car below.

>jump on robot
Jones drops down through the ceiling and on to the guard robot. It swings around looking for her, obviously panicked that it can't bring its gun to bear on its attacker. Jones manages to hang on.

The mauve guard robot struggles against her hold on it, to no avail.

>pour gel on robot
Which do you mean, the untakable bottle or the bottle of Electrofil quick-setting conductive polymer gel?

>both
Sorry, you can only have one item here. Which exactly?

>bottle of electrofil\
Jones pours the gel into the vent on the robot's head. The robot flails around wildly and throws her from its back, then lets out a loud crackling sound and stops moving.

Galaxy Jones is in the elevator car. It's luxurious, with gold-plated walls and crystal lighting on the ceiling. The button panel is lacquered dark mahogany with what look like real ivory buttons. The carpeting is soft and plush. A golden key rests in a golden keyhole above the buttons. The buttons 1, 9, 10, and 100 are illuminated. There is a hole in the ceiling big enough for Jones to squeeze through.

The remains of the mauve guard robot are sprawled on the ground.

>z
Jones stands around and waits.

>gonear rooftop
(the rooftop)

*** Run-time problem P61: Attempt to move the player off-stage.

>gonear penthouse roof
Galaxy Jones is on the penthouse roof. It is an extravagant and opulent space, designed to showcase Thallium's wealth and power. Much of the rooftop is devoted to an outdoor lounge area, with comfortable seating and a fire pit, centered around a hot tub and flanked by a bar. All around is the city of New Reykjavik, and beyond that the red Martian landscape. Around the entirety of the roof is an electrostatic field designed to keep air in and particulates out. To the north is a large cage, and to the west is a landing pad. Jones can distantly see a woman lying on the floor of the cage. A green and black flyer sits on the landing pad.

Admiral Thallium is sulking.

>x thallium
(Admiral Thallium)
The "Admiral" is a disctinctly ridiculous figure. He dresses in a mockery of a Martian admiral's uniform, plastered with medals. His hair is slicked back and his mustache is painstakingly waxed.

>gonear roof stairs
Galaxy Jones is on the roof stairs. Thick slabs of marble lead from the hall to the west to the rooftop door above.

>u
(first opening the roof access door)
It seems to be locked.

>gonear thallium
(Admiral Thallium)
Galaxy Jones is on the penthouse roof. It is an extravagant and opulent space, designed to showcase Thallium's wealth and power. Much of the rooftop is devoted to an outdoor lounge area, with comfortable seating and a fire pit, centered around a hot tub and flanked by a bar. All around is the city of New Reykjavik, and beyond that the red Martian landscape. Around the entirety of the roof is an electrostatic field designed to keep air in and particulates out. To the north is a large cage, and to the west is a landing pad. Jones can distantly see a woman lying on the floor of the cage. A green and black flyer sits on the landing pad.

Admiral Thallium is sulking.

>w
Thallium trails after Jones.

Um, Jones -- that harlot you're so bent on freeing from captivity is over there. Now get out of the way, I'm trying to escape."

Thallium pushes past Jones. She attempts to grab his shoulder, but she is thrown back by an unseen force.

Thallium smirks. "Personal security field, remember? Now I must be off."

Jones watches as Thallium boards the flyer. It takes off a moment later.

Galaxy Jones is on the flyer pad. This is what one would expect from a rooftop flyer pad: landing lights surrounding a large letter F painted in white on a red background.

>e
Galaxy Jones is on the penthouse roof. It is an extravagant and opulent space, designed to showcase Thallium's wealth and power. Much of the rooftop is devoted to an outdoor lounge area, with comfortable seating and a fire pit, centered around a hot tub and flanked by a bar. All around is the city of New Reykjavik, and beyond that the red Martian landscape. Around the entirety of the roof is an electrostatic field designed to keep air in and particulates out. To the north is a large cage, and to the west is a landing pad. Jones can distantly see a woman lying on the floor of the cage.

Admiral Thallium's flyer is hovering above you.

Thallium's flyer hovers over the rooftop. "Jones!"  he bellows. "Play time is over. I grow weary of your intransigence. In a moment this roof will be swarmed by guard robots -- of many different colors -- so many robots you couldn't possibly vandalize them all.  Say your prayers, Jones, or whatever you do when you're about to die."

Jones rolls her eyes.

A little ways off, a small red flyer aims for the rooftop and accelerates.

>e
Jones would plummet to her death that way.

>i
Jones is carrying:
  an untakable bottle
  a disruptor pistol

>throw pistol at flter
There's nothing like that nearby.

>throw pistol at flyer
Which do you mean, the red flyer or Admiral Thallium's Flyer?

>thallium's
Throwing the disruptor pistol would hardly be effective.

>shoot red flyer
Jones's disruptor does nothing. Looks like Thallium was telling the truth.

Thallium's flyer is circling you not too far away. "Give up, Jones! You'll never get through my silnium bars, haha!"

>s
Jones would plummet to her death that way.

>n
Thallium's flyer floats after Jones.

Galaxy Jones is next to the cage. The closely-set silnium bars seem to dash all hope of a rescue.

Europa Callisto is lying at the center of the cage, out of Jones's reach.

Admiral Thallium's flyer is hovering above you.

>x cage
(the cage)
The cage is huge for holding just one prisoner. The silnium bars are grey and iridescent. They run both horizontally and vertically, creating a lattice. The floor is hard and cold.

>l
Galaxy Jones is next to the cage. The closely-set silnium bars seem to dash all hope of a rescue.

Europa Callisto is lying at the center of the cage, out of Jones's reach.

Admiral Thallium's flyer is hovering above you.

>purloin cable
[Purloined.]

>open cage
It isn't something Jones can open.

Thallium: "Jones! In a moment I shall leave you to be slaughtered by my minions!"

>break it
Jones only uses violent means when absolutely necessary.

>hook cable to cage
It doesn't seem useful to attach the cable to this part of the cage.

>hook cable to flyer
Which do you mean, Admiral Thallium's Flyer or the red flyer?

>thallium's
Jones would achieve nothing by this.

>u
Jones gets onto the cage.

>u
But Jones is already on the cage.

>tie hook to cage
 _________      __                     _____                     
 __/ ____/___ _/ /___ __  ____  __     __/ /___  ____  ___  _____
 _/ / __/ __ `/ / __ `/ |/ / / / /____ _/ / __ \/ __ \/ _ \/ ___/
 / /_/ / /_/ / / /_/ />  </ /_/ / _/ /_/ / /_/ / / / /  __(__  ) 
 \____/\__,_/_/\__,_/_/|_|\__, /  _\____/\____/_/ /_/\___/____/  
 _____________________________/ 

[Your score has just gone up by one point.]

Jones throws the cable up to the flyer where it hooks around the rail, and attaches the other end to the cage, then jumps off the cage to escape the aftermath. Seeing his flyer's predicament, Thallium jumps out of the craft and disappears below the edge of the roof. The flyer reaches the end of its tether and slingshots downwards, slamming into side of the building.

The cage has tilted to the side, one attachment torn loose from the rooftop. Jones crawls into the cage to see to Europa Callisto.

"Europa! Can you hear me? I need you to move to get out of this cage. I can't carry you through that small opening. Europa!"

Europa moans but doesn't show any signs of having understood Jones.

Galaxy Jones is in the cage. The whole structure is tilted, leaving a hole at the eastern end.

Jones is kneeling at Europa Callisto's side, trying to rouse her.

Jones tries the strength of the bars just in case. They don't budge.

The red flyer, now recognizable as Galaxy's own, settles down onto the landing pad.

* * *

>n
Beck sticks his head out of the door of the flyer and yells "C'mon Jones, get Europa and get in the flyer!"

* * *

>r
I didn't understand that sentence.

* * *

>look west
There's nothing in that direction.

>x walls
Outside the building are the red-dusted streets of New Reykjavik.

>n
Jones approaches the Viking Building entryway, the dramatic façade towering over her.

Galaxy Jones is at the entry doorway. A glass revolving door leads into a large open space north of here. The speeder dock is to the south.

Jones peers upwards at the 100 stories of glass and steel. "What do you want to bet Thallium's got Europa all the way at the top?"

Beck: "Oh, no doubt."

>x walls
There's nothing like that nearby.

>look up
There's nothing in that direction.

>n
Jones takes a deep breath. "I'm going in."

Beck replies, "You got this, Galaxy."

Jones passes through the revolving door and into the lobby, alert to any defenses.

Galaxy Jones is in the lobby. The ground floor of the Viking Building is breathtaking. Low-G architecture means more glass and thinner supports, and the building takes advantage of that. Four walls of glass surround a central pillar in which are set the utility rooms and elevators. In between is an expanse of plants, water features, and stylish seating. Near the entryway is a front desk. A giant crystal sculpture floats above the center of the area, suspended on almost invisible cables. She may go east and west from here, north to the elevators, or south out of the building.

Suddenly two robot guards, green and red, emerge from niches in the back wall! She dives behind the front desk and draws her disruptor pistol.

Jones shouts, "I'm under fire from two ugly robot things!"

Beck responds, "Monitoring your suit radar."

>z
Jones stands around and waits.

Zip! Disruptor fire scorches a nearby couch.

>shoot robots
Jones sticks her head out from behind the desk and squeezes off a shot at the red and green guard robots. In Jones's haste it goes wide of the target.

Jones: "I could use some ideas here!"

>take note
There's nothing like that nearby.

>x desk
There's not much on the desk other than a note that says "0".

A robot fires a blistering shot into the front desk.

>take note
As soon as Jones starts to act, an energy beam zips past her head, forcing her back down behind the desk.

The robots intone "Destroy Jones" in an eerie drone.

Beck: "How's it going in there?"

"Jones: "You know -- like all art, it's hit or miss."

>throw note at robots
(first taking the note)
As soon as Jones starts to act, an energy beam zips past her head, forcing her back down behind the desk.

One of the robots fires directly above her head.

>e
Trying to reach an exit would surely get Jones shot.

Jones: "I'm pinned down here!"

>ask beck about robots
(the red and green guard robots).

Beck: "Keep your head down and keep firing."

One of the robots fires directly above Jones's head.

>ask beck about robots
(the red and green guard robots).

Beck: "Keep your head down and keep firing."

The two robots coordinate fire over the desk, narrowly missing Jones.

>ask for help
Beck: "I dunno, maybe shoot the robots?"

Zip! Disruptor fire scorches a nearby couch.

I beg your pardon?

>ask for help
Beck: "I dunno, maybe shoot the robots?"

The two robots coordinate fire over the desk, narrowly missing Jones.

>ask for help
Beck: "I dunno, maybe shoot the robots?"

Beck: "Robot on your right!"

One robot tries to flank Jones, but a shot from her disruptor sends it scurrying back.

>shoot art
Jones fires the disruptor into the sculpture's main support cable, snapping it. The huge crystal blob starts to sag, straining the other cables. In quick succession they break as well, and the whole installation plummets to the ground, right on top of the hapless guard robots.
 _________      __                     _____                     
 __/ ____/___ _/ /___ __  ____  __     __/ /___  ____  ___  _____
 _/ / __/ __ `/ / __ `/ |/ / / / /____ _/ / __ \/ __ \/ _ \/ ___/
 / /_/ / /_/ / / /_/ />  </ /_/ / _/ /_/ / /_/ / / / /  __(__  ) 
 \____/\__,_/_/\__,_/_/|_|\__, /  _\____/\____/_/ /_/\___/____/  
 _____________________________/ 

[Your score has just gone up by one point.]

Beck: "What was that crash? What's going on?"

Jones: "That, my friend, was what you'd call a work of art. Targets terminated."

>e
Jones crosses the floor carefully, disruptor pistol at the ready.

Galaxy Jones is at the southeast corner of the ground floor. The centerpiece of this area is the actual Viking 2 lander, which landed right here on Utopia Planitia. The glass walls look out onto the city. She can go north or west from here.

Admiral Thallium's voice booms from the ceiling. "Little Galaxy thinks she's beaten the big bad Admiral. Sorry dear, that was only a taste."

>n
Galaxy Jones is on the east side of the ground floor. Apparently some kind of function was happening here before Admiral Thallium emptied the building, for there is an array of canapes on a catering table here. The floor stretches north and south, and there's a closet door to the west.

Beck: "Blueprints indicate a closet to the west of you. Might be useful."

>open closet
Jones will have to enter the correct code on the keypad first.

>ask for help
Beck: "You saw that utility door near the catering table, right?"

* * *

>ask for help
Beck: "The code should be around here somewhere."

>ask for help
Beck: "Look at the note you got from the front desk."

>ask for help
Beck: "Look at the note you got from the front desk."

>read note
There's nothing like that nearby.

>i
Jones is carrying:
  a disruptor pistol

>w
(first opening the closet door)
Jones will have to enter the correct code on the keypad first.

>s
Galaxy Jones is at the southeast corner of the ground floor. The centerpiece of this area is the actual Viking 2 lander, which landed right here on Utopia Planitia. The glass walls look out onto the city. Jones can go north or west from here.

* * *

>take note
Taken.

>read it
The note says "0".

>undo
Galaxy Jones is in the lobby.
[Previous turn undone.]

>undo
Galaxy Jones is in the lobby.
[Previous turn undone.]

>x desk
There's not much on the desk other than a note that says "0".

>take note
Taken.

>e
Galaxy Jones is at the southeast corner of the ground floor. The centerpiece of this area is the actual Viking 2 lander, which landed right here on Utopia Planitia. The glass walls look out onto the city. Jones can go north or west from here.

>n
Galaxy Jones is on the east side of the ground floor. Apparently some kind of function was happening here before Admiral Thallium emptied the building, for there is an array of canapes on a catering table here. The floor stretches north and south, and there's a closet door to the west.

>w
(first opening the closet door)
Jones will have to enter the correct code on the keypad first.

>type 0
(on the keypad)
An indicator light glows green.

Jones: "I've unlocked the east side utility door."

* * *

>w
(first opening the closet door)

Galaxy Jones is in the maintenance closet. A bare, white-walled room containing various maintenance items.

There is an Atmo-Suit hanging from a hook here.

On the shelf is a red cardkey.

>e
Galaxy Jones is on the east side of the ground floor. Apparently some kind of function was happening here before Admiral Thallium emptied the building, for there is an array of canapes on a catering table here. The floor stretches north and south, and there's a closet door to the west.

>s
Galaxy Jones is at the southeast corner of the ground floor. The centerpiece of this area is the actual Viking 2 lander, which landed right here on Utopia Planitia. The glass walls look out onto the city. Jones can go north or west from here.

>ask for help
Beck: "Looks like you're managing okay."

>w
Galaxy Jones is in the lobby. The ground floor of the Viking Building is breathtaking. Low-G architecture means more glass and thinner supports, and the building takes advantage of that. Four walls of glass surround a central pillar in which are set the utility rooms and elevators. In between is an expanse of plants, water features, and stylish seating. Near the entryway is a front desk. Jones may go east and west from here, north to the elevators, or south out of the building. There are two niches in the central wall from which the guard robots emerged.

Spread across the floor in a tangled ruin are the remains of a giant crystal sculpture and two guard robots.

* * *

>w
Jones crosses the floor carefully, disruptor pistol at the ready.

Galaxy Jones is at the southwest corner of the ground floor. A lush waterfall here contrasts with the dusty red streets of New Reykjavik beyond the glass walls. The ground floor extends north and east.

>m
I didn't understand that sentence.

>n
Galaxy Jones is on the west side of the ground floor. Semicircular couches open on either side of a central carpeted path leading north and south. Set in the central pillar of the building to the east is a utility door. The city looms beyond the glass wall to the west.

>ask for help
Beck: "Looks like you're managing okay."

>e
(first opening the utility door)
It seems to be locked.

>s
Galaxy Jones is at the southwest corner of the ground floor. A lush waterfall here contrasts with the dusty red streets of New Reykjavik beyond the glass walls. The ground floor extends north and east.

>e
Galaxy Jones is in the lobby. The ground floor of the Viking Building is breathtaking. Low-G architecture means more glass and thinner supports, and the building takes advantage of that. Four walls of glass surround a central pillar in which are set the utility rooms and elevators. In between is an expanse of plants, water features, and stylish seating. Near the entryway is a front desk. Jones may go east and west from here, north to the elevators, or south out of the building. There are two niches in the central wall from which the guard robots emerged.

Spread across the floor in a tangled ruin are the remains of a giant crystal sculpture and two guard robots.

>e
Galaxy Jones is at the southeast corner of the ground floor. The centerpiece of this area is the actual Viking 2 lander, which landed right here on Utopia Planitia. The glass walls look out onto the city. Jones can go north or west from here.

* * *

>n
Galaxy Jones is on the east side of the ground floor. Apparently some kind of function was happening here before Admiral Thallium emptied the building, for there is an array of canapes on a catering table here. The floor stretches north and south, and there's a closet door to the west.

>w
Galaxy Jones is in the maintenance closet. A bare, white-walled room containing various maintenance items.

There is an Atmo-Suit hanging from a hook here.

On the shelf is a red cardkey.

>take all
Atmo-Suit: Taken.
red cardkey: Taken.

>e
Galaxy Jones is on the east side of the ground floor. Apparently some kind of function was happening here before Admiral Thallium emptied the building, for there is an array of canapes on a catering table here. The floor stretches north and south, and there's a closet door to the west.

* * *

>w
Galaxy Jones is at the southwest corner of the ground floor. A lush waterfall here contrasts with the dusty red streets of New Reykjavik beyond the glass walls. The ground floor extends north and east.

>n
Galaxy Jones is on the west side of the ground floor. Semicircular couches open on either side of a central carpeted path leading north and south. Set in the central pillar of the building to the east is a utility door. The city looms beyond the glass wall to the west.

>e
(first opening the utility door)
It seems to be locked.

>unlock door
(with the red cardkey)
Jones unlocks the utility door.

>e
(first opening the utility door)

Galaxy Jones is in the elevator room. This is a utility room related to the operation of the elevator, on the other side of the east wall here. There is a control panel on the wall, and a door leading west.

Hanging from a hook here is a drop key.

Lying discarded on a table here is a hammer.

>ask for help
Beck: "You should probably be heading up the building by now."

>ask for help
Beck: "Time to open the elevator door."

>ask for help
Beck: "Use the drop key you found in the elevator room."

>ask for help
Beck: "Use the drop key you found in the elevator room."

>take al
There's nothing like that nearby.

>take all
hammer: Taken.
drop key: Taken.

>w
Galaxy Jones is on the west side of the ground floor. Semicircular couches open on either side of a central carpeted path leading north and south. Set in the central pillar of the building to the east is a utility door. The city looms beyond the glass wall to the west.

>s
Galaxy Jones is at the southwest corner of the ground floor. A lush waterfall here contrasts with the dusty red streets of New Reykjavik beyond the glass walls. The ground floor extends north and east.

* * *

>n
Galaxy Jones is in the ground floor elevator hall. This hallway between the north and south ends of the ground floor is home to the elevator to the west. To the east is the entrance to a stairwell.

>ask for help
Beck: "Use the drop key you found in the elevator room."

>put drop key in elevator
Which do you mean, the elevator door or the elevator shaft?

>door
Jones inserts the drop key into the small hole and turns it, disengaging the lock mechanism. Then she slides the door open.

>undo
Galaxy Jones is in the ground floor elevator hall.
[Previous turn undone.]

>undo
Galaxy Jones is in the ground floor elevator hall.
[Previous turn undone.]

>l
Galaxy Jones is in the ground floor elevator hall. This hallway between the north and south ends of the ground floor is home to the elevator to the west. To the east is the entrance to a stairwell.

>use t
I didn't understand that sentence.

>use
I didn't understand that sentence.

>put key in hole
(the drop key in the small hole)
Jones inserts the drop key into the small hole and turns it, disengaging the lock mechanism. Then she slides the door open.

>undo
Galaxy Jones is in the ground floor elevator hall.
[Previous turn undone.]

>unlock door with drop key
Jones inserts the drop key into the small hole and turns it, disengaging the lock mechanism. Then she slides the door open.

>ask for help
Beck: "Looks like you're managing okay."

>w
Jones climbs into the elevator shaft.

Galaxy Jones is in the ground floor elevator shaft. She is at the bottom of a dark well. Shining her suit light up, she can see that the elevator car is several floors up, unmoving. There is a ladder running up the wall next to the door.

Beck: "Ooh. It's like we're in an action film."

>u
Jones climbs up the shaft, stopping at each floor to test each door. She gets all the way to the ninth floor, directly below the elevator car, before finding one that opens.

Galaxy Jones is in the ninth floor elevator shaft. The door here is open.

Beck: "Huh. Seems like it should have taken longer than that."

>u
The way further up is blocked by the elevator car.

>e
 _________      __                     _____                     
 __/ ____/___ _/ /___ __  ____  __     __/ /___  ____  ___  _____
 _/ / __/ __ `/ / __ `/ |/ / / / /____ _/ / __ \/ __ \/ _ \/ ___/
 / /_/ / /_/ / / /_/ />  </ /_/ / _/ /_/ / /_/ / / / /  __(__  ) 
 \____/\__,_/_/\__,_/_/|_|\__, /  _\____/\____/_/ /_/\___/____/  
 _____________________________/ 

[Your score has just gone up by one point.]

Jones: "Finally out of the shaft. That was quite a climb."

Beck: "This floor is just offices. Check the building management office to the west. It might have some useful stuff."

Jones exits the shaft, the door sliding closed behind her.

Galaxy Jones is in the ninth floor elevator hall. The elevator is to the west, the stairwell is to the east, and a corridor leads north and south. There is a bottled water vending machine here.

>ask for help
Beck: "Looks like you're managing okay."

>e
As soon as Jones enters the stairwell, a disruptor blast from above zings past her shoulder, and she beats a hasty retreat. She won't be going up the stairs until she can clear out the resistance, and she can't do that from here.

Jones: "In case of fire, don't use the stairs."

Galaxy Jones is in the ninth floor elevator hall. The elevator is to the west, the stairwell is to the east, and a corridor leads north and south. There is a bottled water vending machine here.

>s
Galaxy Jones is in the ninth floor south hallway. This anonymous corporate hallway ends here at the south end of the building. An open doorway leads west. To the east is a door with a swipe lock, labeled "Martian Chemical."

>ask for help
Beck: "Looks like you're managing okay."

>e
(first opening the Martian Chemical door)
It seems to be locked.

>ask for help
Beck: "Looks like you're managing okay."

>n
Galaxy Jones is in the ninth floor elevator hall. The elevator is to the west, the stairwell is to the east, and a corridor leads north and south. There is a bottled water vending machine here.

>n
Galaxy Jones is in the ninth floor north hallway. This anonymous corporate hallway ends here at the north end of the building. An open doorway leads west. To the east is a door with a swipe lock, labeled "Cybernetica Inc."

>ask for help
Beck: "You've probably noticed the two locked doors on this floor. You need to get them open."

>ask for help
Beck: "The cardkey for both of them is in the large desk in the building management office."

>ask for help
Beck: "You don't have a key for the desk. Maybe you can pick the lock?"

>ask for help
Beck: "Pick the desk lock with the safety pin."

>ask for help
Beck: "You'll find it inside the medal."

>purloin safety pin
[Purloined.]

>w
Galaxy Jones is at the north end of the building management office. The building management office is a bunch of desks and task boards. There is a particularly large desk against the west window. The office exit is to the east, and the office continues to the south.

>pick the desk lock with the safety pin
Jones pushes the pin into the keyhole and wiggles it around. After a few seconds of this the desk drawer pops open. It contains a black cardkey.
 _________      __                     _____                     
 __/ ____/___ _/ /___ __  ____  __     __/ /___  ____  ___  _____
 _/ / __/ __ `/ / __ `/ |/ / / / /____ _/ / __ \/ __ \/ _ \/ ___/
 / /_/ / /_/ / / /_/ />  </ /_/ / _/ /_/ / /_/ / / / /  __(__  ) 
 \____/\__,_/_/\__,_/_/|_|\__, /  _\____/\____/_/ /_/\___/____/  
 _____________________________/ 

[Your score has just gone up by one point.]

Beck: "Galaxy Jones, master thief!"

>take black
Taken.

>ask for help
Beck: "You'll find the medal with the other military junk on the first floor."

>s
Galaxy Jones is at the south end of the building management office. The building management office is a bunch of desks and task boards. There is a filing cabinet against the east wall. The office exit is to the east, and the office continues to the north.

A screwdriver sits atop the filing cabinet.

>s
Jones can leave through a doorway to the east, or go north to the other end of the office.

>ask for help
Beck: "If you haven't yet, get the screwdriver."

>take screwdriver
Jones reaches for the screwdriver, but she fumbles it and it rolls off the back of the filing cabinet.

Jones: "Damn."

Beck: "What? What's going on?"

Jones: "Just being clumsy is all."

>ask for help
Beck: "Oops. Getting the screwdriver didn't turn out well. Look behind the cabinet to get the screwdriver."

>look behind cabinet
(taking the screwdriver)
Jones reaches behind the cabinet to retrieve the screwdriver. A swipe and a hiss make her recoil.

Jones: "Holy --!"

Beck: "What now?"

Jones: "There's a cat here! Behind a filing cabinet. Gotta get behind there to get a screwdriver, so I need a way to drive off the cat."

>ask for help
Beck: "Give the shrimp tea sandwich to the cat."

>purloin shrimp
[Purloined.]

>give it to cat
Sensing food, the black cat pokes its head out, grabs the shrimp in its jaws, and races off. Jones takes the screwdriver.

 _________      __                     _____                     
 __/ ____/___ _/ /___ __  ____  __     __/ /___  ____  ___  _____
 _/ / __/ __ `/ / __ `/ |/ / / / /____ _/ / __ \/ __ \/ _ \/ ___/
 / /_/ / /_/ / / /_/ />  </ /_/ / _/ /_/ / /_/ / / / /  __(__  ) 
 \____/\__,_/_/\__,_/_/|_|\__, /  _\____/\____/_/ /_/\___/____/  
 _____________________________/ 

[Your score has just gone up by one point.]

Jones: "Aha! No creature is too fearsome for Galaxy Jones!"

Beck: "Congratulations on your victory."

>ask for help
Beck: "Looks like you're managing okay."

>e
Galaxy Jones is in the ninth floor south hallway. This anonymous corporate hallway ends here at the south end of the building. An open doorway leads west. To the east is a door with a swipe lock, labeled "Martian Chemical."

>e
(first opening the Martian Chemical door)
It seems to be locked.

>unlock door
(with the black cardkey)
Jones unlocks the Martian Chemical door.

>e
(first opening the Martian Chemical door)

Galaxy Jones is in the Martian Chemical office. This seems like the business office of the chemical company rather than the lab. Most of the room is taken up by desks and other office stuff. There is a cabinet that looks intriguing, however.

>x cabinet
The cabinet is full of bottles of Electrofil quick-setting conductive polymer gel.

>take gel
Taken.

* * *

>take gel
Jones already has that.

>w
Galaxy Jones is in the ninth floor south hallway. This anonymous corporate hallway ends here at the south end of the building. An open doorway leads west. To the east is a door with a swipe lock, labeled "Martian Chemical."

* * *

>drop gel
Dropped.

>e
Galaxy Jones is in the Martian Chemical office. This seems like the business office of the chemical company rather than the lab. Most of the room is taken up by desks and other office stuff. There is a cabinet that looks intriguing, however.

>take gel
Jones has already taken one bottle of Electrofil from the cabinet. She should use it before taking another.

* * *

>w
Galaxy Jones is in the ninth floor south hallway. This anonymous corporate hallway ends here at the south end of the building. An open doorway leads west. To the east is a door with a swipe lock, labeled "Martian Chemical."

Also here is a bottle of Electrofil quick-setting conductive polymer gel.

>take gel
Taken.

>n
Galaxy Jones is in the ninth floor elevator hall. The elevator is to the west, the stairwell is to the east, and a corridor leads north and south. There is a bottled water vending machine here.

>e
As soon as Jones enters the stairwell, a disruptor blast from above zings past her shoulder, and she beats a hasty retreat. She won't be going up the stairs until she can clear out the resistance, and she can't do that from here.

Galaxy Jones is in the ninth floor elevator hall. The elevator is to the west, the stairwell is to the east, and a corridor leads north and south. There is a bottled water vending machine here.

>n
Galaxy Jones is in the ninth floor north hallway. This anonymous corporate hallway ends here at the north end of the building. An open doorway leads west. To the east is a door with a swipe lock, labeled "Cybernetica Inc."

>e
(first opening the Cybernetica door)
It seems to be locked.

>unlock door
(with the black cardkey)
Jones unlocks the Cybernetica door.

>e
(first opening the Cybernetica door)

Galaxy Jones is in the Cybernetica office. It's spacious and luxurious, designed to make developers forget how spent they are from months of overwork and abuse. Ergonomic desks and chairs fill space like a furniture fractal, before giving way to an open area, presumably for group activities.

As soon as Jones steps into the office, a shot zaps just past her nose. She dives to the ground, protected by the maze of desks and chairs. Peeking through the mesh back of one of the chairs, she takes notice of both the purple guard robot training its disruptor on the room, and the chair's fine construction and lumbar support.

Jones (whispering): "We've got another one! I'm out of sight for now, but it's going to be hard to get a shot off at this 'bot."

Beck: "What's the situation?"

Jones: "I'm on the floor with desks and chairs all around. The target is a few yards off, coming this way. I might get a shot in, but it might just absorb it anyway."

Beck: "Well, see if you can sneak up on it. Maybe close up you can find a way past its defenses."

>ask help
There's nothing like that nearby.

>ask for help
Beck: "The robot's got you pinned down good, yeah? And you can't get a good shot in? And even if you did, it would probably just be absorbed?"

>ask for help
Beck: "When will you start listening to your handler? When? I've been giving you good advice, just spelling out what to do, and you don't pay attention."

>ask for help
Beck: "Sneak up on the stupid robot already!"

>sneak up on robot
Jones creeps a little ways toward the guard robot.

* * *

>sneak up on robot
Jones is right up next to the robot, crouched beneath a desk. She'll never get a better shot.

>shoot robot
Jones aims the pistol upward under the robot's enhanced armor and fires. She flinches back when the robot's innards explode downward in a shower of sparks. It topples over, dead. Jones stands up and surveys her handiwork.

 _________      __                     _____                     
 __/ ____/___ _/ /___ __  ____  __     __/ /___  ____  ___  _____
 _/ / __/ __ `/ / __ `/ |/ / / / /____ _/ / __ \/ __ \/ _ \/ ___/
 / /_/ / /_/ / / /_/ />  </ /_/ / _/ /_/ / /_/ / / / /  __(__  ) 
 \____/\__,_/_/\__,_/_/|_|\__, /  _\____/\____/_/ /_/\___/____/  
 _____________________________/ 

[Your score has just gone up by one point.]

Jones: "Better than a video game. "

Beck: "Nice, but don't forget to credit your handler."

Jones: "Yes, yes, thanks for helping me not get killed."

Beck: "You're welcome."

>x robot
The tattered guts of the purple guard robot spill out from its armored carapace.

>take it
It's too heavy to lift or move.

>take guys
There's nothing like that nearby.

>take guts
It's too heavy to lift or move.

>stand up
You are already standing up.

>get up
Jones: "I'm going out the window to see if I can find a way to get up to the tenth floor."

Beck: "Whoa whoa whoa, Jones. You know you're not good with heights."

Jones: "Ask Thallium how how much that matters once I've kicked his ass. Watch me, I'll look down and not even flinch."

Jones puts on the Atmo-Suit.

Galaxy Jones is on a ledge. She's plastered up against the wall, trying not to look down.

>undo
Galaxy Jones is in the Cybernetica office.
[Previous turn undone.]

>stand
You are already standing up.

>get up
Jones: "I'm going out the window to see if I can find a way to get up to the tenth floor."

Beck: "Whoa whoa whoa, Jones. You know you're not good with heights."

Jones: "Ask Thallium how how much that matters once I've kicked his ass. Watch me, I'll look down and not even flinch."

Jones puts on the Atmo-Suit.

Galaxy Jones is on a ledge. She's plastered up against the wall, trying not to look down.

* * *

>undo
Galaxy Jones is in the Cybernetica office.
[Previous turn undone.]

>actions
Actions listing on.

>get up
[exiting]
[(1) going outside]
Jones: "I'm going out the window to see if I can find a way to get up to the tenth floor."

Beck: "Whoa whoa whoa, Jones. You know you're not good with heights."

Jones: "Ask Thallium how how much that matters once I've kicked his ass. Watch me, I'll look down and not even flinch."

[(2) wearing the Atmo-Suit]
Jones puts on the Atmo-Suit.
[(2) wearing the Atmo-Suit - succeeded]

[(2) looking]
Galaxy Jones is on a ledge. She's plastered up against the wall, trying not to look down.

[(2) looking - succeeded]

[(1) going outside - failed]

[exiting - failed the convert exit into go out rule]

>undo
Galaxy Jones is in the Cybernetica office.
[Previous turn undone.]

>stand
[dithering]
You are already standing up.
[dithering - failed]

* * *

>u
Galaxy Jones is on the roof stairs. Thick slabs of marble lead from the hall to the west to the rooftop door above.

>u
(first opening the roof access door)
Jones opens the door and steps through onto the roof. The door crashes shut, and a lock audibly clicks.
 _________      __                     _____                     
 __/ ____/___ _/ /___ __  ____  __     __/ /___  ____  ___  _____
 _/ / __/ __ `/ / __ `/ |/ / / / /____ _/ / __ \/ __ \/ _ \/ ___/
 / /_/ / /_/ / / /_/ />  </ /_/ / _/ /_/ / /_/ / / / /  __(__  ) 
 \____/\__,_/_/\__,_/_/|_|\__, /  _\____/\____/_/ /_/\___/____/  
 _____________________________/ 

[Your score has just gone up by one point.]

Jones walks out onto the luxurious penthouse roof. Admiral Thallium turns from the railing to face her. He is dressed in an absurd elaboration of a Martian Admiral's uniform. He looks Jones up and down with a lecherous leer. "Ah, Galaxy Jones, as lovely as ever. If it weren't so unbearably cliché I'd ask you to join me in my rise to greatness. But alas, you are too habituated to the smug high of 'goodness'." He sighs dramatically. "We've trodden similar ground before; no need to discuss it further. Although I would challenge any of your various amoureux to conjugate 'tread' correctly.

"Anyway, I guess this is the time where you do something predictably undignified and violent. Before you do I feel I should inform you that your sidearm has been rendered quite ineffective by my personal security field. But do go ahead and try it."

Jones sneers. "I wouldn't give you the satisfaction," she says, looking around. "I see you don't have any of your robot pets up here. How are you going to stop me from rescuing Europa?"

"Oh please, while we're trying things, try that too. I wish you luck breaking the silnium bars of the cage."

"What's silnium?"

"A superstrong material invented here in my Martian Chemical laboratory. We had a press conference for it -- weren't you watching?"

"Couldn't be bothered."

"Oh for frotz sake, Jones, you're so frustrating!"

Thallium turns his back on Jones and stares out over the city.

Galaxy Jones is on the penthouse roof. It is an extravagant and opulent space, designed to showcase Thallium's wealth and power. Much of the rooftop is devoted to an outdoor lounge area, with comfortable seating and a fire pit, centered around a hot tub and flanked by a bar. All around is the city of New Reykjavik, and beyond that the red Martian landscape. Around the entirety of the roof is an electrostatic field designed to keep air in and particulates out. To the north is a large cage, and to the west is a landing pad. Jones can distantly see a woman lying on the floor of the cage. A green and black flyer sits on the landing pad.

Admiral Thallium is sulking.

>jump
Jones jumps on the spot.

>e
Jones would plummet to her death that way.

>n
Galaxy Jones is next to the cage. The closely-set silnium bars seem to dash all hope of a rescue. The flyer pad is to the southwest and the rest of the rooftop to the south.

Europa Callisto is lying at the center of the cage, out of Jones's reach.

Jones tries the strength of the bars just in case. They don't budge.

South of the cage, Thallium crosses the roof to the flyer pad, where he boards the waiting flyer. The flyer lifts off and moves towards Jones.

>jump
Jones's jump comes up pathetically short.

Thallium's flyer hovers over the rooftop. "Jones!"  he bellows. "Play time is over. I grow weary of your intransigence. In a moment this roof will be swarmed by guard robots -- of many different colors -- so many robots you couldn't possibly vandalize them all.  Say your prayers, Jones, or whatever you do when you're about to die."

Jones rolls her eyes.

A little ways off, a small red flyer aims for the rooftop and accelerates.

>scope
1: a red flyer (1134432)
2: Admiral Thallium's Flyer (1134496)
3: an electrostatic field (1134464)
4: outside (1132352)
5: Jones (1126656)
6: Europa Callisto (1132128)
7: a cage (1132160)
8: a cage-container (1132192)
9: a screwdriver (1129120)
10: a black cardkey (1128896)
11: a full water bottle (1129600)
12: an elevator drop key (1127648)
13: a hammer (1127744)
14: a safety pin (1128000)
15: a garish medal (1127968)
16: a fork (1128128)
17: a red cardkey (1128384)
18: an Atmo-Suit (1128256)
19: a cable with hooks at either end (1132832)
20: a disruptor pistol (1126688)
21: Beck (1126240)

* * *

>x flyer
It's big and green and black. Looks like a Sirius XE.

>n
Galaxy Jones is next to the cage. The closely-set silnium bars seem to dash all hope of a rescue. The flyer pad is to the southwest and the rest of the rooftop to the south.

Europa Callisto is lying at the center of the cage, out of Jones's reach.

Jones tries the strength of the bars just in case. They don't budge.

South of the cage, Thallium crosses the roof to the flyer pad, where he boards the waiting flyer. The flyer lifts off and moves towards Jones.

>get on cage
Jones gets onto the cage.

Thallium's flyer hovers over the rooftop. "Jones!"  he bellows. "Play time is over. I grow weary of your intransigence. In a moment this roof will be swarmed by guard robots -- of many different colors -- so many robots you couldn't possibly vandalize them all.  Say your prayers, Jones, or whatever you do when you're about to die."

Jones rolls her eyes.

A little ways off, a small red flyer aims for the rooftop and accelerates.

>jump
Jones's jump comes up pathetically short of the Admiral's flyer.

>shoot flyer
Which do you mean, the red flyer or Admiral Thallium's flyer?

>admiral
Jones's disruptor does nothing. Looks like Thallium was telling the truth.

>throw cable at flyer
(Admiral Thallium's flyer)
 _________      __                     _____                     
 __/ ____/___ _/ /___ __  ____  __     __/ /___  ____  ___  _____
 _/ / __/ __ `/ / __ `/ |/ / / / /____ _/ / __ \/ __ \/ _ \/ ___/
 / /_/ / /_/ / / /_/ />  </ /_/ / _/ /_/ / /_/ / / / /  __(__  ) 
 \____/\__,_/_/\__,_/_/|_|\__, /  _\____/\____/_/ /_/\___/____/  
 _____________________________/ 

[Your score has just gone up by one point.]

Jones throws the cable up to the flyer where it hooks around the rail, and attaches the other end to the cage, then jumps off the cage to escape the aftermath. Seeing his flyer's predicament, Thallium jumps out of the craft and disappears below the edge of the roof. The flyer reaches the end of its tether and slingshots downwards, slamming into side of the building.

The cage has tilted to the side, one attachment torn loose from the rooftop. Jones crawls into the cage to see to Europa Callisto.

"Europa! Can you hear me? I need you to move to get out of this cage. I can't carry you through that small opening. Europa!"

Europa moans but doesn't show any signs of having understood Jones.

Galaxy Jones is in the cage. The whole structure is tilted, leaving a hole at the eastern end. The flyer pad is to the southwest and the rest of the rooftop to the south.

Jones is kneeling at Europa Callisto's side, trying to rouse her.

The red flyer, now recognizable as Galaxy's own, settles down onto the landing pad.

>e
Jones can't leave Europa now!

>out
Jones can't leave Europa now!

Beck sticks his head out of the door of the flyer and yells "C'mon Jones, get Europa and get in the flyer!"

>pick up europa
Jones could carry Europa to the hole in the cage, but she'd never get her through without help.

>x europa
Europa Callisto is a stunningly beautiful woman with long ice-blue hair and piercing blue eyes. Right now she's looking pretty ragged, though.

>take europa
Jones could carry Europa to the hole in the cage, but she'd never get her through without help.

>x flyer
Jones's little red flyer, Galaxy Two.

>i
Jones is carrying:
  a screwdriver
  a black cardkey
  a full water bottle
  an elevator drop key
  a hammer
  a safety pin
  a garish medal
  a fork
  a red cardkey
  an Atmo-Suit
  a disruptor pistol

>poke europa with fork
I didn't understand that sentence.

>give fork to europa
Europa Callisto doesn't seem interested.

>open water
It isn't something Jones can open.

>put water on europa
Putting things on Europa Callisto would achieve nothing.

* * *

>w
Thallium trails after Jones.

Um, Jones -- that harlot you're so bent on freeing from captivity is over there. Now get out of the way, I'm trying to escape."

Thallium pushes past Jones. She attempts to grab his shoulder, but she is thrown back by an unseen force.

Thallium smirks. "Personal security field, remember? Now I must be off."

Jones watches as Thallium boards the flyer. It takes off a moment later.

Galaxy Jones is on the flyer pad. This is what one would expect from a rooftop flyer pad: landing lights surrounding a large letter F painted in white on a red background. Europa's cage is to the northeast and the rest of the rooftop is to the east.

>ne
Galaxy Jones is next to the cage. The closely-set silnium bars seem to dash all hope of a rescue. The flyer pad is to the southwest and the rest of the rooftop to the south.

Europa Callisto is lying at the center of the cage, out of Jones's reach.

Admiral Thallium's flyer is hovering above you.

Thallium's flyer hovers over the rooftop. "Jones!"  he bellows. "Play time is over. I grow weary of your intransigence. In a moment this roof will be swarmed by guard robots -- of many different colors -- so many robots you couldn't possibly vandalize them all.  Say your prayers, Jones, or whatever you do when you're about to die."

Jones rolls her eyes.

A little ways off, a small red flyer aims for the rooftop and accelerates.

>call to europa
I didn't understand that sentence.

>europa, hello
She's too out of it to respond.

>enter cage
Jones gets onto the cage.

>undo
Galaxy Jones is next to the cage. 
[Previous turn undone.]

>get in cage
Jones gets onto the cage.

>x flyer
Which do you mean, the red flyer or Admiral Thallium's Flyer?

>admiral
Hovering above Jones, it's distinctly menacing. It's not visibly armed, but it conveys the impression of a beast about to strike. It's flying low, the rails of its landing gear just a few feet above Jones's head.

>jump
Jones jumps on the spot.

Thallium's flyer is circling you not too far away. "Give up, Jones! You'll never get through my silnium bars, haha!"

>scenes
Scene 'Entire Game' playing (for 106 mins now)
Scene 'Lobby Shootout' ended
Scene 'Cybernetica Battle' ended
Scene 'Lobby Shootout Aftermath' ended
Scene 'Endgame' playing (for 7 mins now)
Scene 'On-Rooftop' ended
Scene 'Thallium alight' ended
Scene 'Thallium ultimatum' playing (for 4 mins now)
(Scene monitoring now switched on. Type "scenes off" to switch it off again.)

* * *

>i
Jones is carrying:
  a diamond
  a screwdriver
  a black cardkey
  a full water bottle
  an elevator drop key
  a hammer
  a safety pin
  a garish medal
  a fork
  a red cardkey
  an Atmo-Suit
  a cable with hooks at either end
  a disruptor pistol

>x gem
There's nothing like that nearby.

* * *

>d
(first opening the roof access door)
It seems to be locked.

>w
Thallium trails after Jones.

Um, Jones -- that harlot you're so bent on freeing from captivity is over there. Now get out of the way, I'm trying to escape."

Thallium pushes past Jones. She attempts to grab his shoulder, but she is thrown back by an unseen force.

Thallium smirks. "Personal security field, remember? Now I must be off."

Jones watches as Thallium boards the flyer. It takes off a moment later.

Galaxy Jones is on the flyer pad. This is what one would expect from a rooftop flyer pad: landing lights surrounding a large letter F painted in white on a red background.

>push thallium
Don't be silly.

Thallium's flyer hovers over the rooftop. "Jones!"  he bellows. "Play time is over. I grow weary of your intransigence. In a moment this roof will be swarmed by guard robots -- of many different colors -- so many robots you couldn't possibly vandalize them all.  Say your prayers, Jones, or whatever you do when you're about to die."

Jones rolls her eyes.

A little ways off, a small red flyer aims for the rooftop and accelerates.

>hit admiral;
There's nothing like that nearby.

>hit admiral
It's just too far away.

>pronouns
At the moment, "it" means Admiral Thallium's Flyer, "him" means Admiral Thallium, "her" means the mauve guard robot, and "them" means the mauve guard robot.

>push him
Jones can't see 'him' (nothing) at the moment.

>throw hammer at admiral thallium
It might leave a dent, but bring down a flyer? Really?

>x red flyer
It's little more than a growing red speck.

>n
Jones would plummet to her death that way.

Thallium's flyer is circling you not too far away. "Give up, Jones! You'll never get through my silnium bars, haha!"

>l
Galaxy Jones is on the flyer pad. This is what one would expect from a rooftop flyer pad: landing lights surrounding a large letter F painted in white on a red background.

Admiral Thallium's flyer is hovering above you.

>e
Thallium's flyer floats after Jones.

Galaxy Jones is on the penthouse roof. It is an extravagant and opulent space, designed to showcase Thallium's wealth and power. Much of the rooftop is devoted to an outdoor lounge area, with comfortable seating and a fire pit, centered around a hot tub and flanked by a bar. All around is the city of New Reykjavik, and beyond that the red Martian landscape. Around the entirety of the roof is an electrostatic field designed to keep air in and particulates out. To the north is a large cage, and to the west is a landing pad. Jones can distantly see a woman lying on the floor of the cage.

Admiral Thallium's flyer is hovering above you.

>n
Thallium's flyer floats after Jones.

Galaxy Jones is next to the cage. The closely-set silnium bars seem to dash all hope of a rescue.

Europa Callisto is lying at the center of the cage, out of Jones's reach.

Admiral Thallium's flyer is hovering above you.

* * *

>press 100
The elevator accelerates upwards at a frightening rate. The numbers climb towards 100. Soon the elevator slows, and the door opens on the 100th floor.

Jones: "Holy - This thing goes fast."

Galaxy Jones is in the elevator car. It's luxurious, with gold-plated walls and crystal lighting on the ceiling. The button panel is lacquered dark mahogany with what look like real ivory buttons. The carpeting is soft and plush. A golden key rests in a golden keyhole above the buttons. The buttons 1, 9, 10, and 100 are illuminated. There is a hole in the ceiling big enough for Jones to squeeze through.

The remains of the mauve guard robot are sprawled on the ground.

>s
The exit is to the east.

>e
Galaxy Jones is in the 100th floor elevator hall. The luxury is staggering.  The walls are made of polished black marble, and the floors are covered in plush black carpeting that muffles the sound of footsteps. The ceiling is high and adorned with a crystal chandelier. The elevator doors to the west are gold-plated. Sumptuous living quarters are visible to the north and south.

>s
Galaxy Jones is in the southern corner of the penthouse. This must be Thallium's "treasure room", to go by the obscene display of wealth. The most notable feature is the array of diamonds lining the walls. Everything else here pales in comparison. The penthouse continues to the northwest, north, and northeast.

Thallium seems to speak from all around Jones. "You like diamonds, Jones? Of course you do -- they're a girl's best friend, after all."

Jones snorts, "Sure, Thallium."

>smash diamonds
(with the hammer)
Whoa, once is enough.

* * *

>e
Galaxy Jones is in the 100th floor elevator hall. The luxury is staggering.  The walls are made of polished black marble, and the floors are covered in plush black carpeting that muffles the sound of footsteps. The ceiling is high and adorned with a crystal chandelier. The elevator doors to the west are gold-plated. Sumptuous living quarters are visible to the north and south.

* * *

>s
Galaxy Jones is in the southern corner of the penthouse. This must be Thallium's "treasure room", to go by the obscene display of wealth. The most notable feature is the array of diamonds lining the walls. Everything else here pales in comparison. The penthouse continues to the northwest, north, and northeast.

Thallium seems to speak from all around Jones. "You like diamonds, Jones? Of course you do -- they're a girl's best friend, after all."

Jones snorts, "Sure, Thallium."

>smash diamonds
(with the hammer)
Jones only uses violent means when absolutely necessary.

>take diamond
You pry one of the diamonds out of the wall.

Thallium giggles. "Oh, I hope you're not disappointed, Jones."

>smash diamonds
(with the hammer)
Jones only uses violent means when absolutely necessary.

>x diamond
(the diamond)

Jones: "Hmm. This is made of glass."

Thallium: "Poor, sad Jones. But here's the thing. There is a real diamond in there; it's just you'll never find it before the building's defenses flood the whole floor with poisonous gas. Or maybe I'm bluffing. Maybe I'm not. Can you afford to gamble?"

Jones tosses the fake away.

>smash diamonds
(with the hammer)
Jones commences to smash all of the diamonds. After destroying several dozen fraudulent gems, she finds one that won't break. She takes the real diamond.

Thallium: "Wow, clever solution. Be careful you don't cut yourself."

Jones: "I appreciate your concern."

>smash diamonds
(with the hammer)
Whoa, once is enough.

>smash diamonds with cable
Jones only uses violent means when absolutely necessary.

>sw
The diamond-shaped penthouse bends to the northeast and northwest.

>put diamond in claw
There's nothing like that nearby.

>nw
Galaxy Jones is in the western corner of the penthouse. The purpose of this room is unclear. Instead of the black carpet that plagues the rest of the penthouse, the floor is fashioned from a striking polished red granite. Instead of windows, there are walls. Thallium's personal insignia, the ten planets in order overlaid with the motto "Planetas Vincam", is carved into the deep red wood outer wall, and inlaid with ebony. In the center of the room is a thin metal pillar ending in a claw, which looks like it's meant to hold something. Finally, there is something that looks like an electronic eye set into the inner wall. One may leave to the northeast or southeast.

* * *

>put diamond in claw
As soon as insert the diamond into the claw, laser beams spring from five emitters on the walls. They hit the diamond and join into a single more powerful beam that strikes the electronic eye on the wall. A sound like a sliding door comes from behind Jones, and she spins around to see the red wall slide down into the floor. It exposes a control panel of sorts, featuring a large red button labeled "Press Me".

>x panel
Jones discovers a secret panel, which when opened exposes a small black button.

>press black button
Somewhere beyond this room comes the sound of something heavy being moved.

Beck: "Why ever did you not press the button that said 'Press Me'? Maybe we should press it anyway. Please?"

>ne
Galaxy Jones is in the northern corner of the penthouse. This is Thallium's bedroom. Apart from the expansive round bed in the center of the room, notable features include the line of dummies displaying his various suits of clothes, a large vanity table, and the complete lack of mirrors on the ceiling, thankfully. One may leave the room to the southwest, south, and southeast.

* * *

>u
Jones gets onto the cage.

Thallium's flyer hovers over the rooftop. "Jones!"  he bellows. "Play time is over. I grow weary of your intransigence. In a moment this roof will be swarmed by guard robots -- of many different colors -- so many robots you couldn't possibly vandalize them all.  Say your prayers, Jones, or whatever you do when you're about to die."

Jones rolls her eyes.

A little ways off, a small red flyer aims for the rooftop and accelerates.

>throw hook at cage
Jones thinks twice and decides not to throw it after all.

>throw hook at flyer
Which do you mean, the red flyer or Admiral Thallium's Flyer?

>thallium's
 _________      __                     _____                     
 __/ ____/___ _/ /___ __  ____  __     __/ /___  ____  ___  _____
 _/ / __/ __ `/ / __ `/ |/ / / / /____ _/ / __ \/ __ \/ _ \/ ___/
 / /_/ / /_/ / / /_/ />  </ /_/ / _/ /_/ / /_/ / / / /  __(__  ) 
 \____/\__,_/_/\__,_/_/|_|\__, /  _\____/\____/_/ /_/\___/____/  
 _____________________________/ 

[Your score has just gone up by one point.]

Jones throws the cable up to the flyer where it hooks around the rail, and attaches the other end to the cage, then jumps off the cage to escape the aftermath. Seeing his flyer's predicament, Thallium jumps out of the craft and disappears below the edge of the roof. The flyer reaches the end of its tether and slingshots downwards, slamming into side of the building.

The cage has tilted to the side, one attachment torn loose from the rooftop. Jones crawls into the cage to see to Europa Callisto.

"Europa! Can you hear me? I need you to move to get out of this cage. I can't carry you through that small opening. Europa!"

Europa moans but doesn't show any signs of having understood Jones.

Galaxy Jones is in the cage. The whole structure is tilted, leaving a hole at the eastern end.

Jones is kneeling at Europa Callisto's side, trying to rouse her.

The red flyer, now recognizable as Galaxy's own, settles down onto the landing pad.

* * *

>w
Beck sticks his head out of the door of the flyer and yells "C'mon Jones, get Europa and get in the flyer!"

>scenes
Scene 'Entire Game' playing (for 111 mins now)
Scene 'Lobby Shootout' ended
Scene 'Cybernetica Battle' ended
Scene 'Lobby Shootout Aftermath' ended
Scene 'Endgame' playing (for 7 mins now)
Scene 'On-Rooftop' ended
Scene 'Thallium alight' ended
Scene 'Thallium ultimatum' ended
Scene 'Saving Europa' playing (for 3 mins now)
(Scene monitoring now switched on. Type "scenes off" to switch it off again.)

>rules
Rules tracing now switched on. Type "rules off" to switch it off again, or "rules all" to include even rules which do not apply.

[Rule "reset conversed this turn rule" applies.]
[Rule "clear LPR rule" applies.]

>e
[Rule "After deciding the scope of the player" applies.]
[Rule "After deciding the scope of the player" applies.]
[Rule "After deciding the scope of the player" applies.]
[Rule "declare everything initially unmentioned rule" applies.]
[Rule "standard set going variables rule" applies.]
[Rule "assign alternative door targets rule" applies.]
[Rule "announce items from multiple object lists rule" applies.]
[Rule "set pronouns from items from multiple object lists rule" applies.]
[Rule "before stage rule" applies.]
[Rule "keychain-aware carrying requirements rule" applies.]
[Rule "instead stage rule" applies.]
[Rule "Instead of going nowhere from the cage" applies.]
[Rule "A first turn sequence rule" applies.]
[Rule "every turn stage rule" applies.]
[Rule "reset protocol rule" applies.]
[Rule "A last turn sequence rule" applies.]
[Rule "notify score changes rule" applies.]
[Rule "show us the people rule" applies.]
[Rule "reset conversed this turn rule" applies.]
[Rule "clear LPR rule" applies.]

* * *

>s
Galaxy Jones is in the southern corner of the penthouse. This must be Thallium's "treasure room", to go by the obscene display of wealth. The most notable feature is the array of diamonds lining the walls. Everything else here pales in comparison. The penthouse continues to the northwest, north, and northeast.

Thallium seems to speak from all around Jones. "You like diamonds, Jones? Of course you do -- they're a girl's best friend, after all."

Jones snorts, "Sure, Thallium."

>smash diamonds
(with the hammer)
That doesn't accomplish much.

* * *

>s
Galaxy Jones is in the southern corner of the penthouse. This must be Thallium's "treasure room", to go by the obscene display of wealth. The most notable feature is the array of diamonds lining the walls. Everything else here pales in comparison. The penthouse continues to the northwest, north, and northeast.

Thallium seems to speak from all around Jones. "You like diamonds, Jones? Of course you do -- they're a girl's best friend, after all."

Jones snorts, "Sure, Thallium."

>smash diamonds
(with the hammer)
Jones commences to smash all of the diamonds. After destroying several dozen fraudulent gems, she finds one that won't break. She takes the real diamond.

Thallium: "Wow, clever solution. Be careful you don't cut yourself."

Jones: "I appreciate your concern."

>i
Jones is carrying:
  a diamond
  a screwdriver
  a black cardkey
  a full water bottle
  an elevator drop key
  a hammer
  a safety pin
  a garish medal
  a fork
  a red cardkey
  an Atmo-Suit
  a cable with hooks at either end
  a disruptor pistol

>take diamon
There's nothing like that nearby.

>take diamond
(the diamond)
Jones already has that.

* * *

>n
The exit is to the east.

>e
Galaxy Jones is in the 100th floor elevator hall. The luxury is staggering.  The walls are made of polished black marble, and the floors are covered in plush black carpeting that muffles the sound of footsteps. The ceiling is high and adorned with a crystal chandelier. The elevator doors to the west are gold-plated. Sumptuous living quarters are visible to the north and south.