>ask about speeder
Beck: "I keep reminding you, but you still haven't taken it in for yearly maintenance."

>x speeder
Galaxy Jones is in the speeder dock. A safe harbor from the periodic dust storms of Utopia Planitia, the dock features several dozen speeder bays. Only a few are filled right now. The building entryway is to the north, under a red stone façade carved into the likeness of a fearsome Viking.

Jones's speeder, Galaxy One, sits in one of the parking bays.

A safe harbor from the periodic dust storms of Utopia Planitia, the dock features several dozen speeder bays. Only a few are filled right now. The building entryway is to the north, under a red stone façade carved into the likeness of a fearsome Viking.

* * *

>ask beck about himself
Beck: "I'm just happy to serve."

>ask beck about me
Beck: "Well, I think you're very nice, Jones."

>ask beck about jones
Beck: "Well, I think you're very nice, Jones."

* * *

>gonear cage
(the cage)
Galaxy Jones is next to the cage. The closely-set silnium bars seem to dash all hope of a rescue.

Europa Callisto is lying at the center of the cage, out of Jones's reach.

Jones tries the strength of the bars just in case. They don't budge.

South of the cage, Thallium crosses the roof to the flyer pad, where he boards the waiting flyer. The flyer lifts off and moves towards Jones.

>x cage
The cage is huge for holding just one prisoner. The silnium bars are grey and iridescent. They run both horizontally and vertically, creating a lattice.

Thallium's flyer hovers over the rooftop. "Jones!"  he bellows. "Play time is over. I grow weary of your intransigence. In a moment this roof will be swarmed by guard robots -- of many different colors -- so many robots you couldn't possibly vandalize them all.  Say your prayers, Jones, or whatever you do when you're about to die."

Jones rolls her eyes.

A little ways off, a small red flyer aims for the rooftop and accelerates.

>l
Galaxy Jones is next to the cage. The closely-set silnium bars seem to dash all hope of a rescue.

Europa Callisto is lying at the center of the cage, out of Jones's reach.

>x roof
There's nothing like that nearby.

>n
Jones can't go that way.

>s
Thallium's flyer floats after Jones.

Jones opens the door and steps through onto the roof. The door crashes shut, and a lock audibly clicks.
 _________      __                     _____                     
 __/ ____/___ _/ /___ __  ____  __     __/ /___  ____  ___  _____
 _/ / __/ __ `/ / __ `/ |/ / / / /____ _/ / __ \/ __ \/ _ \/ ___/
 / /_/ / /_/ / / /_/ />  </ /_/ / _/ /_/ / /_/ / / / /  __(__  ) 
 \____/\__,_/_/\__,_/_/|_|\__, /  _\____/\____/_/ /_/\___/____/  
 _____________________________/ 

[Your score has just gone up by one point.]

Jones walks out onto the luxurious penthouse roof. Admiral Thallium turns from the railing to face her. He is dressed in an absurd elaboration of a Martian Admiral's uniform. He looks Jones up and down with a lecherous leer. "Ah, Galaxy Jones, as lovely as ever. If it weren't so unbearably cliché I'd ask you to join me in my rise to greatness. But alas, you are too habituated to the smug high of 'goodness'." He sighs dramatically. "We've trodden similar ground before; no need to discuss it further. Although I would challenge any of your various amoureux to conjugate 'tread' correctly.

"Anyway, I guess this is the time where you do something predictably undignified and violent. Before you do I feel I should inform you that your sidearm has been rendered quite ineffective by my personal security field. But do go ahead and try it."

Jones sneers. "I wouldn't give you the satisfaction," she says, looking around. "I see you don't have any of your robot pets up here. How are you going to stop me from rescuing Europa?"

"Oh please, while we're trying things, try that too. I wish you luck breaking the silnium bars of the cage."

"What's silnium?"

"A superstrong material invented here in my Martian Chemical laboratory. We had a press conference for it -- weren't you watching?"

"Couldn't be bothered."

"Oh for frotz sake, Jones, you're so frustrating!"

Thallium turns his back on Jones and stares out over the city.

Galaxy Jones is on the penthouse roof. It is an extravagant and opulent space, designed to showcase Thallium's wealth and power. Much of the rooftop is devoted to an outdoor lounge area, with comfortable seating and a fire pit, centered around a hot tub and flanked by a bar. All around is the city of New Reykjavik, and beyond that the red Martian landscape. Around the entirety of the roof is an electrostatic field designed to keep air in and particulates out. To the north is a large cage, and to the west is a landing pad. Jones can distantly see a woman lying on the floor of the cage.

>x roof
Looking strangely out of place, it is a common grey metal door with a push bar.

>x penthouse roof
There's nothing like that nearby.

* * *

>gonear ninth hall
(the ninth floor elevator hall)
Galaxy Jones is in the ninth floor elevator hall. The elevator is to the west, the stairwell is to the east, and a corridor leads north and south. There is a bottled water vending machine here.

>x ninth
Which do you mean, the ninth floor elevator door or the nfeh?

>n
I only understood you as far as wanting to examine north.

>n
Galaxy Jones is in the ninth floor north hallway. This anonymous corporate hallway ends here at the north end of the building. An open doorway leads west. To the east is a door with a swipe lock, labeled "Cybernetica Inc."

>x doorway
There's nothing like that nearby.

* * *

>gonear roof stairs
(the roof stairs)
Galaxy Jones is on the roof stairs. Thick slabs of marble lead from the hall to the west to the rooftop door above.

>x stairs
Galaxy Jones is on the roof stairs. Thick slabs of marble lead from the hall to the west to the rooftop door above.

>x roof
Which do you mean, the roof access door or the roof stairs?

>access
Looking strangely out of place, it is a common grey metal door with a push bar.

* * *

>gonear top of
Galaxy Jones is on the top of the elevator car. The elevator shaft extends many hundreds of feet above here. She can see down into the elevator car from here.

>x car
Jones is standing on top of the elevator car.

The elevator car is empty.

* * *

>gonear top of the elevator car
Galaxy Jones is on the top of the elevator car. The elevator shaft extends many hundreds of feet above here. She can see down into the elevator car from here.

>x car
Jones is standing on top of the elevator car.

>x elevator
Which do you mean, the elevator car or the elevator shaft?

>car
Jones is standing on top of the elevator car.

>x shaft
The shaft extends far up into the darkness. The ladder here is missing, making it impossible to climb up to the eleventh floor and beyond.

>look down
The elevator car is empty.

>actions
Actions listing on.

>x elevator car
[examining the elevator car]
Jones is standing on top of the elevator car.
[examining the elevator car - failed]

* * *

>in
Jones approaches the Viking Building entryway, the dramatic façade towering over her.

Galaxy Jones is at the entry doorway. A glass revolving door leads into a large open space north of here. The speeder dock is to the south.

Jones peers upwards at the 100 stories of glass and steel. "What do you want to bet Thallium's got Europa all the way at the top?"

Beck: "Oh, no doubt."

>in
Jones takes a deep breath. "I'm going in."

Beck replies, "You got this, Galaxy."

Jones passes through the revolving door and into the lobby, alert to any defenses.

Galaxy Jones is in the lobby. The ground floor of the Viking Building is breathtaking. Low-G architecture means more glass and thinner supports, and the building takes advantage of that. Four walls of glass surround a central pillar in which are set the utility rooms and elevators. In between is an expanse of plants, water features, and stylish seating. Near the entryway is a front desk. A giant crystal sculpture floats above the center of the area, suspended on almost invisible cables. She may go east and west from here, north to the elevators, or south out of the building.

Suddenly two robot guards, green and red, emerge from niches in the back wall! She dives behind the front desk and draws her disruptor pistol.

Jones shouts, "I'm under fire from two ugly robot things!"

Beck responds, "Monitoring your suit radar."

>out
Trying to reach an exit would surely get Jones shot.

Jones: "I'm pinned down here!"

One of the robots fires directly above her head.

>shoot art
Jones fires the disruptor into the sculpture's main support cable, snapping it. The huge crystal blob starts to sag, straining the other cables. In quick succession they break as well, and the whole installation plummets to the ground, right on top of the hapless guard robots.
 _________      __                     _____                     
 __/ ____/___ _/ /___ __  ____  __     __/ /___  ____  ___  _____
 _/ / __/ __ `/ / __ `/ |/ / / / /____ _/ / __ \/ __ \/ _ \/ ___/
 / /_/ / /_/ / / /_/ />  </ /_/ / _/ /_/ / /_/ / / / /  __(__  ) 
 \____/\__,_/_/\__,_/_/|_|\__, /  _\____/\____/_/ /_/\___/____/  
 _____________________________/ 

[Your score has just gone up by one point.]

Beck: "What was that crash? What's going on?"

Jones: "That, my friend, was what you'd call a work of art. Targets terminated."

>out
Jones leaves the building.

Galaxy Jones is at the entry doorway. A glass revolving door leads into a large open space north of here. The speeder dock is to the south.

>out
Jones slinks back to the speeder dock.

Galaxy Jones is in the speeder dock. A safe harbor from the periodic dust storms of Utopia Planitia, the dock features several dozen speeder bays. Only a few are filled right now. The building entryway is to the north, under a red stone façade carved into the likeness of a fearsome Viking.

Her speeder, Galaxy One, sits in one of the parking bays.

>enter
You must supply a noun.

>enter building
Galaxy Jones is at the entry doorway. A glass revolving door leads into a large open space north of here. The speeder dock is to the south.

>enter building
Galaxy Jones is in the lobby. The ground floor of the Viking Building is breathtaking. Low-G architecture means more glass and thinner supports, and the building takes advantage of that. Four walls of glass surround a central pillar in which are set the utility rooms and elevators. In between is an expanse of plants, water features, and stylish seating. Near the entryway is a front desk. Jones may go east and west from here, north to the elevators, or south out of the building. There are two niches in the central wall from which the guard robots emerged.

Spread across the floor in a tangled ruin are the remains of a giant crystal sculpture and two guard robots.

>enter building
Galaxy Jones is in the ground floor elevator hall. This hallway between the north and south ends of the ground floor is home to the elevator to the west. To the east is the entrance to a stairwell.

Admiral Thallium's voice booms from the ceiling. "Little Galaxy thinks she's beaten the big bad Admiral. Sorry dear, that was only a taste."

>exit
But Jones isn't in anything at the moment.

>s
Galaxy Jones is in the lobby. The ground floor of the Viking Building is breathtaking. Low-G architecture means more glass and thinner supports, and the building takes advantage of that. Four walls of glass surround a central pillar in which are set the utility rooms and elevators. In between is an expanse of plants, water features, and stylish seating. Near the entryway is a front desk. Jones may go east and west from here, north to the elevators, or south out of the building. There are two niches in the central wall from which the guard robots emerged.

Spread across the floor in a tangled ruin are the remains of a giant crystal sculpture and two guard robots.

>exit
Galaxy Jones is at the entry doorway. A glass revolving door leads into a large open space north of here. The speeder dock is to the south.

>exit
Galaxy Jones is in the speeder dock. A safe harbor from the periodic dust storms of Utopia Planitia, the dock features several dozen speeder bays. Only a few are filled right now. The building entryway is to the north, under a red stone façade carved into the likeness of a fearsome Viking.

Jones's speeder, Galaxy One, sits in one of the parking bays.

* * *

>n
Jones approaches the Viking Building entryway, the dramatic façade towering over her.

Galaxy Jones is at the entry doorway. A glass revolving door leads into a large open space north of here. The speeder dock is to the south.

Jones peers upwards at the 100 stories of glass and steel. "What do you want to bet Thallium's got Europa all the way at the top?"

Beck: "Oh, no doubt."

>n
Jones approaches the Viking Building entryway, the dramatic façade towering over her.

Galaxy Jones is at the entry doorway. A glass revolving door leads into a large open space north of here. The speeder dock is to the south.

Jones peers upwards at the 100 stories of glass and steel. "What do you want to bet Thallium's got Europa all the way at the top?"

Beck: "Oh, no doubt."

* * *

>shoot art
Jones fires the disruptor into the sculpture's main support cable, snapping it. The huge crystal blob starts to sag, straining the other cables. In quick succession they break as well, and the whole installation plummets to the ground, right on top of the hapless guard robots.
 _________      __                     _____                     
 __/ ____/___ _/ /___ __  ____  __     __/ /___  ____  ___  _____
 _/ / __/ __ `/ / __ `/ |/ / / / /____ _/ / __ \/ __ \/ _ \/ ___/
 / /_/ / /_/ / / /_/ />  </ /_/ / _/ /_/ / /_/ / / / /  __(__  ) 
 \____/\__,_/_/\__,_/_/|_|\__, /  _\____/\____/_/ /_/\___/____/  
 _____________________________/ 

[Your score has just gone up by one point.]

Beck: "What was that crash? What's going on?"

Jones: "That, my friend, was what you'd call a work of art. Targets terminated."

Admiral Thallium's voice booms from the ceiling. "Little Galaxy thinks she's beaten the big bad Admiral. Sorry dear, that's only a taste."

* * *

>n
Jones approaches the Viking Building entryway, the dramatic façade towering over her.

Galaxy Jones is at the entry doorway. A glass revolving door leads into a large open space north of here. The speeder dock is to the south.

Jones peers upwards at the 100 stories of glass and steel. "What do you want to bet Thallium's got Europa all the way at the top?"

Beck: "Oh, no doubt."

>about
Beck: "Well, you can ask about: INTERACTIVE FICTION, COMMANDS, or CREDITS."

>credits
"Here are the credits:"

Extensions by:
Standard Rules version 3/120430 by Graham Nelson
Deluxe Doors version 4 by Emily Short
Skeleton Keys by Emily Short
Epistemology version 9 by Eric Eve
Conversation Framework version 11 by Eric Eve
Property Checking version 4 by Emily Short
Gender Options version 3/210331 by Nathanael Nerode

Story by Phil Riley.
Programming by Phil Riley.
Playtesting by Leon Lin, Oliver Matthias, and Jade.
Invaluable inspiration from Laura Taalman.

* * *

>n
Jones approaches the Viking Building entryway, the dramatic façade towering over her.

Galaxy Jones is at the entry doorway. A glass revolving door leads into a large open space north of here. The speeder dock is to the south.

Jones peers upwards at the 100 stories of glass and steel. "What do you want to bet Thallium's got Europa all the way at the top?"

Beck: "Oh, no doubt."

>ask beck about beck
Beck: "I'm just happy to serve."

* * *

>n
Jones approaches the Viking Building entryway, the dramatic façade towering over her.

Galaxy Jones is at the entry doorway. A glass revolving door leads into a large open space north of here. The speeder dock is to the south.

Jones peers upwards at the 100 stories of glass and steel. "What do you want to bet Thallium's got Europa all the way at the top?"

Beck: "Oh, no doubt."

>ask beck for help
Beck: "Looks like you're managing okay."

* * *

>ask beck for help
Beck: "I dunno, maybe shoot the robots?"

A robot fires a blistering shot into the front desk.

Beck: "How's it going in there?"

"Jones: "You know -- like all art, it's hit or miss."

>g
Beck: "I dunno, maybe shoot the robots?"

A robot fires a blistering shot into the front desk.

Jones: "I could use some ideas here!"

>shoot robot
Oof. Big miss.

The robots intone "Destroy Jones" in an eerie drone.

>shoot robot
Jones sticks her head out from behind the desk and squeezes off a shot at the guard robots. In Jones's haste it goes wide of the target.

>shoot robot
Jones's shot hits the guard robots dead on, but nothing happens, almost as if the robot had absorbed the energy.

Jones: "Target seems to be absorbing disruptor fire. This will make things a little harder."

The robots intone "Destroy Jones" in an eerie drone.

>ask beck for help
Beck: "Well, if your energy weapon won't hurt them, maybe direct physical force will?"

The two robots coordinate fire over the desk, narrowly missing Jones.

>g
Beck: "It would have to be something large. Throwing your shoe at them isn't going to cut it."

>g
Beck: "That sculpture up there seems pretty big."

* * *

I beg your pardon?

>x lobby
Galaxy Jones is in the lobby. The ground floor of the Viking Building is breathtaking. Low-G architecture means more glass and thinner supports, and the building takes advantage of that. Four walls of glass surround a central pillar in which are set the utility rooms and elevators. In between is an expanse of plants, water features, and stylish seating. Near the entryway is a front desk. A giant crystal sculpture floats above the center of the area, suspended on almost invisible cables. Jones may go east and west from here, north to the elevators, or south out of the building. There are two niches in the central wall from which the guard robots emerged.

The guard robots have their head cannons trained on the front desk.

>x lobby
Galaxy Jones is in the lobby. The ground floor of the Viking Building is breathtaking. Low-G architecture means more glass and thinner supports, and the building takes advantage of that. Four walls of glass surround a central pillar in which are set the utility rooms and elevators. In between is an expanse of plants, water features, and stylish seating. Near the entryway is a front desk. A giant crystal sculpture floats above the center of the area, suspended on almost invisible cables. Jones may go east and west from here, north to the elevators, or south out of the building. There are two niches in the central wall from which the guard robots emerged.

Two guard robots, red and green, criss-cross the lobby, stalking her.

A robot fires a blistering shot into the front desk.

Beck: "How's it going in there?"

"Jones: "You know -- like all art, it's hit or miss."

>n
Trying to reach an exit would surely get Jones shot.

Jones: "I'm pinned down here!"

Beck: "Robot on your right!"

One robot tries to flank her, but a shot from her disruptor sends it scurrying back.

* * *

>ask robot about art
They're not likely to be helpful.

Jones: "I could use some ideas here!"

>ask robot about art
They're not likely to be helpful.

>ask robot about art
They're not likely to be helpful.

>ask robot about art
They're not likely to be helpful.

A robot fires a blistering shot into the front desk.

>ask robot about art
They're not likely to be helpful.

Beck: "Robot on your right!"

One robot tries to flank Jones, but a shot from her disruptor sends it scurrying back.

>ask beck about art
Beck: "It's huge. Imagine if it fell on you."

* * *

>ask robot about art
They're not likely to be helpful.

Jones: "I could use some ideas here!"

>ask robot about asdf
They're not likely to be helpful.

* * *

>n
Jones takes a deep breath. "I'm going in."

Beck replies, "You got this, Galaxy."

Jones passes through the revolving door and into the lobby, alert to any defenses.

Galaxy Jones is in the lobby. The ground floor of the Viking Building is breathtaking. Low-G architecture means more glass and thinner supports, and the building takes advantage of that. Four walls of glass surround a central pillar in which are set the utility rooms and elevators. In between is an expanse of plants, water features, and stylish seating. Near the entryway is a front desk. A giant crystal sculpture floats above the center of the area, suspended on almost invisible cables. She may go east and west from here, north to the elevators, or south out of the building.

Suddenly two robot guards, green and red, emerge from niches in the back wall! She dives behind the front desk and draws her disruptor pistol.

Jones shouts, "I'm under fire from two ugly robot things!"

Beck responds, "Monitoring your suit radar."

* * *

>n
Galaxy Jones is in the ground floor elevator hall. This hallway between the north and south ends of the ground floor is home to the elevator to the west. To the east is the entrance to a stairwell.

Admiral Thallium's voice booms from the ceiling. "Little Galaxy thinks she's beaten the big bad Admiral. Sorry dear, that's only a taste."

>s
Galaxy Jones is in the lobby. The ground floor of the Viking Building is breathtaking. Low-G architecture means more glass and thinner supports, and the building takes advantage of that. Four walls of glass surround a central pillar in which are set the utility rooms and elevators. In between is an expanse of plants, water features, and stylish seating. Near the entryway is a front desk. Jones may go east and west from here, north to the elevators, or south out of the building. There are two niches in the central wall from which the guard robots emerged.

Spread across the floor in a tangled ruin are the remains of a giant crystal sculpture and two guard robots.

>e
Jones crosses the floor carefully, disruptor pistol at the ready.

Galaxy Jones is at the southeast corner of the ground floor. The centerpiece of this area is the actual Viking 2 lander, which landed right here on Utopia Planitia. The glass walls look out onto the city. She can go north or west from here.

>w
Galaxy Jones is in the lobby. The ground floor of the Viking Building is breathtaking. Low-G architecture means more glass and thinner supports, and the building takes advantage of that. Four walls of glass surround a central pillar in which are set the utility rooms and elevators. In between is an expanse of plants, water features, and stylish seating. Near the entryway is a front desk. Jones may go east and west from here, north to the elevators, or south out of the building. There are two niches in the central wall from which the guard robots emerged.

Spread across the floor in a tangled ruin are the remains of a giant crystal sculpture and two guard robots.

* * *

>w
Jones crosses the floor carefully, disruptor pistol at the ready.

Galaxy Jones is at the southwest corner of the ground floor. A lush waterfall here contrasts with the dusty red streets of New Reykjavik beyond the glass walls. The ground floor extends north and east.

Admiral Thallium's voice booms from the ceiling. "Little Galaxy thinks she's beaten the big bad Admiral. Sorry dear, that's only a taste."

* * *

>shoot robot
Oof. Big miss.

Beck: "How's it going in there?"

"Jones: "You know -- like all art, it's hit or miss."

>g
A barrage of fire from the robots prevents Jones from firing.

One of the robots fires directly above her head.

>g
Jones's shot hits the guard robots dead on, but nothing happens, almost as if the robot had absorbed the energy.

Jones: "Target seems to be absorbing disruptor fire. This will make things a little harder."

>ask beck about robot
Beck: "It doesn't look like shooting the robots is doing any good. Is there another way you can hurt them?"

The robots intone "Destroy Jones" in an eerie drone.

Jones: "I could use some ideas here!"

>ask beck for help
Beck: "Well, if your energy weapon won't hurt them, maybe direct physical force will?"

>ask beck for help
Beck: "It would have to be something large. Throwing your shoe at them isn't going to cut it."

A robot fires a blistering shot into the front desk.

>ask beck for help
Beck: "That sculpture up there seems pretty big."

Beck: "Robot on your right!"

One robot tries to flank Jones, but a shot from her disruptor sends it scurrying back.

>ask beck for help
Beck: "That sculpture up there seems pretty big."

>shoot art
Jones fires the disruptor into the sculpture's main support cable, snapping it. The huge crystal blob starts to sag, straining the other cables. In quick succession they break as well, and the whole installation plummets to the ground, right on top of the hapless guard robots.
 _________      __                     _____                     
 __/ ____/___ _/ /___ __  ____  __     __/ /___  ____  ___  _____
 _/ / __/ __ `/ / __ `/ |/ / / / /____ _/ / __ \/ __ \/ _ \/ ___/
 / /_/ / /_/ / / /_/ />  </ /_/ / _/ /_/ / /_/ / / / /  __(__  ) 
 \____/\__,_/_/\__,_/_/|_|\__, /  _\____/\____/_/ /_/\___/____/  
 _____________________________/ 

[Your score has just gone up by one point.]

Beck: "What was that crash? What's going on?"

Jones: "That, my friend, was what you'd call a work of art. Targets terminated."

* * *

>t about beck
You need to specify who you want to speak to.

>tell robot about beck
It's doubtful it is interested.

>t about beck
It's doubtful it is interested.

>t beck
It's doubtful it is interested.

* * *

>tell robot about art
It's doubtful that's interested.

>gonear admiral
(Admiral Thallium)
Galaxy Jones is on the penthouse roof. It is an extravagant and opulent space, designed to showcase Thallium's wealth and power. Much of the rooftop is devoted to an outdoor lounge area, with comfortable seating and a fire pit, centered around a hot tub and flanked by a bar. All around is the city of New Reykjavik, and beyond that the red Martian landscape. Around the entirety of the roof is an electrostatic field designed to keep air in and particulates out. To the north is a large cage, and to the west is a landing pad. Jones can distantly see a woman lying on the floor of the cage. A green and black flyer sits on the landing pad.

Admiral Thallium is sulking.

The guard robots have their head cannons trained on the front desk.

Beck: "How's it going in there?"

"Jones: "You know -- like all art, it's hit or miss."

>tell robot about art\
There's nothing like that nearby.

>tell robot about art
There's nothing like that nearby.

>tell admiral about admiral
(Admiral Thallium about Admiral Thallium)
It's doubtful he's interested.

One of the robots fires directly above Jones's head.

>restart
Are you sure you want to restart?

* * *

>talk to robot
Jones says hello to the guard robots.

Zip! Disruptor fire scorches a nearby couch.

Jones: "I could use some ideas here!"

>t robot
It's doubtful that's interested.

A robot fires a blistering shot into the front desk.

>t beck
It's doubtful that's interested.

* * *

>n
Jones approaches the Viking Building entryway, the dramatic façade towering over her.

Galaxy Jones is at the entry doorway. A glass revolving door leads into a large open space north of here. The speeder dock is to the south.

Jones peers upwards at the 100 stories of glass and steel. "What do you want to bet Thallium's got Europa all the way at the top?"

Beck: "Oh, no doubt."

>x doorway
Galaxy Jones is at the entry doorway. A glass revolving door leads into a large open space north of here. The speeder dock is to the south.

A glass revolving door leads into a large open space north of here. The speeder dock is to the south.

>x door
A glass revolving door emblazoned with the symbol of a Viking king astride the planet Mars.

>x entry
Galaxy Jones is at the entry doorway. A glass revolving door leads into a large open space north of here. The speeder dock is to the south.

A glass revolving door leads into a large open space north of here. The speeder dock is to the south.

>n
Jones takes a deep breath. "I'm going in."

Beck replies, "You got this, Galaxy."

Jones passes through the revolving door and into the lobby, alert to any defenses.

Galaxy Jones is in the lobby. The ground floor of the Viking Building is breathtaking. Low-G architecture means more glass and thinner supports, and the building takes advantage of that. Four walls of glass surround a central pillar in which are set the utility rooms and elevators. In between is an expanse of plants, water features, and stylish seating. Near the entryway is a front desk. A giant crystal sculpture floats above the center of the area, suspended on almost invisible cables. She may go east and west from here, north to the elevators, or south out of the building.

Suddenly two robot guards, green and red, emerge from niches in the back wall! She dives behind the front desk and draws her disruptor pistol.

Jones shouts, "I'm under fire from two ugly robot things!"

Beck responds, "Monitoring your suit radar."

>x lobby
Galaxy Jones is in the lobby. The ground floor of the Viking Building is breathtaking. Low-G architecture means more glass and thinner supports, and the building takes advantage of that. Four walls of glass surround a central pillar in which are set the utility rooms and elevators. In between is an expanse of plants, water features, and stylish seating. Near the entryway is a front desk. A giant crystal sculpture floats above the center of the area, suspended on almost invisible cables. Jones may go east and west from here, north to the elevators, or south out of the building. There are two niches in the central wall from which the guard robots emerged.

Two guard robots, red and green, criss-cross the lobby, stalking her.

The ground floor of the Viking Building is breathtaking. Low-G architecture means more glass and thinner supports, and the building takes advantage of that. Four walls of glass surround a central pillar in which are set the utility rooms and elevators. In between is an expanse of plants, water features, and stylish seating. Near the entryway is a front desk. A giant crystal sculpture floats above the center of the area, suspended on almost invisible cables. She may go east and west from here, north to the elevators, or south out of the building. There are two niches in the central wall from which the guard robots emerged.

Beck: "Robot on your right!"

One robot tries to flank her, but a shot from her disruptor sends it scurrying back.

>s
Trying to reach an exit would surely get Jones shot.

Jones: "I'm pinned down here!"

>s
Trying to reach an exit would surely get Jones shot.

Jones: "I could use some ideas here!"

* * *

>shout
(hello to Beck)
Jones is already talking to Beck.

>shout to speeder
I didn't understand that sentence.

>x speeder
Galaxy Jones is in the speeder dock. A safe harbor from the periodic dust storms of Utopia Planitia, the dock features several dozen speeder bays. Only a few are filled right now. The building entryway is to the north, under a red stone façade carved into the likeness of a fearsome Viking.

Jones's speeder, Galaxy One, sits in one of the parking bays.

* * *

>t beck
Don't worry, Galaxy Jones will tell Beck what he needs to know.

>a beck
Beck: "I'm just happy to serve."

>n
Jones approaches the Viking Building entryway, the dramatic façade towering over her.

Galaxy Jones is at the entry doorway. A glass revolving door leads into a large open space north of here. The speeder dock is to the south.

Jones peers upwards at the 100 stories of glass and steel. "What do you want to bet Thallium's got Europa all the way at the top?"

Beck: "Oh, no doubt."

* * *

>tell robots about robot
It's doubtful it is interested.

The robots intone "Destroy Jones" in an eerie drone.

>a robot
Beck: "Keep your head down and keep firing."

A robot fires a blistering shot into the front desk.

Jones: "I could use some ideas here!"

* * *

>t beck about beck
(addressing Beck)
Don't worry, Galaxy Jones will tell Beck what he needs to know.

>t beck about me
Don't worry, Galaxy Jones will tell Beck what he needs to know.

>t beck about speeder dock
Don't worry, Galaxy Jones will tell Beck what he needs to know.

>tell beck about me
Don't worry, Galaxy Jones will tell Beck what he needs to know.

>tell beck about beck
Don't worry, Galaxy Jones will tell Beck what he needs to know.

* * *

>t dock
Don't worry, Galaxy Jones will tell Beck what he needs to know.

>n
Jones approaches the Viking Building entryway, the dramatic façade towering over her.

Galaxy Jones is at the entry doorway. A glass revolving door leads into a large open space north of here. The speeder dock is to the south.

Jones peers upwards at the 100 stories of glass and steel. "What do you want to bet Thallium's got Europa all the way at the top?"

Beck: "Oh, no doubt."

>a dock
Beck: "Guess everyone went home when Thallium went ape."

>ask beck about commands
"Here's a partial list of commands with explanations and/or examples:"
 
 * TAKE: TAKE GOLD COIN
 * DROP: DROP GOLD COIN
 * I: list the player's possessions
 * X: examine something; X GOLD COIN
 * L: look around
 * CLIMB: CLIMB BEANSTALK
 * GET OFF: GET OFF BEANSTALK
 * PUT INTO: PUT GOLD COIN INTO TREASURE CHEST
 * PUSH: PUSH BIG RED BUTTON
 
 not to mention POUR, TYPE, OPEN, CLOSE, UNLOCK, SHOOT, and a few others you'll have to figure out for yourself.

>shout to pistol
I didn't understand that sentence.

>shout
(hello to the disruptor pistol)
The disruptor pistol does not respond.

>me, hi
Jones is already talking to Beck.

>beck, hello
Jones is already talking to Beck.

>me, hello
Jones is already talking to Beck.

>jones, hello
Jones is already talking to Beck.

>shout
(hello to the disruptor pistol)
The disruptor pistol does not respond.

>n
Jones takes a deep breath. "I'm going in."

Beck replies, "You got this, Galaxy."

Jones passes through the revolving door and into the lobby, alert to any defenses.

Galaxy Jones is in the lobby. The ground floor of the Viking Building is breathtaking. Low-G architecture means more glass and thinner supports, and the building takes advantage of that. Four walls of glass surround a central pillar in which are set the utility rooms and elevators. In between is an expanse of plants, water features, and stylish seating. Near the entryway is a front desk. A giant crystal sculpture floats above the center of the area, suspended on almost invisible cables. She may go east and west from here, north to the elevators, or south out of the building.

Suddenly two robot guards, green and red, emerge from niches in the back wall! She dives behind the front desk and draws her disruptor pistol.

Jones shouts, "I'm under fire from two ugly robot things!"

Beck responds, "Monitoring your suit radar."

>shout
(hello to the disruptor pistol)
The disruptor pistol does not respond.

Zip! Disruptor fire scorches a nearby couch.

Beck: "How's it going in there?"

"Jones: "You know -- like all art, it's hit or miss."

>showme pistol
disruptor pistol - thing
location: carried by Jones in the lobby
singular-named, improper-named, unused; unlit, inedible, portable, handled, neuter, seen, familiar, non-pourable
list grouping key: none
printed name: "disruptor pistol"
printed plural name: none
indefinite article: none
most recent reference: nominal
third singular pronoun: It-pronoun
conversation: none
description: "A compact instrument of death, with only one setting: kill."
initial appearance: none
third-plural-pronoun: They-pronoun

>restart
Are you sure you want to restart?

* * *

>trace 5
[Parser tracing set to level 5.]

* * *

>tell beck about beck
Don't worry, Galaxy Jones will tell Beck what he needs to know.

>ask beck for dock
Jones is more than capable of acquiring things by herself.

>ask beck for help
Beck: "Looks like you're managing okay."

* * *

>ask robot for robot
Jones is more than capable of acquiring things by herself.

>talk to robot
Jones is already talking to the guard robots.

Jones: "I could use some ideas here!"

* * *

>tell beck about beck
Don't worry, Galaxy Jones will tell Beck what he needs to know.

>tell beck
That's not a verb I recognise.

>t beck
(addressing Beck)
Don't worry, Galaxy Jones will tell Beck what he needs to know.

>tell beck about me
That's not a verb I recognise.

>tell beck about pistol
That's not a verb I recognise.

>showme pistol
disruptor pistol - thing
location: carried by Jones in the speeder dock
singular-named, improper-named, unused; unlit, inedible, portable, handled, neuter, seen, familiar, non-pourable
list grouping key: none
printed name: "disruptor pistol"
printed plural name: none
indefinite article: none
most recent reference: nominal
third singular pronoun: It-pronoun
conversation: none
description: "A compact instrument of death, with only one setting: kill."
initial appearance: none
third-plural-pronoun: They-pronoun

>epistat me
Jones - seen / familiar / known.

* * *

>tell beck about speeder
That's not a verb I recognise.

>tell beck about speeder dock
That's not a verb I recognise.

>tell beck about galaxy one
That's not a verb I recognise.

>trace 5
[Parser tracing set to level 5.]

>tell beck about galaxy one
[ "tell" ? / "beck" beck / "about" about / "galaxy" galaxy / "one" one ]
   [NounDomain called at word 1
   seeking definite object
    Trying the north (1034888) at word 1
Parse_name called
Pass 1: 0 Pass 2: 0 Pass 3: 0
    Trying the northeast (1034920) at word 1
Parse_name called
Pass 1: 0 Pass 2: 0 Pass 3: 0
    Trying the northwest (1034952) at word 1
Parse_name called
Pass 1: 0 Pass 2: 0 Pass 3: 0
    Trying the south (1034984) at word 1
Parse_name called
Pass 1: 0 Pass 2: 0 Pass 3: 0
    Trying the southeast (1035016) at word 1
Parse_name called
Pass 1: 0 Pass 2: 0 Pass 3: 0
    Trying the southwest (1035048) at word 1
Parse_name called
Pass 1: 0 Pass 2: 0 Pass 3: 0
    Trying the east (1035080) at word 1
Parse_name called
Pass 1: 0 Pass 2: 0 Pass 3: 0
    Trying the west (1035112) at word 1
Parse_name called
Pass 1: 0 Pass 2: 0 Pass 3: 0
    Trying the up (1035144) at word 1
Parse_name called
Pass 1: 0 Pass 2: 0 Pass 3: 0
    Trying the down (1035176) at word 1
Parse_name called
Pass 1: 0 Pass 2: 0 Pass 3: 0
    Trying the inside (1035208) at word 1
Parse_name called
Pass 1: 0 Pass 2: 0 Pass 3: 0
    Trying the outside (1035240) at word 1
Parse_name called
Pass 1: 0 Pass 2: 0 Pass 3: 0
    Trying the speeder dock (1036008) at word 1
    Trying the building entryway (1041640) at word 1
Parse_name called
Pass 1: 0 Pass 2: 0 Pass 3: 0
    Trying outside (1041384) at word 1
Parse_name called
Pass 1: 0 Pass 2: 0 Pass 3: 0
    Trying Jones (1036040) at word 1
Parse_name called
Pass 1: 0 Pass 2: 0 Pass 3: 0
    Trying the disruptor pistol (1036072) at word 1
Parse_name called
Pass 1: 0 Pass 2: 0 Pass 3: 0
    Trying the speeder (1036104) at word 1
Parse_name called
Pass 1: 0 Pass 2: 0 Pass 3: 0
    Trying the windows (1041544) at word 1
    Trying the turbines (1041576) at word 1
Parse_name called
Pass 1: 0 Pass 2: 0 Pass 3: 0
    Trying the wings (1041608) at word 1
Parse_name called
Pass 1: 0 Pass 2: 0 Pass 3: 0
    Trying the parking bays (1036136) at word 1
Parse_name called
Pass 1: 0 Pass 2: 0 Pass 3: 0
    Trying Beck (1035592) at word 1
   [ND made 0 matches]
That's not a verb I recognise.

>t beck
[ "t" t / "beck" beck ]
[Parsing for the verb 't' (2 lines)]

[line 0 * scope=Routine(573744) -> A88_implicit_informing]
 [line 0 token 1 word 2 : scope=Routine(573744)]
  [Scope routine called at stage 1]
  [Scope routine returned multiple-flag of 0]
  [Object list from word 2]
  [Calling NounDomain on location and actor]
   [NounDomain called at word 2
   seeking definite object
  [Scope routine called at stage 2]
    Trying Beck (1035592) at word 2
    Matched (1)
    Trying Jones (1036040) at word 2
Parse_name called
Pass 1: 0 Pass 2: 0 Pass 3: 0
    Trying the disruptor pistol (1036072) at word 2
Parse_name called
Pass 1: 0 Pass 2: 0 Pass 3: 0
    Trying the speeder (1036104) at word 2
Parse_name called
Pass 1: 0 Pass 2: 0 Pass 3: 0
    Trying the parking bays (1036136) at word 2
Parse_name called
Pass 1: 0 Pass 2: 0 Pass 3: 0
    Trying Admiral Thallium (1041160) at word 2
Parse_name called
Pass 1: 0 Pass 2: 0 Pass 3: 0
    Trying Europa Callisto (1041320) at word 2
    Trying outside (1041384) at word 2
Parse_name called
Pass 1: 0 Pass 2: 0 Pass 3: 0
    Trying the windows (1041544) at word 2
    Trying the turbines (1041576) at word 2
Parse_name called
Pass 1: 0 Pass 2: 0 Pass 3: 0
    Trying the wings (1041608) at word 2
Parse_name called
Pass 1: 0 Pass 2: 0 Pass 3: 0
    Trying the building entryway (1041640) at word 2
Parse_name called
Pass 1: 0 Pass 2: 0 Pass 3: 0
   [ND made 1 matches]
  [ND returned Beck]
  [token resulted in success]
 [line 0 token 2 word 3 : END]
[Line successfully parsed]

(addressing Beck)
Don't worry, Galaxy Jones will tell Beck what he needs to know.

>t beck about speeder
[ "t" t / "beck" beck / "about" about / "speeder" speeder ]
[Parsing for the verb 't' (2 lines)]

[line 0 * scope=Routine(573744) -> A88_implicit_informing]
 [line 0 token 1 word 2 : scope=Routine(573744)]
  [Scope routine called at stage 1]
  [Scope routine returned multiple-flag of 0]
  [Object list from word 2]
  [Calling NounDomain on location and actor]
   [NounDomain called at word 2
   seeking definite object
  [Scope routine called at stage 2]
    Trying Beck (1035592) at word 2
    Matched (1)
    Trying Jones (1036040) at word 2
Parse_name called
Pass 1: 0 Pass 2: 0 Pass 3: 0
    Trying the disruptor pistol (1036072) at word 2
Parse_name called
Pass 1: 0 Pass 2: 0 Pass 3: 0
    Trying the speeder (1036104) at word 2
Parse_name called
Pass 1: 0 Pass 2: 0 Pass 3: 0
    Trying the parking bays (1036136) at word 2
Parse_name called
Pass 1: 0 Pass 2: 0 Pass 3: 0
    Trying Admiral Thallium (1041160) at word 2
Parse_name called
Pass 1: 0 Pass 2: 0 Pass 3: 0
    Trying Europa Callisto (1041320) at word 2
    Trying outside (1041384) at word 2
Parse_name called
Pass 1: 0 Pass 2: 0 Pass 3: 0
    Trying the windows (1041544) at word 2
    Trying the turbines (1041576) at word 2
Parse_name called
Pass 1: 0 Pass 2: 0 Pass 3: 0
    Trying the wings (1041608) at word 2
Parse_name called
Pass 1: 0 Pass 2: 0 Pass 3: 0
    Trying the building entryway (1041640) at word 2
Parse_name called
Pass 1: 0 Pass 2: 0 Pass 3: 0
   [ND made 1 matches]
  [ND returned Beck]
  [token resulted in success]
 [line 0 token 2 word 3 : END]

[line 1 * topic -> A86_implicit_telling]
 [line 1 token 1 word 2 : topic]
  [token resulted in success]
 [line 1 token 2 word 5 : END]
[Line successfully parsed]

This provokes no reaction.

* * *

>tell beckl
That's not a verb I recognise.

>tell beck
That's not a verb I recognise.

>tell
That's not a verb I recognise.

* * *

>touch room
There's nothing like that nearby.

>touch dock
That doesn't make sense.

>touch speeder
(the speeder)
Jones feels nothing unexpected.

>taste dock
That doesn't make sense.

* * *

>touch speederdock
There's nothing like that nearby.

>touch speeder dock
Jones feels nothing unexpected.

* * *

>x dock
Galaxy Jones is in the speeder dock. A safe harbor from the periodic dust storms of Utopia Planitia, the dock features several dozen speeder bays. Only a few are filled right now. The building entryway is to the north, under a red stone façade carved into the likeness of a fearsome Viking.

Jones's speeder, Galaxy One, sits in one of the parking bays.

>x speeder
(the speeder)
Galaxy One is a Dust Runner, a top-of-the-line model from Olympus Speedworks. It's deep crimson with tinted windows. Powerful turbines adorn vestigial wings that sweep back in severe rearward arcs.

>n
Jones approaches the Viking Building entryway, the dramatic façade towering over her.

Galaxy Jones is at the entry doorway. A glass revolving door leads into a large open space north of here. The speeder dock is to the south.

Jones peers upwards at the 100 stories of glass and steel. "What do you want to bet Thallium's got Europa all the way at the top?"

Beck: "Oh, no doubt."

>x entry
Which do you mean, the building entryway or the entry door?

>building entryway
The entryway is dominated by the towering façade of a Viking king, namesake of the building itself.

>x doorway
The entryway is dominated by the towering façade of a Viking king, namesake of the building itself.

>n
Jones takes a deep breath. "I'm going in."

Beck replies, "You got this, Galaxy."

Jones passes through the revolving door and into the lobby, alert to any defenses.

Galaxy Jones is in the lobby. The ground floor of the Viking Building is breathtaking. Low-G architecture means more glass and thinner supports, and the building takes advantage of that. Four walls of glass surround a central pillar in which are set the utility rooms and elevators. In between is an expanse of plants, water features, and stylish seating. Near the entryway is a front desk. A giant crystal sculpture floats above the center of the area, suspended on almost invisible cables. She may go east and west from here, north to the elevators, or south out of the building.

Suddenly two robot guards, green and red, emerge from niches in the back wall! She dives behind the front desk and draws her disruptor pistol.

Jones shouts, "I'm under fire from two ugly robot things!"

Beck responds, "Monitoring your suit radar."

>x lobby
There's nothing like that nearby.

* * *

>x speeder
(the speeder)
Galaxy One is a Dust Runner, a top-of-the-line model from Olympus Speedworks. It's deep crimson with tinted windows. Powerful turbines adorn vestigial wings that sweep back in severe rearward arcs.

>x speeder dock
Which do you mean, the speeder dock or the speeder dock?

>dock
There's nothing like that nearby.

>trace 5
[Parser tracing set to level 5.]

* * *

>scope
  [token resulted in re-parse request]
[ "scope" scope ]
[Parsing for the verb 'scope' (2 lines)]

[line 0 * -> Scope]
 [line 0 token 1 word 2 : END]
[Line successfully parsed]
1: a building entryway (1044680)
2: outside (1044424)
3: Jones (1039016)
4: a speeder dock (1039080)
5: a speeder dock (1039112)
6: a speeder (1039144)
7: some windows (1044584)
8: some turbines (1044616)
9: some wings (1044648)
10: some parking bays (1039176)
11: a disruptor pistol (1039048)
12: Beck (1038568)

* * *

>trace off
[ "trace" trace / "off" off ]
[Parsing for the verb 'trace' (4 lines)]

[line 0 * -> TraceOn]
 [line 0 token 1 word 2 : END]

[line 1 * number -> TraceLevel]
 [line 1 token 1 word 2 : number]
  [token resulted in failure with error type 3]

[line 2 * 'on' -> TraceOn]
[line rejected for not ending with correct preposition]

[line 3 * 'off' -> TraceOff]
 [line 3 token 1 word 2 : 'off']
  [token resulted in success]
 [line 3 token 2 word 3 : END]
[Line successfully parsed]
Trace off.

>showme speeder dock
(the speeder dock)
speeder dock - room
    building entryway - backdrop
    outside - backdrop
    Jones - person
        disruptor pistol
    speeder dock - location-scenery
    speeder dock - location-scenery
    speeder
        windows (part of speeder)
        turbines (part of speeder)
        wings (part of speeder)
    parking bays
singular-named, improper-named, used; lighted, visited, safe
list grouping key: none
printed name: "speeder dock"
printed plural name: none
indefinite article: none
most recent reference: nominal
third singular pronoun: It-pronoun
conversation: "Jones's handler Beck comes over her headset. "Alright, what's going on?"

She replies, "I'm in the speeder dock. No movement. What can I expect inside?"

"Blueprints show the ground floor is one big empty space with elevators in the center. Not a lot of places for resistance to hide, but you can never tell. Be careful.

"And one other thing, Jones: if you need help you can ASK BECK FOR HELP. You can also ASK BECK ABOUT things or ASK BECK ABOUT GAME for more information about the game. Finally, you can cause help to repeat from the beginning by saying ASK BECK TO RESET HELP""
description: "A safe harbor from the periodic dust storms of Utopia Planitia, the dock features several dozen speeder bays. Only a few are filled right now. The building entryway is to the north, under a red stone façade carved into the likeness of a fearsome Viking."
preposition: "in"

* * *

>x room
Galaxy Jones is in the speeder dock. A safe harbor from the periodic dust storms of Utopia Planitia, the dock features several dozen speeder bays. Only a few are filled right now. The building entryway is to the north, under a red stone façade carved into the likeness of a fearsome Viking.

Jones's speeder, Galaxy One, sits in one of the parking bays.

* * *

>x speeder
(the speeder)
Galaxy One is a Dust Runner, a top-of-the-line model from Olympus Speedworks. It's deep crimson with tinted windows. Powerful turbines adorn vestigial wings that sweep back in severe rearward arcs.

>trace 5
[Parser tracing set to level 5.]

>x speeder
[ "x" x / "speeder" speeder ]
[Parsing for the verb 'x' (3 lines)]

[line 0 * noun=Routine(572902) -> Examine]
 [line 0 token 1 word 2 : noun=Routine(572902)]
  [Object list from word 2]
  [Calling NounDomain on location and actor]
   [NounDomain called at word 2
   seeking definite object
    Trying the speeder dock (1038056) at word 2
    Matched (1)
   [ND made 1 matches]
  [ND returned the speeder dock]
  [token resulted in success]
 [line 0 token 2 word 3 : END]
[Line successfully parsed]

Galaxy Jones is in the speeder dock. A safe harbor from the periodic dust storms of Utopia Planitia, the dock features several dozen speeder bays. Only a few are filled right now. The building entryway is to the north, under a red stone façade carved into the likeness of a fearsome Viking.

Jones's speeder, Galaxy One, sits in one of the parking bays.

A safe harbor from the periodic dust storms of Utopia Planitia, the dock features several dozen speeder bays. Only a few are filled right now. The building entryway is to the north, under a red stone façade carved into the likeness of a fearsome Viking.

>scope
[ "scope" scope ]
[Parsing for the verb 'scope' (2 lines)]

[line 0 * -> Scope]
 [line 0 token 1 word 2 : END]
[Line successfully parsed]
1: a building entryway (1043688)
2: outside (1043432)
3: Jones (1038088)
4: a speeder (1038152)
5: some windows (1043592)
6: some turbines (1043624)
7: some wings (1043656)
8: some parking bays (1038184)
9: a disruptor pistol (1038120)
10: a speeder dock (1038056)
11: a building entryway (1043688)
12: outside (1043432)
13: Jones (1038088)
14: a disruptor pistol (1038120)
15: a speeder (1038152)
16: some windows (1043592)
17: some turbines (1043624)
18: some wings (1043656)
19: some parking bays (1038184)
20: Beck (1037640)

* * *

>x speeder dock
[ "x" x / "speeder" speeder / "dock" dock ]
[Parsing for the verb 'x' (3 lines)]

[line 0 * noun=Routine(572902) -> Examine]
 [line 0 token 1 word 2 : noun=Routine(572902)]
  [Object list from word 2]
  [Calling NounDomain on location and actor]
   [NounDomain called at word 2
   seeking definite object
    Trying the speeder dock (1038056) at word 2
    Matched (2)
   [ND made 1 matches]
  [ND returned the speeder dock]
  [token resulted in success]
 [line 0 token 2 word 4 : END]
[Line successfully parsed]

Galaxy Jones is in the speeder dock. A safe harbor from the periodic dust storms of Utopia Planitia, the dock features several dozen speeder bays. Only a few are filled right now. The building entryway is to the north, under a red stone façade carved into the likeness of a fearsome Viking.

Jones's speeder, Galaxy One, sits in one of the parking bays.

A safe harbor from the periodic dust storms of Utopia Planitia, the dock features several dozen speeder bays. Only a few are filled right now. The building entryway is to the north, under a red stone façade carved into the likeness of a fearsome Viking.

>x speeder
[ "x" x / "speeder" speeder ]
[Parsing for the verb 'x' (3 lines)]

[line 0 * noun=Routine(572902) -> Examine]
 [line 0 token 1 word 2 : noun=Routine(572902)]
  [Object list from word 2]
  [Calling NounDomain on location and actor]
   [NounDomain called at word 2
   seeking definite object
    Trying the speeder dock (1038056) at word 2
    Matched (1)
   [ND made 1 matches]
  [ND returned the speeder dock]
  [token resulted in success]
 [line 0 token 2 word 3 : END]
[Line successfully parsed]

Galaxy Jones is in the speeder dock. A safe harbor from the periodic dust storms of Utopia Planitia, the dock features several dozen speeder bays. Only a few are filled right now. The building entryway is to the north, under a red stone façade carved into the likeness of a fearsome Viking.

Jones's speeder, Galaxy One, sits in one of the parking bays.

A safe harbor from the periodic dust storms of Utopia Planitia, the dock features several dozen speeder bays. Only a few are filled right now. The building entryway is to the north, under a red stone façade carved into the likeness of a fearsome Viking.

* * *

>x speeder
(the speeder)
Galaxy One is a Dust Runner, a top-of-the-line model from Olympus Speedworks. It's deep crimson with tinted windows. Powerful turbines adorn vestigial wings that sweep back in severe rearward arcs.

>x dock
Galaxy Jones is in the speeder dock. A safe harbor from the periodic dust storms of Utopia Planitia, the dock features several dozen speeder bays. Only a few are filled right now. The building entryway is to the north, under a red stone façade carved into the likeness of a fearsome Viking.

Jones's speeder, Galaxy One, sits in one of the parking bays.

>x speeder dock
Galaxy Jones is in the speeder dock. A safe harbor from the periodic dust storms of Utopia Planitia, the dock features several dozen speeder bays. Only a few are filled right now. The building entryway is to the north, under a red stone façade carved into the likeness of a fearsome Viking.

Jones's speeder, Galaxy One, sits in one of the parking bays.

>gonear ninth hall
(the ninth floor elevator hall)
Galaxy Jones is in the ninth floor elevator hall. The elevator is to the west, the stairwell is to the east, and a corridor leads north and south. There is a bottled water vending machine here.

>x hall
Galaxy Jones is in the ninth floor elevator hall. The elevator is to the west, the stairwell is to the east, and a corridor leads north and south. There is a bottled water vending machine here.

>x ninth
Which do you mean, the ninth floor elevator door or the ninth floor elevator hall?

>hall
Galaxy Jones is in the ninth floor elevator hall. The elevator is to the west, the stairwell is to the east, and a corridor leads north and south. There is a bottled water vending machine here.

>showme speederdock
There seems to be no such object anywhere in the model world.

>showme speeder dock
(the ninth floor elevator hall)
ninth floor elevator hall - location-scenery
location: in the speeder dock
singular-named, improper-named, unused; unlit, inedible, fixed in place, scenery, neuter, seen, familiar, non-pourable
list grouping key: none
printed name: "ninth floor elevator hall"
printed plural name: "location-sceneries"
indefinite article: none
most recent reference: nominal
third singular pronoun: It-pronoun
conversation: none
description: none
initial appearance: none
third-plural-pronoun: They-pronoun

* * *

>x speeder
(the speeder)
Galaxy One is a Dust Runner, a top-of-the-line model from Olympus Speedworks. It's deep crimson with tinted windows. Powerful turbines adorn vestigial wings that sweep back in severe rearward arcs.

>x galaxy one
Galaxy One is a Dust Runner, a top-of-the-line model from Olympus Speedworks. It's deep crimson with tinted windows. Powerful turbines adorn vestigial wings that sweep back in severe rearward arcs.

>trace 5
[Parser tracing set to level 5.]

>x speeder
[ "x" x / "speeder" speeder ]
[Parsing for the verb 'x' (2 lines)]

[line 0 * noun=Routine(572902) -> Examine]
 [line 0 token 1 word 2 : noun=Routine(572902)]
  [Object list from word 2]
  [Calling NounDomain on location and actor]
   [NounDomain called at word 2
   seeking definite object
    Trying the speeder dock (1038056) at word 2
    Matched (1)
   [ND made 1 matches]
  [ND returned the speeder dock]
  [token resulted in success]
 [line 0 token 2 word 3 : END]
[Line successfully parsed]

Galaxy Jones is in the speeder dock. A safe harbor from the periodic dust storms of Utopia Planitia, the dock features several dozen speeder bays. Only a few are filled right now. The building entryway is to the north, under a red stone façade carved into the likeness of a fearsome Viking.

Jones's speeder, Galaxy One, sits in one of the parking bays.

A safe harbor from the periodic dust storms of Utopia Planitia, the dock features several dozen speeder bays. Only a few are filled right now. The building entryway is to the north, under a red stone façade carved into the likeness of a fearsome Viking.

>trace 6
[ "trace" trace / "6" ? ]
[Parsing for the verb 'trace' (4 lines)]

[line 0 * -> TraceOn]
 [line 0 token 1 word 2 : END]

[line 1 * number -> TraceLevel]
 [line 1 token 1 word 2 : number]
  [Read number as 6]
  [token resulted in success]
 [line 1 token 2 word 3 : END]
[Line successfully parsed]
[Parser tracing set to level 6.]

>x speeder
[ "x" x / "speeder" speeder ]
[Parsing for the verb 'x' (2 lines)]

[line 0 * noun=Routine(572902) -> Examine]
 [line 0 token 1 word 2 : noun=Routine(572902)]
  [Object list from word 2]
  [Calling NounDomain on location and actor]
   [NounDomain called at word 2
   seeking definite object
[DSA on the north with reason = 0 p1 = 0 p2 = 0]
[DSA on the northeast with reason = 0 p1 = 0 p2 = 0]
[DSA on the northwest with reason = 0 p1 = 0 p2 = 0]
[DSA on the south with reason = 0 p1 = 0 p2 = 0]
[DSA on the southeast with reason = 0 p1 = 0 p2 = 0]
[DSA on the southwest with reason = 0 p1 = 0 p2 = 0]
[DSA on the east with reason = 0 p1 = 0 p2 = 0]
[DSA on the west with reason = 0 p1 = 0 p2 = 0]
[DSA on the up with reason = 0 p1 = 0 p2 = 0]
[DSA on the down with reason = 0 p1 = 0 p2 = 0]
[DSA on the inside with reason = 0 p1 = 0 p2 = 0]
[DSA on the outside with reason = 0 p1 = 0 p2 = 0]
[DSA on the building entryway with reason = 0 p1 = 0 p2 = 0]
[DSA on outside with reason = 0 p1 = 0 p2 = 0]
[DSA on Jones with reason = 0 p1 = 0 p2 = 0]
[DSA on the speeder with reason = 0 p1 = 0 p2 = 0]
[DSA on the windows with reason = 0 p1 = 0 p2 = 0]
[DSA on the turbines with reason = 0 p1 = 0 p2 = 0]
[DSA on the wings with reason = 0 p1 = 0 p2 = 0]
[DSA on the parking bays with reason = 0 p1 = 0 p2 = 0]
[DSA on the disruptor pistol with reason = 0 p1 = 0 p2 = 0]
[DSA on the speeder dock with reason = 0 p1 = 0 p2 = 0]
    Trying the speeder dock (1038056) at word 2
    Matched (1)
    Match with quality 1
    Match added to list
[DSA on the building entryway with reason = 0 p1 = 0 p2 = 0]
[DSA on outside with reason = 0 p1 = 0 p2 = 0]
[DSA on Jones with reason = 0 p1 = 0 p2 = 0]
[DSA on the disruptor pistol with reason = 0 p1 = 0 p2 = 0]
[DSA on the speeder with reason = 0 p1 = 0 p2 = 0]
[DSA on the windows with reason = 0 p1 = 0 p2 = 0]
[DSA on the turbines with reason = 0 p1 = 0 p2 = 0]
[DSA on the wings with reason = 0 p1 = 0 p2 = 0]
[DSA on the parking bays with reason = 0 p1 = 0 p2 = 0]
[DSA on Beck with reason = 0 p1 = 0 p2 = 0]
   [ND made 1 matches]
  [ND returned the speeder dock]
  [token resulted in success]
 [line 0 token 2 word 3 : END]
[Line successfully parsed]

Galaxy Jones is in the speeder dock. A safe harbor from the periodic dust storms of Utopia Planitia, the dock features several dozen speeder bays. Only a few are filled right now. The building entryway is to the north, under a red stone façade carved into the likeness of a fearsome Viking.

Jones's speeder, Galaxy One, sits in one of the parking bays.

A safe harbor from the periodic dust storms of Utopia Planitia, the dock features several dozen speeder bays. Only a few are filled right now. The building entryway is to the north, under a red stone façade carved into the likeness of a fearsome Viking.

* * *

>x speeder
(the speeder)
Galaxy One is a Dust Runner, a top-of-the-line model from Olympus Speedworks. It's deep crimson with tinted windows. Powerful turbines adorn vestigial wings that sweep back in severe rearward arcs.

>x one
Galaxy One is a Dust Runner, a top-of-the-line model from Olympus Speedworks. It's deep crimson with tinted windows. Powerful turbines adorn vestigial wings that sweep back in severe rearward arcs.

>trace 5
[Parser tracing set to level 5.]

>trace off
[ "trace" trace / "off" off ]
[Parsing for the verb 'trace' (4 lines)]

[line 0 * -> TraceOn]
 [line 0 token 1 word 2 : END]

[line 1 * number -> TraceLevel]
 [line 1 token 1 word 2 : number]
  [token resulted in failure with error type 3]

[line 2 * 'on' -> TraceOn]
[line rejected for not ending with correct preposition]

[line 3 * 'off' -> TraceOff]
 [line 3 token 1 word 2 : 'off']
  [token resulted in success]
 [line 3 token 2 word 3 : END]
[Line successfully parsed]
Trace off.

>actions
Actions listing on.

>enter viking
[entering the building entryway]
[(1) going north]
Jones approaches the Viking Building entryway, the dramatic façade towering over her.

Galaxy Jones is at the entry doorway. A glass revolving door leads into a large open space north of here. The speeder dock is to the south.

Jones peers upwards at the 100 stories of glass and steel. "What do you want to bet Thallium's got Europa all the way at the top?"

Beck: "Oh, no doubt."
[(1) going north - succeeded]

[entering the building entryway - failed]

>out
[exiting]
But Jones isn't in anything at the moment.
[exiting - failed the can't exit when not inside anything rule]

>s
[going south]
Jones slinks back to the speeder dock.

Galaxy Jones is in the speeder dock. A safe harbor from the periodic dust storms of Utopia Planitia, the dock features several dozen speeder bays. Only a few are filled right now. The building entryway is to the north, under a red stone façade carved into the likeness of a fearsome Viking.

Her speeder, Galaxy One, sits in one of the parking bays.

[going south - succeeded]

>in
[going inside]
Jones can't go that way.
[going inside - failed the can't go that way rule]

>n
[going north]

Galaxy Jones is at the entry doorway. A glass revolving door leads into a large open space north of here. The speeder dock is to the south.

[going north - succeeded]

>exit
[exiting]
But Jones isn't in anything at the moment.
[exiting - failed the can't exit when not inside anything rule]

>enter viking
[entering the building entryway]
[(1) going north]
Jones takes a deep breath. "I'm going in."

Beck replies, "You got this, Galaxy."

Jones passes through the revolving door and into the lobby, alert to any defenses.

Galaxy Jones is in the lobby. The ground floor of the Viking Building is breathtaking. Low-G architecture means more glass and thinner supports, and the building takes advantage of that. Four walls of glass surround a central pillar in which are set the utility rooms and elevators. In between is an expanse of plants, water features, and stylish seating. Near the entryway is a front desk. A giant crystal sculpture floats above the center of the area, suspended on almost invisible cables. She may go east and west from here, north to the elevators, or south out of the building.

[(1) going north - succeeded]

[entering the building entryway - failed]

Suddenly two robot guards, green and red, emerge from niches in the back wall! She dives behind the front desk and draws her disruptor pistol.

Jones shouts, "I'm under fire from two ugly robot things!"

Beck responds, "Monitoring your suit radar."

>restart
[restarting the game]
Are you sure you want to restart?

* * *

>in
Jones can't go that way.

>n
Jones approaches the Viking Building entryway, the dramatic façade towering over her.

Galaxy Jones is at the entry doorway. A glass revolving door leads into a large open space north of here. The speeder dock is to the south.

Jones peers upwards at the 100 stories of glass and steel. "What do you want to bet Thallium's got Europa all the way at the top?"

Beck: "Oh, no doubt."

* * *

>x speeder
(the speeder)
Galaxy One is a Dust Runner, a top-of-the-line model from Olympus Speedworks. It's deep crimson with tinted windows. Powerful turbines adorn vestigial wings that sweep back in severe rearward arcs.

>x speeder dock
I only understood you as far as wanting to examine the speeder.

>l
Galaxy Jones is in the speeder dock. A safe harbor from the periodic dust storms of Utopia Planitia, the dock features several dozen speeder bays. Only a few are filled right now. The building entryway is to the north, under a red stone façade carved into the likeness of a fearsome Viking.

Jones's speeder, Galaxy One, sits in one of the parking bays.

>x dock
There's nothing like that nearby.

* * *

>y
The phone rings. Galaxy Jones, the solar system's greatest hero, rolls over in bed and presses the talk button.

"Yes?" she says in a voice thick with sleep.

"Hello, is this Galaxy Jones?" comes the voice from the speaker.

"Yes, this is she. To whom am I speaking?"

"Oh, hi, Ms Jones. This is Patty, I work for Admiral P. X. Thallium, CEO of Diversified Entanglements, LLC. He asked me to forward a message to you."

"He did, did he? Now what would the Admiral want to say to me?"

"Oh, it's not from the Admiral himself. It's from one Miss Europa Callisto. I must say, the Admiral was quite surprised when I said I didn't know who she is. Apparently she's famous."

"Yes, quite famous, but why would she send a message to me, and why on Mars would she send it through Thallium? But never mind, what's the message?"

Patty can be heard rustling paper. "Let's see... it's here somewhere. Oh yes, here it is. The message is 'Help.'"

Ten minutes later, Galaxy Jones, in her speeder Galaxy One, races across the desolate expanse of Utopia Planitia, Mars. Her nemesis, the thoroughly execrable Admiral Thallium, has taken hostage the exquisite Europa Callisto, singer and actress renowned throughout a dozen solar systems. As Patty has quite helpfully explained, Miss Callisto is imprisoned at the top of the Viking Building in New Reykjavik, guarded by an impressive number of killer robots and other diabolical instruments of Jones's inevitable demise. The Admiral has most cordially invited Ms Jones to break into his building and attempt a rescue.

"Oh I will," Galaxy mutters to herself. This time, she vows silently, Thallium won't escape.

Plus she'll get to meet Europa Callisto. That'll be totally sweet.

accessible has no description.

Galaxy Jones!
An Interactive Fiction by Phil Riley
Release 1 / Serial number 230311 / Inform 7 build 6M62 (I6/v6.34 lib 6/12N) SD

A sleek dark red speeder roars into the dock of the Viking Building. A tall woman in a battle-ready jumpsuit climbs out of it: Galaxy Jones.

Galaxy Jones is in the speeder dock. A safe harbor from the periodic dust storms of Utopia Planitia, the dock features several dozen speeder bays. Only a few are filled right now. The building entryway is to the north, under a red stone façade carved into the likeness of a fearsome Viking.

Jones's speeder, Galaxy One, sits in one of the parking bays.

Jones's handler Beck comes over her headset. "Alright, what's going on?"

She replies, "I'm in the speeder dock. No movement. What can I expect inside?"

"Blueprints show the ground floor is one big empty space with elevators in the center. Not a lot of places for resistance to hide, but you can never tell. Be careful.

"And one other thing, Jones: if you need help you can ASK BECK FOR HELP. You can also ASK BECK ABOUT things or ASK BECK ABOUT GAME for more information about the game. Finally, you can cause help to repeat from the beginning by saying ASK BECK TO RESET HELP"

>n
Jones approaches the Viking Building entryway, the dramatic façade towering over her.

Galaxy Jones is at the entry doorway. A glass revolving door leads into a large open space north of here. The speeder dock is to the south.

Jones peers upwards at the 100 stories of glass and steel. "What do you want to bet Thallium's got Europa all the way at the top?"

Beck: "Oh, no doubt."

* * *

>shoot robot
Oof. Big miss.

One of the robots fires directly above Jones's head.

Jones: "I could use some ideas here!"

>shoot robot
Oops! Jones misses.

>shoot robot
Jones's shot hits the guard robots dead on, but nothing happens, almost as if the robot had absorbed the energy.

Jones: "Target seems to be absorbing disruptor fire. This will make things a little harder."

Beck: "How's it going in there?"

"Jones: "You know -- like all art, it's hit or miss."

>shoot robot
Oof. Big miss.

The two robots coordinate fire over the desk, narrowly missing Jones.

>shoot robot
Jones's shot goes wide, reflecting off one of the building struts and into the suspended sculpture. The artwork begins to spin wildly, straining its cables.

The two robots coordinate fire over the desk, narrowly missing her.

>shoot robot
A perfect shot! Yet, somehow, the robot is unscathed.

The robots intone "Destroy Jones" in an eerie drone.

>shoot robot
Oof. Big miss.

>shoot robot
Oops! Jones misses.

>shoot robot
Jones's shot goes wide, reflecting off one of the building struts and into the suspended sculpture. The artwork begins to spin wildly, straining its cables.

The robots intone "Destroy Jones" in an eerie drone.

>shoot robot
A perfect shot! Yet, somehow, the robot is unscathed.

>shoot robot
Oof. Big miss.

Zip! Disruptor fire scorches a nearby couch.

>shoot robot
A perfect shot! Yet, somehow, the robot is unscathed.

>shoot robot
A barrage of fire from the robots prevents Jones from firing.

A robot fires a blistering shot into the front desk.

>shoot robot
Jones's shot goes wide, reflecting off one of the building struts and into the suspended sculpture. The artwork begins to spin wildly, straining its cables.

Zip! Disruptor fire scorches a nearby couch.

>shoot robot
Oops! Jones misses.

Beck: "Robot on your right!"

One robot tries to flank her, but a shot from her disruptor sends it scurrying back.

>shoot robot
Oof. Big miss.

>shoot robot
Oops! Jones misses.

One robot tries to flank her, but a shot from her disruptor sends it scurrying back.

>shoot robot
Jones sticks her head out from behind the desk and squeezes off a shot at the guard robots. In Jones's haste it goes wide of the target.

The robots intone "Destroy Jones" in an eerie drone.

>shoot robot
Oops! Jones misses.

>shoot robot
Jones sticks her head out from behind the desk and squeezes off a shot at the guard robots. In Jones's haste it goes wide of the target.

>shoot robot
A barrage of fire from the robots prevents Jones from firing.

The two robots coordinate fire over the desk, narrowly missing her.

>shoot robot
Oof. Big miss.

The two robots coordinate fire over the desk, narrowly missing Jones.

>shoot robot
A barrage of fire from the robots prevents Jones from firing.

>shoot robot
A perfect shot! Yet, somehow, the robot is unscathed.

>shoot art
Jones fires the disruptor into the sculpture's main support cable, snapping it. The huge crystal blob starts to sag, straining the other cables. In quick succession they break as well, and the whole installation plummets to the ground, right on top of the hapless guard robots.

[Your score has just gone up by one point.]

Beck: "What was that crash? What's going on?"

Jones: "That, my friend, was what you'd call a work of art. Targets terminated."

>n
Galaxy Jones is in the ground floor elevator hall. This hallway between the north and south ends of the ground floor is home to the elevator to the west. To the east is the entrance to a stairwell.

>e
As soon as Jones enters the stairwell, a disruptor blast from above zings past her shoulder, and she beats a hasty retreat. She won't be going up the stairs until she can clear out the resistance, and she can't do that from here.

Jones: "In case of fire, don't use the stairs."

Galaxy Jones is in the ground floor elevator hall. This hallway between the north and south ends of the ground floor is home to the elevator to the west. To the east is the entrance to a stairwell.

>e
As soon as Jones enters the stairwell, a disruptor blast from above zings past her shoulder, and she beats a hasty retreat. She won't be going up the stairs until she can clear out the resistance, and she can't do that from here.

Galaxy Jones is in the ground floor elevator hall. This hallway between the north and south ends of the ground floor is home to the elevator to the west. To the east is the entrance to a stairwell.

* * *

>w
(first opening the elevator door)
Jones can't just open the elevator with her hands.

>press button
Jones presses the call button, but nothing happens.

>w
(first opening the elevator door)
Jones can't just open the elevator with her hands.

>n
Galaxy Jones is on the north side of the ground floor. The area is dominated by a towering statue of Admiral Thallium against the north wall. The ground floor extends west and east from here. The elevator is to the south.

>push statue
It is fixed in place.

>x it
His nauseating visage seems to leer at Jones, and she suppresses a shiver of disgust.

Jones groans. "Be glad you're not here, Beck. This is revolting."

Beck chuckles. "I won't ask."

>touch it
Jones feels nothing unexpected.

>search it
Jones finds nothing of interest.

>look behind it
Jones finds nothing of note.

>look under it
Jones finds nothing of interest.

>e
Galaxy Jones is at the northeast corner of the ground floor. The area is dedicated to celebrating the military career of Admiral Thallium. Uniforms, medals, ribbons, and other miscellanea are mounted on the wall or in showcases. All this despite the fact that no one has turned up any evidence that Thallium served in any navy of any country on any planet. One can escape to the west or south.

Jones: "Now this is some choice bullshit here."

Beck: "Looks like the record of the good Admiral's long and dedicated service."

>x ribbons
Jones yawns looking over the assortment of faux honors. They're all behind glass, but one of the display cases is partly open, leaving the rather garish medal inside unprotected.

>take medal
Taken.

* * *

>take pin
Taken.

>x medal
While the front looks authentic, the reverse is engraved with Thallium's personal motto "Planetas Vincam". Earlier Jones removed the safety pin.

>ask beck about medals
Beck: "Who does this guy think he's fooling? On the other hand, maybe you can find a disguise in there and fake your way past the guards."

>e
Jones can't go that way.

>s
Galaxy Jones is on the east side of the ground floor. Apparently some kind of function was happening here before Admiral Thallium emptied the building, for there is an array of canapes on a catering table here. The floor stretches north and south, and there's a closet door to the west.

Beck: "Blueprints indicate a closet to the west of you. Might be useful."

>x canapes
The table is covered with a wide array of treats from the ridiculously expensive, such as shrimp tea sandwiches (where do you get shrimp on Mars?), to the just plain ridiculous, like poached ostrich eggs in jelly. A good number of forks are laid out to one side.

Jones: "What would you like me to bring you, Beck? Shrimp tea sandwiches, or poached ostrich eggs?"

Beck: "Oh, the shrimp. Definitely get the shrimp."

>take sandiwiches
There's nothing like that nearby.

>take shrimp
Taken.

>take fork
Taken.

>x fork
A very stylish silver-plated fork.

>ask beck about fork
Beck: "Maybe you can poke Thallium with a fork until he submits?"

>drop fork
Dropped.

>n
Galaxy Jones is at the northeast corner of the ground floor. The area is dedicated to celebrating the military career of Admiral Thallium. Uniforms, medals, ribbons, and other miscellanea are mounted on the wall or in showcases. All this despite the fact that no one has turned up any evidence that Thallium served in any navy of any country on any planet. One can escape to the west or south.

>ask beck about fork
Beck: "Maybe you can poke Thallium with a fork until he submits?"

>s
Galaxy Jones is on the east side of the ground floor. Apparently some kind of function was happening here before Admiral Thallium emptied the building, for there is an array of canapes on a catering table here. The floor stretches north and south, and there's a closet door to the west.

Also here is a fork.

>u
Jones can't go that way.

>n
Galaxy Jones is at the northeast corner of the ground floor. The area is dedicated to celebrating the military career of Admiral Thallium. Uniforms, medals, ribbons, and other miscellanea are mounted on the wall or in showcases. All this despite the fact that no one has turned up any evidence that Thallium served in any navy of any country on any planet. One can escape to the west or south.

>take fork
There's nothing like that nearby.

>x it
That noun did not make sense in this context.

>x fork
There's nothing like that nearby.

>s
Galaxy Jones is on the east side of the ground floor. Apparently some kind of function was happening here before Admiral Thallium emptied the building, for there is an array of canapes on a catering table here. The floor stretches north and south, and there's a closet door to the west.

Also here is a fork.

>take fork
Taken.

>type 0
(on the keypad)
An indicator light glows green.

Jones: "I've unlocked the east side utility door."

* * *

>w
(first opening the closet door)

Galaxy Jones is in the maintenance closet. A bare, white-walled room containing various maintenance items.

There is an Atmo-Suit hanging from a hook here.

On the shelf is a red cardkey.

>take all
Atmo-Suit: Taken.
red cardkey: Taken.

>l
Galaxy Jones is in the maintenance closet. A bare, white-walled room containing various maintenance items.

>x items
Various uninteresting items, like mops and brooms and the like.

>x mops
Various uninteresting items, like mops and brooms and the like.

>ask beck about closet
Beck: "Hmm. Don't have much to say about that right now."

>e
Galaxy Jones is on the east side of the ground floor. Apparently some kind of function was happening here before Admiral Thallium emptied the building, for there is an array of canapes on a catering table here. The floor stretches north and south, and there's a closet door to the west.

* * *

>s
Galaxy Jones is at the southeast corner of the ground floor. The centerpiece of this area is the actual Viking 2 lander, which landed right here on Utopia Planitia. The glass walls look out onto the city. Jones can go north or west from here.

>ask beck about lander
Beck: "I'd heard it was stolen. I can't believe he just flaunts it like this."

>take it
Jones can't see 'it' (nothing) at the moment.

>take lander
That's hardly portable.

>x it
The lander is such a big, ungainly object it's hard to imagine it was once a pinnacle of human achievement.

>x walls
Outside the building are the red-dusted streets of New Reykjavik.

>x glass walls
Outside the building are the red-dusted streets of New Reykjavik.

>x glass
Outside the building are the red-dusted streets of New Reykjavik.

>x ity
There's nothing like that nearby.

>x city
Outside the building are the red-dusted streets of New Reykjavik.

>w
Galaxy Jones is in the lobby. The ground floor of the Viking Building is breathtaking. Low-G architecture means more glass and thinner supports, and the building takes advantage of that. Four walls of glass surround a central pillar in which are set the utility rooms and elevators. In between is an expanse of plants, water features, and stylish seating. Near the entryway is a front desk. Jones may go east and west from here, north to the elevators, or south out of the building. There are two niches in the central wall from which the guard robots emerged.

Spread across the floor in a tangled ruin are the remains of a giant crystal sculpture and two guard robots.

>take art
That can't be taken.

>x art
Jones digs through the ruins and finds a cable with hooks at either end, which she takes.

>x cable
This is a strong but slender cable, presumably of carbon nanotubes. There are steel hooks at either end.

>ask beck about it
Beck: "Could come in handy."

>w
Jones crosses the floor carefully, disruptor pistol at the ready.

Galaxy Jones is at the southwest corner of the ground floor. A lush waterfall here contrasts with the dusty red streets of New Reykjavik beyond the glass walls. The ground floor extends north and east.

>ask beck about water
(the waterfall)

Beck: "Hmm. Don't have much to say about that right now."

>search it
Jones finds nothing of interest.

>x it
This is a strong but slender cable, presumably of carbon nanotubes. There are steel hooks at either end.

>x water
The waterfall descends the length of an artificial rock formation fringed by wide-leaved Earth plants and ferns. The water collects in a basin at the bottom, where it begins its journey again. A single coin sits on the bottom of the basin.

Jones: "One coin? Not very generous people around here."

>take coin
Taken.

>e
Galaxy Jones is in the lobby. The ground floor of the Viking Building is breathtaking. Low-G architecture means more glass and thinner supports, and the building takes advantage of that. Four walls of glass surround a central pillar in which are set the utility rooms and elevators. In between is an expanse of plants, water features, and stylish seating. Near the entryway is a front desk. Jones may go east and west from here, north to the elevators, or south out of the building. There are two niches in the central wall from which the guard robots emerged.

Spread across the floor in a tangled ruin are the remains of a giant crystal sculpture and two guard robots.

* * *

>n
Galaxy Jones is in the ground floor elevator hall. This hallway between the north and south ends of the ground floor is home to the elevator to the west. To the east is the entrance to a stairwell.

>w
(first opening the elevator door)
Jones can't just open the elevator with her hands.

* * *

>n
Galaxy Jones is on the north side of the ground floor. The area is dominated by a towering statue of Admiral Thallium against the north wall. The ground floor extends west and east from here. The elevator is to the south.

>e
Galaxy Jones is at the northeast corner of the ground floor. The area is dedicated to celebrating the military career of Admiral Thallium. Uniforms, medals, ribbons, and other miscellanea are mounted on the wall or in showcases. All this despite the fact that no one has turned up any evidence that Thallium served in any navy of any country on any planet. One can escape to the west or south.

>w
Galaxy Jones is on the north side of the ground floor. The area is dominated by a towering statue of Admiral Thallium against the north wall. The ground floor extends west and east from here. The elevator is to the south.

>s
Galaxy Jones is in the ground floor elevator hall. This hallway between the north and south ends of the ground floor is home to the elevator to the west. To the east is the entrance to a stairwell.

>s
Galaxy Jones is in the lobby. The ground floor of the Viking Building is breathtaking. Low-G architecture means more glass and thinner supports, and the building takes advantage of that. Four walls of glass surround a central pillar in which are set the utility rooms and elevators. In between is an expanse of plants, water features, and stylish seating. Near the entryway is a front desk. Jones may go east and west from here, north to the elevators, or south out of the building. There are two niches in the central wall from which the guard robots emerged.

Spread across the floor in a tangled ruin are the remains of a giant crystal sculpture and two guard robots.

>w
Galaxy Jones is at the southwest corner of the ground floor. A lush waterfall here contrasts with the dusty red streets of New Reykjavik beyond the glass walls. The ground floor extends north and east.

* * *

>n
Galaxy Jones is at the northwest corner of the ground floor. A large relief map of mars is mounted on the north wall here. One can leave here to the south or east.

>e
Galaxy Jones is on the north side of the ground floor. The area is dominated by a towering statue of Admiral Thallium against the north wall. The ground floor extends west and east from here. The elevator is to the south.

>e
Beck: "Boooring."

Jones: "I can't take you anywhere."

Galaxy Jones is at the northeast corner of the ground floor. The area is dedicated to celebrating the military career of Admiral Thallium. Uniforms, medals, ribbons, and other miscellanea are mounted on the wall or in showcases. All this despite the fact that no one has turned up any evidence that Thallium served in any navy of any country on any planet. One can escape to the west or south.

>s
Galaxy Jones is on the east side of the ground floor. Apparently some kind of function was happening here before Admiral Thallium emptied the building, for there is an array of canapes on a catering table here. The floor stretches north and south, and there's a closet door to the west.

>s
Galaxy Jones is at the southeast corner of the ground floor. The centerpiece of this area is the actual Viking 2 lander, which landed right here on Utopia Planitia. The glass walls look out onto the city. Jones can go north or west from here.

* * *

>e
Galaxy Jones is on the north side of the ground floor. The area is dominated by a towering statue of Admiral Thallium against the north wall. The ground floor extends west and east from here. The elevator is to the south.

>e
Galaxy Jones is at the northeast corner of the ground floor. The area is dedicated to celebrating the military career of Admiral Thallium. Uniforms, medals, ribbons, and other miscellanea are mounted on the wall or in showcases. All this despite the fact that no one has turned up any evidence that Thallium served in any navy of any country on any planet. One can escape to the west or south.

>s
Galaxy Jones is on the east side of the ground floor. Apparently some kind of function was happening here before Admiral Thallium emptied the building, for there is an array of canapes on a catering table here. The floor stretches north and south, and there's a closet door to the west.

>s
Beck: "Yawn."

Jones: "Shut up."

Galaxy Jones is at the southeast corner of the ground floor. The centerpiece of this area is the actual Viking 2 lander, which landed right here on Utopia Planitia. The glass walls look out onto the city. Jones can go north or west from here.

>w
Galaxy Jones is in the lobby. The ground floor of the Viking Building is breathtaking. Low-G architecture means more glass and thinner supports, and the building takes advantage of that. Four walls of glass surround a central pillar in which are set the utility rooms and elevators. In between is an expanse of plants, water features, and stylish seating. Near the entryway is a front desk. Jones may go east and west from here, north to the elevators, or south out of the building. There are two niches in the central wall from which the guard robots emerged.

Spread across the floor in a tangled ruin are the remains of a giant crystal sculpture and two guard robots.

* * *

>n
Galaxy Jones is on the west side of the ground floor. Semicircular couches open on either side of a central carpeted path leading north and south. Set in the central pillar of the building to the east is a utility door. The city looms beyond the glass wall to the west.

>e
(first opening the utility door)
(first unlocking the utility door)
(with the red cardkey)

Galaxy Jones is in the elevator room. This is a utility room related to the operation of the elevator, on the other side of the east wall here. There is a control panel on the wall, and a door leading west.

Hanging from a hook here is an elevator drop key.

Lying discarded on a table here is a hammer.

>take all
elevator drop key: Taken.
hammer: Taken.

>w
Galaxy Jones is on the west side of the ground floor. Semicircular couches open on either side of a central carpeted path leading north and south. Set in the central pillar of the building to the east is a utility door. The city looms beyond the glass wall to the west.

* * *

>n
Galaxy Jones is in the ground floor elevator hall. This hallway between the north and south ends of the ground floor is home to the elevator to the west. To the east is the entrance to a stairwell.

>put drop key in hole
(the elevator drop key in the drop key hole)
Jones inserts the elevator drop key into the drop key hole and turns it, disengaging the lock mechanism. Then she slides the door open.

>undo
Galaxy Jones is in the ground floor elevator hall.
[Previous turn undone.]

>unlock door with drop key
(the elevator drop key)
Jones inserts the elevator drop key into the drop key hole and turns it, disengaging the lock mechanism. Then she slides the door open.

>w
Jones climbs into the elevator shaft

Galaxy Jones is in the ground floor elevator shaft. She is at the bottom of a dark well. Shining her suit light up, she can see that the elevator car is several floors up, unmoving. There is a ladder running up the wall next to the door.

Beck: "Ooh. It's like we're in an action film."

>u
Jones climbs up the shaft, stopping at each floor to test each door. She gets all the way to the ninth floor, directly below the elevator car, before finding one that opens.

Galaxy Jones is in the ninth floor elevator shaft. The door here is closed.

Beck: "Huh. Seems like it should have taken longer than that."

>e
(first opening the ninth floor elevator door)
[Your score has just gone up by one point.]

Jones: "Finally out of the shaft. That was quite a climb."

Beck: "This floor is just offices. Check the building management office to the west. It might have some useful stuff."

Galaxy Jones is in the ninth floor elevator hall. The elevator is to the west, the stairwell is to the east, and a corridor leads north and south. There is a bottled water vending machine here.

>n
Galaxy Jones is in the ninth floor north hallway. This anonymous corporate hallway ends here at the north end of the building. An open doorway leads west. To the east is a door with a swipe lock, labeled "Cybernetica Inc."

>x door
A slick corporate office door lettered "Cybernetica". It has a swipe lock above the handle.

>ask beck about cybernetica
Beck: "Oh, they make the best games!"

>w
Galaxy Jones is at the north end of the building management office. The building management office is a bunch of desks and task boards. There is a particularly large desk against the west window. The office exit is to the east, and the office continues to the south.

>x desk
It's a pretty utilitarian desk of some plastic material. It has a single drawer with a keyed lock.

>x lock
It's a pretty utilitarian desk of some plastic material. It has a single drawer with a keyed lock.

>ask beck about lock
(the large desk)

Beck: "There must be a way to break into it."

>ask beck for help
Beck: "Looks like you're managing okay."

>n
Jones can't go that way.

>e
Galaxy Jones is in the ninth floor north hallway. This anonymous corporate hallway ends here at the north end of the building. An open doorway leads west. To the east is a door with a swipe lock, labeled "Cybernetica Inc."

>ask beck for help
Beck: "Looks like you're managing okay."

>s
Galaxy Jones is in the ninth floor elevator hall. The elevator is to the west, the stairwell is to the east, and a corridor leads north and south. There is a bottled water vending machine here.

>s
Galaxy Jones is in the ninth floor south hallway. This anonymous corporate hallway ends here at the south end of the building. An open doorway leads west. To the east is a door with a swipe lock, labeled "Martian Chemical."

>ask beck for help
Beck: "You've probably noticed the two locked doors on this floor. You need to get them open."

>ask beck for help
Beck: "The cardkey for both of them is in the large desk in the building management office."

>ask beck for help
Beck: "You don't have a key for the desk. Maybe you can pick the lock?"

>ask beck for help
Beck: "Pick the desk lock with the safety pin."

>w
Galaxy Jones is at the south end of the building management office. The building management office is a bunch of desks and task boards. There is a filing cabinet against the east wall. The office exit is to the east, and the office continues to the north.

A screwdriver sits atop the filing cabinet.

>n
Galaxy Jones is at the north end of the building management office. The building management office is a bunch of desks and task boards. There is a particularly large desk against the west window. The office exit is to the east, and the office continues to the south.

>pick lock with pin
Jones pushes the pin into the keyhole and wiggles it around. After a few seconds of this the desk drawer pops open. It contains a black cardkey.

[Your score has just gone up by one point.]

Beck: "Galaxy Jones, master thief!"

>undo
Galaxy Jones is at the north end of the building management office.
[Previous turn undone.]

>pick desk lock with pin
Jones pushes the pin into the keyhole and wiggles it around. After a few seconds of this the desk drawer pops open. It contains a black cardkey.

[Your score has just gone up by one point.]

Beck: "Galaxy Jones, master thief!"

>d
Jones can't go that way.

>s
Galaxy Jones is at the south end of the building management office. The building management office is a bunch of desks and task boards. There is a filing cabinet against the east wall. The office exit is to the east, and the office continues to the north.

A screwdriver sits atop the filing cabinet.

>x cabinet
An ordinary filing cabinet, with five drawers. The label on the front says "Personnel Records".

>open it
Jones has better things to do than look through reams of personnel records.

>take screwdriver
Jones reaches for the screwdriver, but she fumbles it and it rolls off the back of the filing cabinet.

Jones: "Damn."

Beck: "What? What's going on?"

Jones: "Just being clumsy is all."

>take screwdriver
Jones reaches behind the cabinet to retrieve the screwdriver. A swipe and a hiss make her recoil.

Jones: "Holy --!"

Beck: "What now?"

Jones: "There's a cat here! Behind a filing cabinet. Gotta get behind there to get a screwdriver, so I need a way to drive off the cat."

>drop shrimp
Sensing food, the black cat pokes its head out, grabs the shrimp in its jaws, and races off. Jones takes the screwdriver.

[Your score has just gone up by one point.]

Jones: "Aha! No creature is too fearsome for Galaxy Jones!"

Beck: "Congratulations on your victory."

>e
Galaxy Jones is in the ninth floor south hallway. This anonymous corporate hallway ends here at the south end of the building. An open doorway leads west. To the east is a door with a swipe lock, labeled "Martian Chemical."

>e
(first opening the Martian Chemical door)
(first unlocking the Martian Chemical door)
Jones lacks a key that fits the Martian Chemical door.

>w
Galaxy Jones is at the south end of the building management office. The building management office is a bunch of desks and task boards. There is a filing cabinet against the east wall. The office exit is to the east, and the office continues to the north.

>n
Galaxy Jones is at the north end of the building management office. The building management office is a bunch of desks and task boards. There is a particularly large desk against the west window. The office exit is to the east, and the office continues to the south.

>x desk
It's a pretty utilitarian desk of some plastic material. It has a single drawer with a keyed lock.

In the large desk is a black cardkey.

>take cardkey
(the black cardkey)
Taken.

>e
Galaxy Jones is in the ninth floor north hallway. This anonymous corporate hallway ends here at the north end of the building. An open doorway leads west. To the east is a door with a swipe lock, labeled "Cybernetica Inc."

>s
Galaxy Jones is in the ninth floor elevator hall. The elevator is to the west, the stairwell is to the east, and a corridor leads north and south. There is a bottled water vending machine here.

* * *

>s
Galaxy Jones is in the ninth floor south hallway. This anonymous corporate hallway ends here at the south end of the building. An open doorway leads west. To the east is a door with a swipe lock, labeled "Martian Chemical."

>e
(first opening the Martian Chemical door)
(first unlocking the Martian Chemical door)
(with the black cardkey)

Galaxy Jones is in the Martian Chemical office. This seems like the business office of the chemical company rather than the lab. Most of the room is taken up by desks and other office stuff. There is a cabinet that looks intriguing, however.

>x abinet
There's nothing like that nearby.

>x cabinet
The cabinet is full of bottles of Electrofil quick-setting conductive polymer gel.

>take gell
There's nothing like that nearby.

>take gel
Taken.

* * *

>n
Galaxy Jones is in the ninth floor north hallway. This anonymous corporate hallway ends here at the north end of the building. An open doorway leads west. To the east is a door with a swipe lock, labeled "Cybernetica Inc."

>s
Galaxy Jones is in the ninth floor elevator hall. The elevator is to the west, the stairwell is to the east, and a corridor leads north and south. There is a bottled water vending machine here.

>insert coin in machine
Jones inserts the coin in the machine and takes the bottle that appears a few seconds later.

>n
Galaxy Jones is in the ninth floor north hallway. This anonymous corporate hallway ends here at the north end of the building. An open doorway leads west. To the east is a door with a swipe lock, labeled "Cybernetica Inc."

>e
(first opening the Cybernetica door)
(first unlocking the Cybernetica door)
(with the black cardkey)

Galaxy Jones is in the Cybernetica office. It's spacious and luxurious, designed to make developers forget how spent they are from months of overwork and abuse. Ergonomic desks and chairs fill space like a furniture fractal, before giving way to an open area, presumably for group activities.

As soon as Jones steps into the office, a shot zaps just past her nose. She dives to the ground, protected by the maze of desks and chairs. Peeking through the mesh back of one of the chairs, she takes notice of both the purple guard robot training its disruptor on the room, and the chair's fine construction and lumbar support.

Jones (whispering): "We've got another one! I'm out of sight for now, but it's going to be hard to get a shot off at this 'bot."

Beck: "What's the situation?"

Jones: "I'm on the floor with desks and chairs all around. The target is a few yards off, coming this way. I might get a shot in, but it might just absorb it anyway."

Beck: "Well, see if you can sneak up on it. Maybe close up you can find a way past its defenses."

>x door
This side intentionally left blank.

>shoot robot
Jones raises her head and fires wide. The robot fires back. Jones ducks and crawls off among the labyrinth of desks.

Beck: "Are you still shooting at those things? Even if you hit "em it's not going to leave a scratch."

Jones (whispering): "So what do you propose?"

Beck: "Get closer. Keep your head down, but move in closer to it until you can get a good shot in."

>get closer
What should Jones get closer to?

>robot
She creeps a little ways toward the guard robot.

>get closer to robot
Slowly, slowly, Jones gets a little closer. Just a little more...

She must have poked up her shoulder or something, for the guard robot fires his disruptor. The shot takes out a window on the east side of the room. The electrostatic field around the building keeps the atmosphere from pouring out.

>get closer to robot
Jones is right up next to the robot, crouched beneath a desk. She'll never get a better shot.

>stand up
Jones starts to stand, and a shot zips by, way too close. She hits the deck.

>shoot robot
Jones aims the pistol upward under the robot's enhanced armor and fires. She flinches back when the robot's innards explode downward in a shower of sparks. It topples over, dead.

[Your score has just gone up by one point.]

Jones: "Better than a video game. "

Beck: "Nice, but don't forget to credit your handler."

Jones: "Yes, yes, thanks for helping me not get killed."

Beck: "You're welcome."

>x robot
The tattered guts of the purple guard robot spill out from its armored carapace.

>s
Jones can't go that way.

>e
Jones: "I'm going out the window to see if I can find a way to get up to the tenth floor."

Beck: "Whoa whoa whoa, Jones. You know you're not good with heights."

Jones: "Ask Thallium how how much that matters once I've kicked his ass. Watch me, I'll look down and not even flinch."

Jones puts on the Atmo-Suit.

Galaxy Jones is on a ledge. She's plastered up against the wall, trying not to look down.

* * *

>open vent
Jones loosens the screws with the screwdriver and removes the grill from the vent.

>w
Jones climbs inside the vent, crawls along a short length of duct work, and emerges through another, hinged grill, into the air handling room.

[Your score has just gone up by one point.]

Galaxy Jones is in the air handling room. There is a good number of loud fans and other air handling machinery here. A small hinged vent opening leads into some ductwork, and from there to the outside. A door leads west.

She takes off the Atmo-Suit.

Jones: "Ha! I'm in!"

Beck: "Be careful, you're likely to run into more resistance here. The floor is all one open office, so any guard robots will have good line of sight."

Jones: "Got it."

Beck: "And Jones? Save your game."

>w
(first opening the air handling door)

Galaxy Jones is on the north side of the Consolidated Microthings office. This is the company cafeteria. The elevator is south, the air handling room is to the east, and the office continues to the west and southeast.

* * *

>x ceiling
Asbestos? In this day and age?

>remove panel
(the ceiling panel)
Jones isn't wearing the ceiling panel.

>take it
Jones removes the ceiling panel, exposing a hole wide enough for her to climb through.

>e
Galaxy Jones is in the tenth floor elevator hall. The elevator car to the west stands open. There is a stairwell to the east. The hall runs north and south into a sumptuous corporate office.

* * *

>n
Galaxy Jones is on the north side of the Consolidated Microthings office. This is the company cafeteria. The elevator is south, the air handling room is to the east, and the office continues to the west and southeast.

>s
Galaxy Jones is in the tenth floor elevator hall. The elevator car to the west stands open. There is a stairwell to the east. The hall runs north and south into a sumptuous corporate office.

* * *

>w
Galaxy Jones is in the elevator car. It's luxurious, with gold-plated walls and crystal lighting on the ceiling. The button panel is lacquered dark mahogany with what looks like real ivory buttons. The carpeting is soft and plush. A golden keyhole sits above the buttons.

The mauve guard robot appears to the east, coming from the south.

>u
Galaxy Jones is on the top of the elevator car. The elevator shaft extends many hundreds of feet above here. She can see down into the elevator car from here.

The mauve guard robot enters the elevator car below.

>jump on robot
Jones drops down through the ceiling and on to the guard robot. It swings around looking for her, obviously panicked that it can't bring its gun to bear on its attacker. Jones manages to hang on.

The mauve guard robot struggles against her hold on it, to no avail.

>pour gel on robot
Jones pours the gel into the vent on the robot's head. The robot flails around wildly and throws her from its back, then lets out a loud crackling sound and stops moving.

[Your score has just gone up by one point.]

Galaxy Jones is in the elevator car. It's luxurious, with gold-plated walls and crystal lighting on the ceiling. The button panel is lacquered dark mahogany with what looks like real ivory buttons. The carpeting is soft and plush. A golden keyhole sits above the buttons.

The remains of the mauve guard robot are sprawled on the ground.

>x remains
From the outside there's no sign of what killed the mauve guard robot.

>e
Galaxy Jones is in the tenth floor elevator hall. The elevator car to the west stands open. There is a stairwell to the east. The hall runs north and south into a sumptuous corporate office.

>s
Galaxy Jones is on the south side of the Consolidated Microthings office. This is reception. It has a great view of the New Reykjavik Botanic Dome. Couches are lined up to take advantage. The floor east and west, and north to the elevator

>w
Galaxy Jones is at the southwest corner of the Consolidated Microthings office. This looks like the IT area of the office. Numerous desks and an abundance of computer parts are here. Jones can go north or east from here.

There is a present with a note attached sitting on a desk here.

>open present
Jones rips the package open and discovers a golden key.

>e
Galaxy Jones is on the south side of the Consolidated Microthings office. This is reception. It has a great view of the New Reykjavik Botanic Dome. Couches are lined up to take advantage. The floor east and west, and north to the elevator

>n
Galaxy Jones is in the tenth floor elevator hall. The elevator car to the west stands open. There is a stairwell to the east. The hall runs north and south into a sumptuous corporate office.

>w
Galaxy Jones is in the elevator car. It's luxurious, with gold-plated walls and crystal lighting on the ceiling. The button panel is lacquered dark mahogany with what looks like real ivory buttons. The carpeting is soft and plush. A golden keyhole sits above the buttons.

The remains of the mauve guard robot are sprawled on the ground.

>put golden key in keyhole
Jones puts the key in the keyhole and turns. There is a pleasant chime, and some buttons light up.

Galaxy Jones is in the elevator car. It's luxurious, with gold-plated walls and crystal lighting on the ceiling. The button panel is lacquered dark mahogany with what looks like real ivory buttons. The carpeting is soft and plush. A golden key rests in a golden keyhole above the buttons. The buttons 1, 9, 10, and 100 are illuminated.

The remains of the mauve guard robot are sprawled on the ground.

>press 100
The elevator accelerates upwards at a frightening rate. The numbers cllimb towards 100. Soon the elevator slows, and the door opens on the 100th floor.

Jones: "Holy - This thing goes fast."

Galaxy Jones is in the elevator car. It's luxurious, with gold-plated walls and crystal lighting on the ceiling. The button panel is lacquered dark mahogany with what looks like real ivory buttons. The carpeting is soft and plush. A golden key rests in a golden keyhole above the buttons. The buttons 1, 9, 10, and 100 are illuminated.

The remains of the mauve guard robot are sprawled on the ground.

>e
Galaxy Jones is in the 100th floor elevator hall. The luxury is staggering.  The walls are made of polished black marble, and the floors are covered in plush black carpeting that muffles the sound of footsteps. The ceiling is high and adorned with a crystal chandelier. The elevator doors to the west are gold-plated. Sumptuous living quarters are visible to the north and south.

I beg your pardon?

>e
Jones can't go that way.

>x wall
Black marble. Wow. It's beautiful.

>s
Galaxy Jones is in the southern corner of the penthouse. This must be Thallium's "treasure room", to go by the obscene display of wealth. The most notable feature is the array of diamonds lining the walls. Everything else here pales in comparison. The penthouse continues to the northwest, north, and northeast.

Thallium seems to speak from all around Jones. "You like diamonds, Jones? Of course you do -- they're a girl's best friend, after all."

Jones snorts, "Sure, Thallium."

>pry diamond
Taken.

Thallium giggles. "Oh, I hope you're not disappointed, Jones."

>x it
Jones: "Hmm. This is made of glass."

Thallium: "Poor, sad Jones. But here's the thing. There is a real diamond in there; it's just you'll never find it before the building's defenses flood the whole floor with poisonous gas. Or maybe I'm bluffing. Maybe I'm not. Can you afford to gamble?"

Jones tosses the fake away.

>smash diamonds
(with the hammer)
Jones commences to smash all of the diamonds. After destroying several dozen fraudulent gems, she finds one that won't break. She takes the real diamond.

Thallium: "Wow, clever solution. Be careful you don't cut yourself."

Jones: "I appreciate your concern."

* * *

>put gem in claw
As soon as insert the real diamond into the claw, laser beams spring from five emitters on the walls. They hit the diamond and join into a single more powerful beam that strikes the electronic eye on the wall. A sound like a sliding door comes from behind Jones, and she spins around to see the red wall slide down into the floor. It exposes a control panel of sorts, featuring a large red button labeled "Press Me".

>x panel
Jones discovers a secret panel, which when opened exposes a small black button.

* * *

>u
Galaxy Jones is on the roof stairs. Thick slabs of marble lead from the hall to the west to the rooftop door above.

>u
(first opening the roof access door)
Jones opens the door and steps through onto the roof. The door crashes shut, and a lock audibly clicks.

[Your score has just gone up by one point.]

Jones walks out onto the luxurious penthouse roof. Admiral Thallium turns from the railing to face her. He is dressed in an absurd elaboration of a Martian Admiral's uniform. He looks Jones up and down with a lecherous leer. "Ah, Galaxy Jones, as lovely as ever. If it weren't so unbearably cliché I'd ask you to join me in my rise to greatness. But alas, you are too habituated to the smug high of 'goodness'." He sighs dramatically. "We've trodden similar ground before; no need to discuss it further. Although I would challenge any of your various amoureux to conjugate 'tread' correctly.

"Anyway, I guess this is the time where you do something predictably undignified and violent. Before you do I feel I should inform you that your sidearm has been rendered quite ineffective by my personal security field. But do go ahead and try it."

Jones sneers. "I wouldn't give you the satisfaction," she says, looking around. "I see you don't have any of your robot pets up here. How are you going to stop me from rescuing Europa?"

"Oh please, while we're trying things, try that too. I wish you luck breaking the silnium bars of the cage."

"What's silnium?"

"A superstrong material invented here in my Martian Chemical laboratory. We had a press conference for it -- weren't you watching?"

"Couldn't be bothered."

"Oh for frotz sake, Jones, you're so frustrating!"

Thallium turns his back on Jones and stares out over the city.

Galaxy Jones is on the penthouse roof. It is an extravagant and opulent space, designed to showcase Thallium's wealth and power. Much of the rooftop is devoted to an outdoor lounge area, with comfortable seating and a fire pit, centered around a hot tub and flanked by a bar. All around is the city of New Reykjavik, and beyond that the red Martian landscape. Around the entirety of the roof is an electrostatic field designed to keep air in and particulates out. To the north is a large cage, and to the west is a landing pad. Jones can distantly see a woman lying on the floor of the cage. A green and black flyer sits on the landing pad.

Admiral Thallium is sulking.

>n
Galaxy Jones is next to the cage. The closely-set silnium bars seem to dash all hope of a rescue.

Europa Callisto is lying at the center of the cage, out of Jones's reach.

Jones tries the strength of the bars just in case. They don't budge.

South of the cage, Thallium crosses the roof to the flyer pad, where he boards the waiting flyer. The flyer lifts off and moves towards Jones.

>s
Galaxy Jones is on the penthouse roof. It is an extravagant and opulent space, designed to showcase Thallium's wealth and power. Much of the rooftop is devoted to an outdoor lounge area, with comfortable seating and a fire pit, centered around a hot tub and flanked by a bar. All around is the city of New Reykjavik, and beyond that the red Martian landscape. Around the entirety of the roof is an electrostatic field designed to keep air in and particulates out. To the north is a large cage, and to the west is a landing pad. Jones can distantly see a woman lying on the floor of the cage.

Thallium's flyer hovers over the rooftop. "Jones!"  he bellows. "Play time is over. I grow weary of your intransigence. In a moment this roof will be swarmed by guard robots -- of many different colors -- so many robots you couldn't possibly vandalize them all.  Say your prayers, Jones, or whatever you do when you're about to die."

Jones rolls her eyes.

A little ways off, a small red flyer aims for the rooftop and accelerates.

>w
Thallium's flyer floats after Jones.

Galaxy Jones is on the flyer pad. This is what one would expect from a rooftop flyer pad: landing lights surrounding a large letter F painted in white on a red background.

>e
Thallium's flyer floats after Jones.

Galaxy Jones is on the penthouse roof. It is an extravagant and opulent space, designed to showcase Thallium's wealth and power. Much of the rooftop is devoted to an outdoor lounge area, with comfortable seating and a fire pit, centered around a hot tub and flanked by a bar. All around is the city of New Reykjavik, and beyond that the red Martian landscape. Around the entirety of the roof is an electrostatic field designed to keep air in and particulates out. To the north is a large cage, and to the west is a landing pad. Jones can distantly see a woman lying on the floor of the cage.

>n
Thallium's flyer floats after Jones.

Galaxy Jones is next to the cage. The closely-set silnium bars seem to dash all hope of a rescue.

Europa Callisto is lying at the center of the cage, out of Jones's reach.

>get on cage
(the cage)
Jones gets onto the cage.

>throw cable at rails
[Your score has just gone up by one point.]

Jones throws the cable up to the flyer where it hooks around the rail, and attaches the other end to the cage, then jumps off the cage to escape the aftermath. Seeing his flyer's predicament, Thallium jumps through the door and disappears below the edge of the roof. The flyer reaches the end of its tether and slingshots downwards, slamming into side of the building.

The cage has tilted to the side, one attachment torn loose from the rooftop. Jones crawls into the cage to see to Europa Callisto.

"Europa! Can you hear me? I need you to move to get out of this cage. I can't carry you through that small opening. Europa!"

Europa moans but doesn't show any signs of having understood Jones.

Galaxy Jones is in the cage. The whole structure is tilted, leaving a hole at the eastern end.

Jones is kneeling at Europa Callisto's side, trying to rouse her.

The red flyer, now recognizable as Galaxy's own, settles down onto the landing pad.

>pour water on europa
It's not elegant, but it works.

[Your score has just gone up by one point.]

Jones opens the water bottle and brings it to Europa's lips. Even with closed eyes she drinks, first slowly and then with increasing vigor, until her eyes open.

"Ga- Galaxy Jones?" she says.

Jones nods, but says "We'll have time for introductions later. We have to get out of here before the roof is full of killer robots. Can you crawl? If you can get through that hole I can carry you the rest of the way."

Europa nods. "I think so."

Galaxy Jones helps her through the hole in the cage, then gently picks her up and jogs toward the waiting flyer. Beck's familiar face appears at the door of the aircraft, urging her on.

Not so far away, Admiral Thallium crawls back over the edge of  the roof. As he pulls himself up, he aims a pistol at Jones's back...

...and she falls sprawling on the landing pad, Europa Callisto tumbling from her arms. Beck is by Callisto's side in a moment, lifting her and carrying her into the flyer.

And then the robots swarm the roof like a mechanical rainbow tide. By the time Beck returns to the door it is already too late. A group of robots surrounds Jones, while another robot carries Thallium triumphantly. Beck has no choice but to take off, leaving Jones behind, not knowing if she still lives...

    *** The End, For Now... ***

In that game you scored 10 out of a possible 10, in 237 turns.

Extensions by:
Standard Rules version 3/120430 by Graham Nelson
Deluxe Doors version 4 by Emily Short
Skeleton Keys by Emily Short
Epistemology version 9 by Eric Eve
Conversation Framework version 11 by Eric Eve
Property Checking version 4 by Emily Short
Gender Options version 3/210331 by Nathanael Nerode

Story by Phil Riley.
Programming by Phil Riley.
Playtesting by Leon Lin, Oliver Matthias, and Jade.
Invaluable inspiration from Laura Taalman.

The story, all names, characters, and incidents portrayed in this production are fictitious. No identification with actual persons (living or deceased), places, buildings, and products is intended or should be inferred.

Promotional consideration provided by Olympus Springs Inc.

...

<Black screen>

"Jones! Jones! Wake up! I'm trying to talk to you!"

<Cut to a shot of two closed eyes>

"C'mon, open those eyes."

<The shot widens to show Galaxy Jones, the Solar System's greatest hero, flat on the floor, seemingly unconscious>

"This is getting tiresome, Jones. Stop playing dead."

Her eyes flutter open, close again, then open. She winces and brings one hand up to shield her eyes. "Who's that?" she says, hoarsely.

Join Galaxy Jones next time in Galaxy Jones II: Existential Time Crisis!

Would you like to RESTART, RESTORE a saved game, QUIT, or UNDO the last command?

* * *

>press black button
Somewhere beyond this room comes the sound of something heavy being moved.

Beck: "Why ever did you not press the button that said 'Press Me'? Maybe we should press it anyway. Please?"

>press red button
Thallium's voice startles Jones, and she forgets the button for a moment.

"Yes, yes, press it!", Thallium squeaks.

>press red button
Jones presses the red button, but nothing seems to happen. After a few seconds, however, she starts to feel light-headed, and shortly after she starts to suffocate. It's not a nice way to die.

    *** Galaxy Jones was killed by poison gas. ***

In that game you scored 7 out of a possible 10, in 227 turns.

Would you like to RESTART, RESTORE a saved game, QUIT, or UNDO the last command?

>undo
Galaxy Jones is in the western corner of the penthouse.
[Previous turn undone.]

* * *

>y
The phone rings. Galaxy Jones, the solar system's greatest hero, rolls over in bed and presses the talk button.

"Yes?" she says in a voice thick with sleep.

"Hello, is this Galaxy Jones?" comes the voice from the speaker.

"Yes, this is she. To whom am I speaking?"

"Oh, hi, Ms Jones. This is Patty, I work for Admiral P. X. Thallium, CEO of Diversified Entanglements, LLC. He asked me to forward a message to you."

"He did, did he? Now what would the Admiral want to say to me?"

"Oh, it's not from the Admiral himself. It's from one Miss Europa Callisto. I must say, the Admiral was quite surprised when I said I didn't know who she is. Apparently she's famous."

"Yes, quite famous, but why would she send a message to me, and why on Mars would she send it through Thallium? But never mind, what's the message?"

Patty can be heard rustling paper. "Let's see... it's here somewhere. Oh yes, here it is. The message is 'Help.'"

Ten minutes later, Galaxy Jones, in her speeder Galaxy One, races across the desolate expanse of Utopia Planitia, Mars. Her nemesis, the thoroughly execrable Admiral Thallium, has taken hostage the exquisite Europa Callisto, singer and actress renowned throughout a dozen solar systems. As Patty has quite helpfully explained, Miss Callisto is imprisoned at the top of the Viking Building in New Reykjavik, guarded by an impressive number of killer robots and other diabolical instruments of Jones's inevitable demise. The Admiral has most cordially invited Ms Jones to break into his building and attempt a rescue.

"Oh I will," Galaxy mutters to herself. This time, she vows silently, Thallium won't escape.

Plus she'll get to meet Europa Callisto. That'll be totally sweet.

accessible has no description.

Galaxy Jones!
An Interactive Fiction by Phil Riley
Release 1 / Serial number 230311 / Inform 7 build 6M62 (I6/v6.34 lib 6/12N) SD

A sleek dark red speeder roars into the dock of the Viking Building. A tall woman in a battle-ready jumpsuit climbs out of it: Galaxy Jones.

Galaxy Jones is in the speeder dock. A safe harbor from the periodic dust storms of Utopia Planitia, the dock features several dozen speeder bays. Only a few are filled right now. The building entryway is to the north, under a red stone façade carved into the likeness of a fearsome Viking.

Jones's speeder, Galaxy One, sits in one of the parking bays.

Jones's handler Beck comes over her headset. "Alright, what's going on?"

She replies, "I'm in the speeder dock. No movement. What can I expect inside?"

"Blueprints show the ground floor is one big empty space with elevators in the center. Not a lot of places for resistance to hide, but you can never tell. Be careful.

"And one other thing, Jones: if you need help you can ASK BECK FOR HELP. You can also ASK BECK ABOUT things or ASK BECK ABOUT GAME for more information about the game. Finally, you can cause help to repeat from the beginning by saying ASK BECK TO RESET HELP"

* * *

>shoot art
Jones fires the disruptor into the sculpture's main support cable, snapping it. The huge crystal blob starts to sag, straining the other cables. In quick succession they break as well, and the whole installation plummets to the ground, right on top of the hapless guard robots.

[Your score has just gone up by one point.]

Beck: "What was that crash? What's going on?"

Jones: "That, my friend, was what you'd call a work of art. Targets terminated."