>undo
Galaxy Jones is in the cage. 
[Previous turn undone.]

>a hall
Beck: "I'm not sure what you're asking about, Jones."

>a view
Beck: "I'm not sure what you're asking about, Jones."

Beck sticks his head out of the door of the flyer and yells "C'mon Jones, get Europa and get in the flyer!"

>a region
Beck: "I'm not sure what you're asking about, Jones."

>a accessible
Beck: "I'm not sure what you're asking about, Jones."

>a atmo
Beck: "Good thing this was around."

>a thallium
(Admiral Thallium)

Beck: "Wonderful man, can't get enough of him."

>a beck
Beck: "I'm just happy to serve."

>a bed
Beck: "No time to rest, Jones."

>a cardkey
Which do you mean, the black cardkey or the red cardkey?

>black
Beck: "Hmm. Don't have much to say about that right now."

>a red
(the red and green guard robots)

Beck: "I've really come to appreciate art a lot more since then."

>a red cardkey
Beck: "Hmm. Don't have much to say about that right now."

>a cat
Beck: "I'm not sure what you're asking about, Jones."

>a gel
Beck: "I imagine it does what it says it does."

>a water
Beck: "Say Jones, you could use an endorsement contract. How about Olympus Springs water?"

Jones: "Yeah, sure."

>a window
Beck: "Wow. Impressive."

>a broken-window
Beck: "I'm not sure what you're asking about, Jones."

>actions
Actions listing on.

>a window
[implicit-quizzing outside]
[(1) quizzing Beck about outside]

Beck: "Wow. Impressive."
[(1) quizzing Beck about outside - failed]

[implicit-quizzing outside - failed]

>a outside
(outside)
[implicit-quizzing outside]
[(1) quizzing Beck about outside]

Beck: "Wow. Impressive."
[(1) quizzing Beck about outside - failed]

[implicit-quizzing outside - failed]

>a cage
[implicit-quizzing the cage]
[(1) quizzing Beck about the cage]

Beck: "You're going to need a lot of force to get through that."
[(1) quizzing Beck about the cage - failed]

[implicit-quizzing the cage - failed]

>a entryway
[implicit-asking "entryway"]
[(1) asking Beck about "entryway"]

Beck: "I'm not sure what you're asking about, Jones."
[(1) asking Beck about "entryway" - succeeded]

[implicit-asking "entryway" - failed]

>a coin
[implicit-asking "coin"]
[(1) asking Beck about "coin"]

Beck: "I'm not sure what you're asking about, Jones."
[(1) asking Beck about "coin" - succeeded]

[implicit-asking "coin" - failed]

>a panel
[implicit-asking "panel"]
[(1) asking Beck about "panel"]

Beck: "I'm not sure what you're asking about, Jones."
[(1) asking Beck about "panel" - succeeded]

[implicit-asking "panel" - failed]

>a table
[implicit-asking "table"]
[(1) asking Beck about "table"]

Beck: "I'm not sure what you're asking about, Jones."
[(1) asking Beck about "table" - succeeded]

[implicit-asking "table" - failed]

>a chandelier
[implicit-asking "chandelier"]
[(1) asking Beck about "chandelier"]

Beck: "I'm not sure what you're asking about, Jones."
[(1) asking Beck about "chandelier" - succeeded]

[implicit-asking "chandelier" - failed]

>cabinet
I didn't understand that sentence.

>a parking bays
[implicit-asking "parking bays"]
[(1) asking Beck about "parking bays"]

Beck: "I'm not sure what you're asking about, Jones."
[(1) asking Beck about "parking bays" - succeeded]

[implicit-asking "parking bays" - failed]

>a pin
[implicit-quizzing the safety pin]
[(1) quizzing Beck about the safety pin]

Beck: "You never know when you might need something that can get in a very small space."
[(1) quizzing Beck about the safety pin - failed]

[implicit-quizzing the safety pin - failed]

>a jelly
[implicit-quizzing poached ostrich eggs in jelly]
[(1) quizzing Beck about poached ostrich eggs in jelly]

Beck: "Hmm. Don't have much to say about that right now."
[(1) quizzing Beck about poached ostrich eggs in jelly - ended without result]

[implicit-quizzing poached ostrich eggs in jelly - failed]

>a new reykjacik
[implicit-asking "new reykjacik"]
[(1) asking Beck about "new reykjacik"]

Beck: "I'm not sure what you're asking about, Jones."
[(1) asking Beck about "new reykjacik" - succeeded]

[implicit-asking "new reykjacik" - failed]

>a new reykjavik
[implicit-quizzing outside]
[(1) quizzing Beck about outside]

Beck: "Wow. Impressive."
[(1) quizzing Beck about outside - failed]

[implicit-quizzing outside - failed]

>\
I didn't understand that sentence.

>a reception
[implicit-asking "reception"]
[(1) asking Beck about "reception"]

Beck: "I'm not sure what you're asking about, Jones."
[(1) asking Beck about "reception" - succeeded]

[implicit-asking "reception" - failed]

>a elevator
[implicit-quizzing the elevator drop key]
[(1) quizzing Beck about the elevator drop key]

Beck: "I'm not sure what that is. Look closer."
[(1) quizzing Beck about the elevator drop key - failed]

[implicit-quizzing the elevator drop key - failed]

>a vent
[implicit-asking "vent"]
[(1) asking Beck about "vent"]

Beck: "I'm not sure what you're asking about, Jones."
[(1) asking Beck about "vent" - succeeded]

[implicit-asking "vent" - failed]

>a flyer
[implicit-quizzing the red flyer]
[(1) quizzing Beck about the red flyer]

Beck: "I'm flying it! No time to talk!"
[(1) quizzing Beck about the red flyer - failed]

[implicit-quizzing the red flyer - failed]

>a diamond
[implicit-quizzing the real diamond]
[(1) quizzing Beck about the real diamond]

Beck: "Ooh pretty."
[(1) quizzing Beck about the real diamond - failed]

[implicit-quizzing the real diamond - failed]

>i
[taking inventory]
Jones is carrying:
  a screwdriver
  a black cardkey
  a full water bottle
  a hammer
  an elevator drop key
  a safety pin
  a garish medal
  a fork
  a red cardkey
  an Atmo-Suit
  a disruptor pistol

[taking inventory - succeeded]

>a purple robot
[implicit-asking "purple robot"]
[(1) asking Beck about "purple robot"]

Beck: "I'm not sure what you're asking about, Jones."
[(1) asking Beck about "purple robot" - succeeded]

[implicit-asking "purple robot" - failed]

>a golden key
[implicit-quizzing the golden key]
[(1) quizzing Beck about the golden key]

Beck: "Gold is a terrible material for keys."
[(1) quizzing Beck about the golden key - failed]

[implicit-quizzing the golden key - failed]

>a golden keyhole
[implicit-asking "golden keyhole"]
[(1) asking Beck about "golden keyhole"]

Beck: "I'm not sure what you're asking about, Jones."
[(1) asking Beck about "golden keyhole" - succeeded]

[implicit-asking "golden keyhole" - failed]

>a mauve roboy
[implicit-asking "mauve roboy"]
[(1) asking Beck about "mauve roboy"]

Beck: "I'm not sure what you're asking about, Jones."
[(1) asking Beck about "mauve roboy" - succeeded]

[implicit-asking "mauve roboy" - failed]

>a mauve robot
[implicit-quizzing the dead mauve robot]
[(1) quizzing Beck about the dead mauve robot]

Beck: "Nice job, Jones."
[(1) quizzing Beck about the dead mauve robot - failed]

[implicit-quizzing the dead mauve robot - failed]

>a mauve guard robot
[implicit-quizzing the dead mauve robot]
[(1) quizzing Beck about the dead mauve robot]

Beck: "Nice job, Jones."
[(1) quizzing Beck about the dead mauve robot - failed]

[implicit-quizzing the dead mauve robot - failed]

>a lander
[implicit-quizzing the Viking 2 lander]
[(1) quizzing Beck about the Viking 2 lander]

Beck: "I'd heard it was stolen. I can't believe he just flaunts it like this."
[(1) quizzing Beck about the Viking 2 lander - failed]

[implicit-quizzing the Viking 2 lander - failed]

>a tower
[implicit-asking "tower"]
[(1) asking Beck about "tower"]

Beck: "I'm not sure what you're asking about, Jones."
[(1) asking Beck about "tower" - succeeded]

[implicit-asking "tower" - failed]

>a ivory
[implicit-quizzing the ivory buttons]
[(1) quizzing Beck about the ivory buttons]

Beck: "I keep thinking he can't get any worse, and then he tops himself."
[(1) quizzing Beck about the ivory buttons - failed]

[implicit-quizzing the ivory buttons - failed]

>a hammer
[implicit-quizzing the hammer]
[(1) quizzing Beck about the hammer]

Beck: "A hammer can't hurt. I mean, it can, but you know what I mean."
[(1) quizzing Beck about the hammer - failed]

[implicit-quizzing the hammer - failed]

>a speeder
[implicit-quizzing the speeder]
[(1) quizzing Beck about the speeder]

Beck: "I keep reminding you, but you still haven't taken it in for yearly maintenance."
[(1) quizzing Beck about the speeder - failed]

[implicit-quizzing the speeder - failed]

>gonear ladder
Which do you mean, the elevator shaft or the ladder?

>ladder
Which do you mean, the elevator shaft or the ladder?

>elevator shaft
[(1) looking]
Galaxy Jones is on the top of the elevator car. She is right at the top of the shaft. She can see down into the elevator car from here.

[(1) looking - succeeded]

>a ladder
[implicit-quizzing the elevator shaft]
[(1) quizzing Beck about the elevator shaft]

Beck: "Hmm. Don't have much to say about that right now."
[(1) quizzing Beck about the elevator shaft - ended without result]

[implicit-quizzing the elevator shaft - failed]

>d
[going down]
Jones can't leave Europa now!
[going down - failed]

>purloin europa
[Purloined.]

>i
[taking inventory]
Jones is carrying:
  Europa Callisto
  a screwdriver
  a black cardkey
  a full water bottle
  a hammer
  an elevator drop key
  a safety pin
  a garish medal
  a fork
  a red cardkey
  an Atmo-Suit
  a disruptor pistol

[taking inventory - succeeded]

>x europa
[examining Europa Callisto]
Europa Callisto is a stunningly beautiful woman with long ice-blue hair and piercing blue eyes. Right now she's looking pretty ragged, though.

[examining Europa Callisto - succeeded]

>a europa
[implicit-quizzing Europa Callisto]
[(1) quizzing Beck about Europa Callisto]

Beck: "You'll need to revive her if you want to get her out of there."
[(1) quizzing Beck about Europa Callisto - failed]

[implicit-quizzing Europa Callisto - failed]

>actions off
Actions listing off.

>ask for help
Beck: "Looks like you're managing okay."

>ask for help
Beck: "Looks like you're managing okay."

>gonear cage
(the cage)
Galaxy Jones is in the cage. The whole structure is tilted, leaving a hole at the eastern end.

>ask for help
Beck: "Congratulations! You made it this far."

>ask for help
Beck: "You need to break Europa out of the cage and get her to a rescue flyer."

>ask for help
Beck: "Don't worry, the rescue flyer will show up on time."

>ask for help
Beck: "To break open the cage, you'll need to find some way to apply a great force to it."

>ask for help
Beck: "Hook the cable to the flyer and the cage by saying THROW CABLE AT FLYER."

>ask for help
Beck: "Come up short? Get higher."

>ask for help
Beck: "Climb the cage."

>ask for help
Beck: "Now throw the cable."

>ask for help
Beck: "Now you're in the cage but Europa is unresponsive. How do you revive her?"

>ask for help
Beck: "The water of course!"

>ask for help
Beck: "The water of course!"