>d
Should Jones burrow downward?

>u
Jones can neither climb walls nor fly.

>w
Jones can't just leave Europa in the hands of Admiral Thallium!

* * *

>n
Jones approaches the Viking Building entryway, the dramatic façade towering over her.

Galaxy Jones is at the entry doorway. A glass revolving door leads into a large open space north of here. The speeder dock is to the south.

Jones peers upwards at the 100 stories of glass and steel. "What do you want to bet Thallium's got Europa all the way at the top?"

Beck: "Oh, no doubt."

>d
Should Jones burrow downward?

>n
Jones takes a deep breath. "I'm going in."

Beck replies, "You got this, Galaxy."

Jones passes through the revolving door and into the lobby, alert to any defenses.

Galaxy Jones is in the lobby. The ground floor of the Viking Building is breathtaking. Low-G architecture means more glass and thinner supports, and the building takes advantage of that. Four walls of glass surround a central pillar in which are set the utility rooms and elevators. In between is an expanse of plants, water features, and stylish seating. Near the entryway is a front desk. A giant crystal sculpture floats above the center of the area, suspended on almost invisible cables. She may go east and west from here, north to the elevators, or south out of the building.

Suddenly two robot guards, green and red, emerge from niches in the back wall! She dives behind the front desk and draws her disruptor pistol.

Jones shouts, "I'm under fire from two ugly robot things!"

Beck responds, "Monitoring your suit radar."

>d
Should Jones burrow downward?

>u
Jones can neither climb walls nor fly.

The robots intone "Destroy Jones" in an eerie drone.

>ne
That would just get Jones lost in a maze of couches.

>nw
That would just get Jones lost in a maze of couches.

>se
Jones can go south out of the building or north to the elevator. East or west will take her around the building.

Beck: "Robot on your right!"

One robot tries to flank Jones, but a shot from her disruptor sends it scurrying back.

* * *

>exits
I didn't understand that sentence.

>exits on
I didn't understand that sentence.

>exit on
I only understood you as far as wanting to exit.

>n
Jones approaches the Viking Building entryway, the dramatic façade towering over her.

Galaxy Jones is at the entry doorway. A glass revolving door leads into a large open space north of here. The speeder dock is to the south.

Jones peers upwards at the 100 stories of glass and steel. "What do you want to bet Thallium's got Europa all the way at the top?"

Beck: "Oh, no doubt."

>e
Jones is already at the main entrance. She's unlikely to find another way in.

>w
Jones is already at the main entrance. She's unlikely to find another way in.

>s
Jones slinks back to the speeder dock.

Galaxy Jones is in the speeder dock. A safe harbor from the periodic dust storms of Utopia Planitia, the dock features several dozen speeder bays. Only a few are filled right now. The building entryway is to the north, under a red stone façade carved into the likeness of a fearsome Viking.

Her speeder, Galaxy One, sits in one of the parking bays.

>se
Jones can't just leave Europa in the hands of Admiral Thallium!

>look s
There's nothing in that direction.

>n
Galaxy Jones is at the entry doorway. A glass revolving door leads into a large open space north of here. The speeder dock is to the south.

>n
Jones takes a deep breath. "I'm going in."

Beck replies, "You got this, Galaxy."

Jones passes through the revolving door and into the lobby, alert to any defenses.

Galaxy Jones is in the lobby. The ground floor of the Viking Building is breathtaking. Low-G architecture means more glass and thinner supports, and the building takes advantage of that. Four walls of glass surround a central pillar in which are set the utility rooms and elevators. In between is an expanse of plants, water features, and stylish seating. Near the entryway is a front desk. A giant crystal sculpture floats above the center of the area, suspended on almost invisible cables. She may go east and west from here, north to the elevators, or south out of the building.

Suddenly two robot guards, green and red, emerge from niches in the back wall! She dives behind the front desk and draws her disruptor pistol.

Jones shouts, "I'm under fire from two ugly robot things!"

Beck responds, "Monitoring your suit radar."

>look d
There's nothing in that direction.

>shoot art
Jones fires the disruptor into the sculpture's main support cable, snapping it. The huge crystal blob starts to sag, straining the other cables. In quick succession they break as well, and the whole installation plummets to the ground, right on top of the hapless guard robots.
 _________      __                     _____                     
 __/ ____/___ _/ /___ __  ____  __     __/ /___  ____  ___  _____
 _/ / __/ __ `/ / __ `/ |/ / / / /____ _/ / __ \/ __ \/ _ \/ ___/
 / /_/ / /_/ / / /_/ />  </ /_/ / _/ /_/ / /_/ / / / /  __(__  ) 
 \____/\__,_/_/\__,_/_/|_|\__, /  _\____/\____/_/ /_/\___/____/  
 _____________________________/ 

[Your score has just gone up by one point.]

Beck: "What was that crash? What's going on?"

Jones: "That, my friend, was what you'd call a work of art. Targets terminated."

>look d
There's nothing in that direction.

>look u
There's nothing in that direction.

* * *

>gonear 100th hall
Galaxy Jones is in the 100th floor elevator hall. The luxury is staggering.  The walls are made of polished black marble, and the floors are covered in plush black carpeting that muffles the sound of footsteps. The ceiling is high and adorned with a crystal chandelier. The elevator doors to the west are gold-plated. Sumptuous living quarters are visible to the north and south.

>push chandelier
Jones can't reach it.

>push doors
Aside from opening and closing them, what is there to do?

>x door
It's not clear why everything has to be so extravagant.

>x doors
It's not clear why everything has to be so extravagant.

>showme elevator doors
elevator doors - thing
location: in the 100th floor elevator hall
plural-named, improper-named, unused; unlit, inedible, fixed in place, scenery, neuter, seen, familiar, non-pourable
list grouping key: none
printed name: "elevator doors"
printed plural name: none
indefinite article: none
most recent reference: nominal
third singular pronoun: It-pronoun
conversation: none
description: "It's not clear why everything has to be so extravagant."
initial appearance: none
third-plural-pronoun: They-pronoun
elevator door - closed door
    drop key hole (part of elevator door)
location: in the ground floor elevator hall
singular-named, improper-named, unused; unlit, inedible, fixed in place, scenery, neuter, unseen, unfamiliar, non-pourable; closed, unopenable, unlocked
list grouping key: none
printed name: "elevator door"
printed plural name: "doors"
indefinite article: none
most recent reference: nominal
third singular pronoun: It-pronoun
conversation: none
description: "A gleaming gold elevator door. There is a hole near the top for inserting a drop key."
initial appearance: none
third-plural-pronoun: They-pronoun
other side: ground floor elevator shaft
matching key: elevator drop key
reverse side: elevator door
elevator door - closed door
location: in the ground floor elevator shaft
singular-named, improper-named, unused; unlit, inedible, fixed in place, scenery, neuter, unseen, unfamiliar, non-pourable; closed, openable, unlocked
list grouping key: none
printed name: "elevator door"
printed plural name: "doors"
indefinite article: none
most recent reference: nominal
third singular pronoun: It-pronoun
conversation: none
description: "The backside of the elevator door."
initial appearance: none
third-plural-pronoun: They-pronoun
other side: ground floor elevator hall
reverse side: elevator door
ninth floor elevator door - closed door
location: in the ninth floor elevator shaft
singular-named, improper-named, unused; unlit, inedible, fixed in place, scenery, neuter, unseen, unfamiliar, non-pourable; closed, openable, unlocked
list grouping key: none
printed name: "ninth floor elevator door"
printed plural name: "doors"
indefinite article: none
most recent reference: nominal
third singular pronoun: It-pronoun
conversation: none
description: "A golden sliding door, opening in the middle."
initial appearance: none
third-plural-pronoun: They-pronoun
other side: ninth floor elevator shaft

* * *

>gonear air
(the air handling room)
Galaxy Jones is in the air handling room. There is a good number of loud fans and other air handling machinery here. A small hinged vent opening leads into some ductwork, and from there to the outside. A door leads west.

>push door
Which do you mean, the air handling door or the vent access door?

>air
Aside from opening and closing it, what is there to do?

>gonear 100th
Galaxy Jones is in the 100th floor elevator hall. The luxury is staggering.  The walls are made of polished black marble, and the floors are covered in plush black carpeting that muffles the sound of footsteps. The ceiling is high and adorned with a crystal chandelier. The elevator doors to the west are gold-plated. Sumptuous living quarters are visible to the north and south.

>push doors
Aside from opening and closing it, what is there to do?

>x door
It's not clear why everything has to be so extravagant.

* * *

>gonear catering
Galaxy Jones is on the east side of the ground floor. Apparently some kind of function was happening here before Admiral Thallium emptied the building, for there is an array of canapes on a catering table here. The floor stretches north and south, and there's a closet door to the west.

Beck: "Blueprints indicate a closet to the west of you. Might be useful."

>0
An indicator light glows green.

Jones: "I've unlocked the east side utility door."

>x door
A typical white metal utility door. Next to it is a keypad with the digits 0-9. An indicator light glows green.

>2
An indicator light blinks red.

>x door
A typical white metal utility door. Next to it is a keypad with the digits 0-9. An indicator light glows red.

>w
(first opening the closet door)
(first unlocking the closet door)
Jones will have to enter the correct code on the keypad.

Jones: "Door on the east side has a keypad lock."

>0
An indicator light glows green.

>x door
A typical white metal utility door. Next to it is a keypad with the digits 0-9. An indicator light glows green.

>w
(first opening the closet door)

Galaxy Jones is in the maintenance closet. A bare, white-walled room containing various maintenance items.

There is an Atmo-Suit hanging from a hook here.

On the shelf is a red cardkey.

>n
Jones can't go that way.

>e
Galaxy Jones is on the east side of the ground floor. Apparently some kind of function was happening here before Admiral Thallium emptied the building, for there is an array of canapes on a catering table here. The floor stretches north and south, and there's a closet door to the west.

>n
Galaxy Jones is at the northeast corner of the ground floor. The area is dedicated to celebrating the military career of Admiral Thallium. Uniforms, medals, ribbons, and other miscellanea are mounted on the wall or in showcases. All this despite the fact that no one has turned up any evidence that Thallium served in any navy of any country on any planet. One can escape to the west or south.

Jones: "Now this is some choice bullshit here."

Beck: "Looks like the record of the good Admiral's long and dedicated service."

>take uniforms
There's too much of it to take!

>take medals
There's too much of it to take!

>x medals
Jones yawns looking over the assortment of faux honors. They're all behind glass, but one of the display cases is partly open, leaving the rather garish medal inside unprotected.

* * *

>gonear first shaft
There seems to be no such object anywhere in the model world.

* * *

>gonear ground shaft
Galaxy Jones is in the ground floor elevator shaft. Jones is at the bottom of a dark well. Shining her suit light up, she can see that the elevator car is several floors up, unmoving. There is a ladder running up the wall next to the door.

Beck: "Ooh. It's like we're in an action film."

>u
Jones climbs up the shaft, stopping at each floor to test each door. She gets all the way to the ninth floor, directly below the elevator car, before finding one that opens.

Galaxy Jones is in the ninth floor elevator shaft. The door here is closed.

Beck: "Huh. Seems like it should have taken longer than that."

>d
Galaxy Jones is in the ground floor elevator shaft. Jones is at the bottom of a dark well. Shining her suit light up, she can see that the elevator car is several floors up, unmoving. There is a ladder running up the wall next to the door.

>u
Galaxy Jones is in the ninth floor elevator shaft. The door here is closed.

>u
The way up is blocked by the elevator car.

* * *

>gonear ground floor elevator hall
Galaxy Jones is in the ground floor elevator hall. This hallway between the north and south ends of the ground floor is home to the elevator to the west. To the east is the entrance to a stairwell.

>u
As soon as Jones enters the stairwell, a disruptor blast from above zings past her shoulder, and she beats a hasty retreat. She won't be going up the stairs until she can clear out the resistance, and she can't do that from here.

Jones: "In case of fire, don't use the stairs."

Galaxy Jones is in the ground floor elevator hall. This hallway between the north and south ends of the ground floor is home to the elevator to the west. To the east is the entrance to a stairwell.

* * *

>gonear ground hall
Galaxy Jones is in the ground floor elevator hall. This hallway between the north and south ends of the ground floor is home to the elevator to the west. To the east is the entrance to a stairwell.

>purloin elevator drop key
Which do you mean, the elevator drop key or the drop key hole?

>key
Which do you mean, the elevator drop key or the drop key hole?

>gonear hammer
Galaxy Jones is in the elevator room. This is a utility room related to the operation of the elevator, on the other side of the east wall here. There is a control panel on the wall, and a door leading west.

Hanging from a hook here is an elevator drop key.

Lying discarded on a table here is a hammer.

>take key
Taken.

>gonear ground hall
Galaxy Jones is in the ground floor elevator hall. This hallway between the north and south ends of the ground floor is home to the elevator to the west. To the east is the entrance to a stairwell.

>unlock elevator
(the elevator door)
Jones inserts the elevator drop key into the drop key hole and turns it, disengaging the lock mechanism. Then she slides the door open.

>unlock elevator with drop key
(the elevator door with the elevator drop key)
The elevator door is already open.

>open elevator with drop key
(the elevator door with the elevator drop key)
The elevator door is already open.

>unlock elevator door with drop key
(the elevator door with the elevator drop key)
The elevator door is already open.

>close door
It isn't something Jones can close.

>se
That way leads straight into a wall.

>u
As soon as Jones enters the stairwell, a disruptor blast from above zings past her shoulder, and she beats a hasty retreat. She won't be going up the stairs until she can clear out the resistance, and she can't do that from here.

Jones: "In case of fire, don't use the stairs."

Galaxy Jones is in the ground floor elevator hall. This hallway between the north and south ends of the ground floor is home to the elevator to the west. To the east is the entrance to a stairwell. The elevator door is open, revealing the bottom of the elevator shaft. Jones could climb into it, if she wished.

>d
Should Jones burrow downward?

* * *

>x elevator
(the elevator door)
A gleaming gold elevator door. There is a hole near the top for inserting a drop key.

>elevators
They're in the center of the building.

* * *

>x elevator
(the elevator door)
A gleaming gold elevator door. There is a hole near the top for inserting a drop key.

>x elevator hole
It's a small hole about half an inch in diameter.

>x elevator hall
Galaxy Jones is in the ground floor elevator hall. This hallway between the north and south ends of the ground floor is home to the elevator to the west. To the east is the entrance to a stairwell.

>x stairs
They lead up from here.

>x south
Jones sees nothing unexpected in that direction.

* * *

>gonear ground shaft
Galaxy Jones is in the ground floor elevator shaft. Jones is at the bottom of a dark well. Shining her suit light up, she can see that the elevator car is several floors up, unmoving. There is a ladder running up the wall next to the door.

Beck: "Ooh. It's like we're in an action film."

>u
Jones climbs up the shaft, stopping at each floor to test each door. She gets all the way to the ninth floor, directly below the elevator car, before finding one that opens.

Galaxy Jones is in the ninth floor elevator shaft. The door here is open.

Beck: "Huh. Seems like it should have taken longer than that."

>a car
(the elevator car)

Beck: "It makes me uncomfortable, it hanging above us like that."

>e
 _________      __                     _____                     
 __/ ____/___ _/ /___ __  ____  __     __/ /___  ____  ___  _____
 _/ / __/ __ `/ / __ `/ |/ / / / /____ _/ / __ \/ __ \/ _ \/ ___/
 / /_/ / /_/ / / /_/ />  </ /_/ / _/ /_/ / /_/ / / / /  __(__  ) 
 \____/\__,_/_/\__,_/_/|_|\__, /  _\____/\____/_/ /_/\___/____/  
 _____________________________/ 

[Your score has just gone up by one point.]

Jones: "Finally out of the shaft. That was quite a climb."

Beck: "This floor is just offices. Check the building management office to the west. It might have some useful stuff."

Galaxy Jones is in the ninth floor elevator hall. The elevator is to the west, the stairwell is to the east, and a corridor leads north and south. There is a bottled water vending machine here.

>close door
That's already closed.

>w
(first opening the ninth floor elevator door)

Galaxy Jones is in the ninth floor elevator shaft. The door here is closed.

>close door
That's already closed.

>open it
Jones opens the ninth floor elevator door.

>e
Galaxy Jones is in the ninth floor elevator hall. The elevator is to the west, the stairwell is to the east, and a corridor leads north and south. There is a bottled water vending machine here.

* * *

>u
Jones climbs up the shaft, stopping at each floor to test each door. She gets all the way to the ninth floor, directly below the elevator car, before finding one that opens.

Galaxy Jones is in the ninth floor elevator shaft. The door here is open.

Beck: "Huh. Seems like it should have taken longer than that."

>x car
The elevator car is just above Jones's head.

>a cvar
Beck: "I'm not sure what you're asking about, Jones."

>a car
(the elevator car)

Beck: "Hmm. Don't have much to say about that right now."

* * *

>gonear management north
Galaxy Jones is at the north end of the building management office. The building management office is a bunch of desks and task boards. There is a particularly large desk against the west window. The office exit is to the east, and the office continues to the south.

>purloin red cardkey
[Purloined.]

* * *

>i
Jones is carrying:
  an elevator drop key
  a red cardkey
  a disruptor pistol

>unlock drawer with key
(the red cardkey)
Jones is unable to unlock the large desk with the red cardkey.

>drop key
Which do you mean, the elevator drop key or the red cardkey?

>z
Jones stands around and waits.

>unlock drawer with drop key
Jones is unable to unlock the large desk with the elevator drop key.

>gonear ground hall
Galaxy Jones is in the ground floor elevator hall. This hallway between the north and south ends of the ground floor is home to the elevator to the west. To the east is the entrance to a stairwell.

>unlock elevator door with key
Which do you mean, the drop key hole, the elevator drop key, or the red cardkey?

>unlock elevator door with drop key
(the elevator drop key)
Jones inserts the elevator drop key into the drop key hole and turns it, disengaging the lock mechanism. Then she slides the door open.

>gonear ninth north
Galaxy Jones is in the ninth floor north hallway. This anonymous corporate hallway ends here at the north end of the building. An open doorway leads west. To the east is a door with a swipe lock, labeled "Cybernetica Inc."

>unlock door with key
(the red cardkey)
Jones is unable to unlock the Cybernetica door with the red cardkey.

>unlock door with key drop
Jones is unable to unlock the Cybernetica door with the elevator drop key.

>w
Galaxy Jones is at the north end of the building management office. The building management office is a bunch of desks and task boards. There is a particularly large desk against the west window. The office exit is to the east, and the office continues to the south.

>x board
The board says "1. Describe scenery objects on Engineering Deck
 2. Fix check rule when installing new engine component
 3. Add more facts to computer database
 4. Fix Arvax response to rebooting the ship computer

and etc.".

>write foo
not blank.

Now the board says "1. Describe scenery objects on Engineering Deck
 2. Fix check rule when installing new engine component
 3. Add more facts to computer database
 4. Fix Arvax response to rebooting the ship computer

and etc. foo".

>erase board
Now the board is blank.

>write foo
blank.

Now the board says "foo".

>write "asdfa" on board
not blank.

Now the board says "foo "asdfa" on board".

>erase
(Jones)
That can't be erased.

>erase board
Now the board is blank.

>write lflflf
blank.

Now the board says "lflflf".

>write jones
not blank.

Now the board says "lflflf jones".

* * *

>write "asdfa" on board
not blank.

Now the board says "foo "asdfa" on board".

>erase board
Now the board is blank.

>x it
The board is blank.

* * *

>write "asdfa" on board
not blank.

Now the board says "foo "asdfa" on board".

>undo
Galaxy Jones is at the north end of the building management office.
[Previous turn undone.]

>x board
The board says "board".

>write foo
not blank.

Now the board says "foo foo".

>write bar
not blank.

Now the board says "foo foo bar".

>erase board
Now the board is blank.

* * *

>x it
The board is blank.

>write asdf
Now the board says "asdf".

>write ggg
Now the board says "ggg ggg".

>x board
The board says "ggg ggg".

* * *

>gonear management south
Galaxy Jones is at the south end of the building management office. The building management office is a bunch of desks and task boards. There is a filing cabinet against the east wall. The office exit is to the east, and the office continues to the north.

A screwdriver sits atop the filing cabinet.

>x cat
There's nothing like that nearby.

>take screwdriver
Jones reaches for the screwdriver, but she fumbles it and it rolls off the back of the filing cabinet.

Jones: "Damn."

Beck: "What? What's going on?"

Jones: "Just being clumsy is all."

* * *

>look behind cabinet
(taking the screwdriver)
Jones reaches behind the cabinet to retrieve the screwdriver. A swipe and a hiss make her recoil.

Jones: "Holy --!"

Beck: "What now?"

Jones: "There's a cat here! Behind a filing cabinet. Gotta get behind there to get a screwdriver, so I need a way to drive off the cat."

>take cat
No way. That thing is mean.

>touch cat
No way. That thing is mean.

>drop cat
No way. That thing is mean.

>x it
It's really a beautiful cat, sleek and black.

>unlock cabinet with cat
(first taking the black cat)
No way. That thing is mean.

>show shrimp to cat
There's nothing like that nearby.

>show
(Beck the disruptor pistol)
Beck is unimpressed.

>show cat
(the disruptor pistol)
The black cat is unimpressed.

>show cat shrimp
There's nothing like that nearby.

>showme cat
black cat - animal
location: in the south end of the building management office
singular-named, improper-named, unused; unlit, inedible, portable, neuter, seen, familiar, examined, non-pourable; not-active; angry
list grouping key: none
printed name: "black cat"
printed plural name: "animals"
indefinite article: none
most recent reference: nominal
third singular pronoun: Singular-they-pronoun
conversation: none
description: "It's really a beautiful cat, sleek and black."
initial appearance: none
third-plural-pronoun: They-pronoun
carrying capacity: 100
first-singular-pronoun: I-pronoun
first-plural-pronoun: We-pronoun
second-singular-pronoun: Singular-you-pronoun
second-plural-pronoun: Plural-you-pronoun
notable action: doing nothing
original location: room of stuff
new location: room of stuff

>give shrimp to cat
There's nothing like that nearby.

>i
Jones is carrying:
  a disruptor pistol

>purloin shrimp
[Purloined.]

>show shrimp to cat
Sensing food, the black cat pokes its head out, grabs the shrimp in its jaws, and races off. Jones takes the screwdriver.

 _________      __                     _____                     
 __/ ____/___ _/ /___ __  ____  __     __/ /___  ____  ___  _____
 _/ / __/ __ `/ / __ `/ |/ / / / /____ _/ / __ \/ __ \/ _ \/ ___/
 / /_/ / /_/ / / /_/ />  </ /_/ / _/ /_/ / /_/ / / / /  __(__  ) 
 \____/\__,_/_/\__,_/_/|_|\__, /  _\____/\____/_/ /_/\___/____/  
 _____________________________/ 

[Your score has just gone up by one point.]

Jones: "Aha! No creature is too fearsome for Galaxy Jones!"

Beck: "Congratulations on your victory."

>give shrimp to cat
Sensing food, the black cat pokes its head out, grabs the shrimp in its jaws, and races off. Jones takes the screwdriver.

 _________      __                     _____                     
 __/ ____/___ _/ /___ __  ____  __     __/ /___  ____  ___  _____
 _/ / __/ __ `/ / __ `/ |/ / / / /____ _/ / __ \/ __ \/ _ \/ ___/
 / /_/ / /_/ / / /_/ />  </ /_/ / _/ /_/ / /_/ / / / /  __(__  ) 
 \____/\__,_/_/\__,_/_/|_|\__, /  _\____/\____/_/ /_/\___/____/  
 _____________________________/ 

[Your score has just gone up by one point.]

Jones: "Aha! No creature is too fearsome for Galaxy Jones!"

Beck: "Congratulations on your victory."

>actions
Actions listing on.

>give shrimp to cat
[giving the shrimp tea sandwich to the black cat]
[(1) saying hello to the black cat]
They're not likely to be helpful.
[(1) saying hello to the black cat - failed the Check saying hello to someone when the noun is not beck and the noun is not europa]

[giving the shrimp tea sandwich to the black cat - failed the Check saying hello to someone when the noun is not beck and the noun is not europa]

* * *

>throw shrimp at car
There's nothing like that nearby.

>throw shrimp at cat
Sensing food, the black cat pokes its head out, grabs the shrimp in its jaws, and races off. Jones takes the screwdriver.

 _________      __                     _____                     
 __/ ____/___ _/ /___ __  ____  __     __/ /___  ____  ___  _____
 _/ / __/ __ `/ / __ `/ |/ / / / /____ _/ / __ \/ __ \/ _ \/ ___/
 / /_/ / /_/ / / /_/ />  </ /_/ / _/ /_/ / /_/ / / / /  __(__  ) 
 \____/\__,_/_/\__,_/_/|_|\__, /  _\____/\____/_/ /_/\___/____/  
 _____________________________/ 

[Your score has just gone up by one point.]

Jones: "Aha! No creature is too fearsome for Galaxy Jones!"

Beck: "Congratulations on your victory."

>undo
Galaxy Jones is at the south end of the building management office.
[Previous turn undone.]

* * *

>trace 5
[Parser tracing set to level 5.]

>show shrimp to cat
[ "show" ? / "shrimp" shrimp / "to" to / "cat" cat ]
   [NounDomain called at word 1
   seeking definite object
    Trying the north (1079190) at word 1
Parse_name called
Pass 1: 0 Pass 2: 0 Pass 3: 0
    Trying the northeast (1079222) at word 1
Parse_name called
Pass 1: 0 Pass 2: 0 Pass 3: 0
    Trying the northwest (1079254) at word 1
Parse_name called
Pass 1: 0 Pass 2: 0 Pass 3: 0
    Trying the south (1079286) at word 1
Parse_name called
Pass 1: 0 Pass 2: 0 Pass 3: 0
    Trying the southeast (1079318) at word 1
Parse_name called
Pass 1: 0 Pass 2: 0 Pass 3: 0
    Trying the southwest (1079350) at word 1
Parse_name called
Pass 1: 0 Pass 2: 0 Pass 3: 0
    Trying the east (1079382) at word 1
Parse_name called
Pass 1: 0 Pass 2: 0 Pass 3: 0
    Trying the west (1079414) at word 1
Parse_name called
Pass 1: 0 Pass 2: 0 Pass 3: 0
    Trying the up (1079446) at word 1
Parse_name called
Pass 1: 0 Pass 2: 0 Pass 3: 0
    Trying the down (1079478) at word 1
Parse_name called
Pass 1: 0 Pass 2: 0 Pass 3: 0
    Trying the inside (1079510) at word 1
Parse_name called
Pass 1: 0 Pass 2: 0 Pass 3: 0
    Trying the outside (1079542) at word 1
Parse_name called
Pass 1: 0 Pass 2: 0 Pass 3: 0
    Trying Beck (1079926) at word 1
   [ND made 0 matches]
[Parsing for the verb 'no.verb' (1 lines)]

[line 0 * Routine(370012) Routine(370066) -> A81_typing_it_on]
 [line 0 token 1 word 1 : Routine(370012)]
  [Outside parsing routine returned -1]
  [token resulted in failure with error type 1]
I didn't understand that sentence.

>i
[ "i" i ]
[Parsing for the verb 'i' (1 lines)]

[line 0 * -> Inv]
 [line 0 token 1 word 2 : END]
[Line successfully parsed]
Jones is carrying:
  a shrimp tea sandwich
  a disruptor pistol

>trace off
[ "trace" trace / "off" off ]
[Parsing for the verb 'trace' (4 lines)]

[line 0 * -> TraceOn]
 [line 0 token 1 word 2 : END]

[line 1 * number -> TraceLevel]
 [line 1 token 1 word 2 : number]
  [token resulted in failure with error type 3]

[line 2 * 'on' -> TraceOn]
[line rejected for not ending with correct preposition]

[line 3 * 'off' -> TraceOff]
 [line 3 token 1 word 2 : 'off']
  [token resulted in success]
 [line 3 token 2 word 3 : END]
[Line successfully parsed]
Trace off.

>l
Galaxy Jones is at the south end of the building management office. The building management office is a bunch of desks and task boards. There is a filing cabinet against the east wall. The office exit is to the east, and the office continues to the north.

>x cabinety
There's nothing like that nearby.

>x cabinet
An ordinary filing cabinet, with five drawers. The label on the front says "Personnel Records".

>look behind cabinet
(taking the screwdriver)
Forget it. Jones isn't getting another scratch.

>give shrimp to cat
No way. That thing is mean.

* * *

>undo
Galaxy Jones is at the south end of the building management office.
[Previous turn undone.]

>drop shrimp
Sensing food, the black cat pokes its head out, grabs the shrimp in its jaws, and races off. Jones takes the screwdriver.

 _________      __                     _____                     
 __/ ____/___ _/ /___ __  ____  __     __/ /___  ____  ___  _____
 _/ / __/ __ `/ / __ `/ |/ / / / /____ _/ / __ \/ __ \/ _ \/ ___/
 / /_/ / /_/ / / /_/ />  </ /_/ / _/ /_/ / /_/ / / / /  __(__  ) 
 \____/\__,_/_/\__,_/_/|_|\__, /  _\____/\____/_/ /_/\___/____/  
 _____________________________/ 

[Your score has just gone up by one point.]

Jones: "Aha! No creature is too fearsome for Galaxy Jones!"

Beck: "Congratulations on your victory."

>undo
Galaxy Jones is at the south end of the building management office.
[Previous turn undone.]

>show pistol to me
I didn't understand that sentence.

>show
I didn't understand that sentence.

>trace 5
[Parser tracing set to level 5.]

>sasdf
[ "sasdf" ? ]
   [NounDomain called at word 1
   seeking definite object
    Trying the north (1078934) at word 1
Parse_name called
Pass 1: 0 Pass 2: 0 Pass 3: 0
    Trying the northeast (1078966) at word 1
Parse_name called
Pass 1: 0 Pass 2: 0 Pass 3: 0
    Trying the northwest (1078998) at word 1
Parse_name called
Pass 1: 0 Pass 2: 0 Pass 3: 0
    Trying the south (1079030) at word 1
Parse_name called
Pass 1: 0 Pass 2: 0 Pass 3: 0
    Trying the southeast (1079062) at word 1
Parse_name called
Pass 1: 0 Pass 2: 0 Pass 3: 0
    Trying the southwest (1079094) at word 1
Parse_name called
Pass 1: 0 Pass 2: 0 Pass 3: 0
    Trying the east (1079126) at word 1
Parse_name called
Pass 1: 0 Pass 2: 0 Pass 3: 0
    Trying the west (1079158) at word 1
Parse_name called
Pass 1: 0 Pass 2: 0 Pass 3: 0
    Trying the up (1079190) at word 1
Parse_name called
Pass 1: 0 Pass 2: 0 Pass 3: 0
    Trying the down (1079222) at word 1
Parse_name called
Pass 1: 0 Pass 2: 0 Pass 3: 0
    Trying the inside (1079254) at word 1
Parse_name called
Pass 1: 0 Pass 2: 0 Pass 3: 0
    Trying the outside (1079286) at word 1
Parse_name called
Pass 1: 0 Pass 2: 0 Pass 3: 0
    Trying Beck (1079670) at word 1
   [ND made 0 matches]
[Parsing for the verb 'no.verb' (1 lines)]

[line 0 * Routine(369822) Routine(369876) -> A81_typing_it_on]
 [line 0 token 1 word 1 : Routine(369822)]
  [Outside parsing routine returned -1]
  [token resulted in failure with error type 1]
I didn't understand that sentence.

>trace off
[ "trace" trace / "off" off ]
[Parsing for the verb 'trace' (4 lines)]

[line 0 * -> TraceOn]
 [line 0 token 1 word 2 : END]

[line 1 * number -> TraceLevel]
 [line 1 token 1 word 2 : number]
  [token resulted in failure with error type 3]

[line 2 * 'on' -> TraceOn]
[line rejected for not ending with correct preposition]

[line 3 * 'off' -> TraceOff]
 [line 3 token 1 word 2 : 'off']
  [token resulted in success]
 [line 3 token 2 word 3 : END]
[Line successfully parsed]
Trace off.

* * *

>unlock filing cabinet with cat
There's nothing like that nearby.

>undo
Galaxy Jones is at the south end of the building management office.
[Previous turn undone.]

>undo
Galaxy Jones is at the south end of the building management office.
[Previous turn undone.]

>unlock filing cabinet with cat
(first taking the black cat)
No way. That thing is mean.

>give pistol to beck
Beck is just a voice in Jones's ear.

* * *

>gonear ninth north
Galaxy Jones is in the ninth floor north hallway. This anonymous corporate hallway ends here at the north end of the building. An open doorway leads west. To the east is a door with a swipe lock, labeled "Cybernetica Inc."

>unlock door with pistol
Jones is unable to unlock the Cybernetica door with the disruptor pistol.

>hit lock
Jones only uses violent means when absolutely necessary.

>t lock
Don't worry, Galaxy Jones will tell Beck what he needs to know.

>a lock
Beck: "Oh, they make the best games!"

* * *

>catering
Galaxy Jones is on the east side of the ground floor. Apparently some kind of function was happening here before Admiral Thallium emptied the building, for there is an array of canapes on a catering table here. The floor stretches north and south, and there's a closet door to the west.

Beck: "Blueprints indicate a closet to the west of you. Might be useful."

>0
An indicator light glows green.

Jones: "I've unlocked the east side utility door."

>1
An indicator light blinks red.

>x door
A typical white metal utility door. Next to it is a keypad with the digits 0-9. An indicator light glows green.

* * *

>gonear uniforms
Galaxy Jones is at the northeast corner of the ground floor. The area is dedicated to celebrating the military career of Admiral Thallium. Uniforms, medals, ribbons, and other miscellanea are mounted on the wall or in showcases. All this despite the fact that no one has turned up any evidence that Thallium served in any navy of any country on any planet. One can escape to the west or south.

Jones: "Now this is some choice bullshit here."

Beck: "Looks like the record of the good Admiral's long and dedicated service."

>take uniforms
The medals, ribbons, and all are behind glass.

>x medals
Jones yawns looking over the assortment of faux honors. They're all behind glass, but one of the display cases is partly open, leaving the rather garish medal inside unprotected.

* * *

>hit speeder
Jones only uses violent means when absolutely necessary.

>gonear bed
Galaxy Jones is in the northern corner of the penthouse. This is Thallium's bedroom. Apart from the expansive round bed in the center of the room, notable features include the line of dummies displaying his various suits of clothes, a large vanity table, and the complete lack of mirrors on the ceiling, thankfully. One may leave the room to the southwest, south, and southeast.

>sleep
Jones isn't feeling especially drowsy.

* * *

>hook me to speeder
Jones would achieve nothing by this.

>n
Jones approaches the Viking Building entryway, the dramatic façade towering over her.

Galaxy Jones is at the entry doorway. A glass revolving door leads into a large open space north of here. The speeder dock is to the south.

Jones peers upwards at the 100 stories of glass and steel. "What do you want to bet Thallium's got Europa all the way at the top?"

Beck: "Oh, no doubt."

* * *

>n
Galaxy Jones is in the ground floor elevator hall. This hallway between the north and south ends of the ground floor is home to the elevator to the west. To the east is the entrance to a stairwell.

Admiral Thallium's voice booms from the ceiling. "Little Galaxy thinks she's beaten the big bad Admiral. Sorry dear, that was only a taste."

>a stairs
Which do you mean, the stairwell or the stairwell?

>showme stairs
Which do you mean, the stairwell, the stairwell, the stairwell, or the roof stairs?

>stairwell
Which do you mean, the stairwell, the stairwell, or the stairwell?

>x stairs
Which do you mean, the stairwell or the stairwell?

>all
Sorry, you can only have one item here. Which exactly?

>n
I only understood you as far as wanting to examine north.

* * *

>look north
Jones sees the entry doorway in that direction.

>look south
Jones sees nothing in that direction.

>n
Jones approaches the Viking Building entryway, the dramatic façade towering over her.

Galaxy Jones is at the entry doorway. A glass revolving door leads into a large open space north of here. The speeder dock is to the south.

Jones peers upwards at the 100 stories of glass and steel. "What do you want to bet Thallium's got Europa all the way at the top?"

Beck: "Oh, no doubt."

>look north
Jones sees the lobby in that direction.

>n
Jones takes a deep breath. "I'm going in."

Beck replies, "You got this, Galaxy."

Jones passes through the revolving door and into the lobby, alert to any defenses.

Galaxy Jones is in the lobby. The ground floor of the Viking Building is breathtaking. Low-G architecture means more glass and thinner supports, and the building takes advantage of that. Four walls of glass surround a central pillar in which are set the utility rooms and elevators. In between is an expanse of plants, water features, and stylish seating. Near the entryway is a front desk. A giant crystal sculpture floats above the center of the area, suspended on almost invisible cables. She may go east and west from here, north to the elevators, or south out of the building.

Suddenly two robot guards, green and red, emerge from niches in the back wall! She dives behind the front desk and draws her disruptor pistol.

Jones shouts, "I'm under fire from two ugly robot things!"

Beck responds, "Monitoring your suit radar."

>e
Trying to reach an exit would surely get Jones shot.

Jones: "I'm pinned down here!"

* * *

>look east
Jones sees the southeast corner of the ground floor in that direction.

>e
Jones crosses the floor carefully, disruptor pistol at the ready.

Galaxy Jones is at the southeast corner of the ground floor. The centerpiece of this area is the actual Viking 2 lander, which landed right here on Utopia Planitia. The glass walls look out onto the city. She can go north or west from here.

Admiral Thallium's voice booms from the ceiling. "Little Galaxy thinks she's beaten the big bad Admiral. Sorry dear, that was only a taste."

* * *

>n
Galaxy Jones is on the east side of the ground floor. Apparently some kind of function was happening here before Admiral Thallium emptied the building, for there is an array of canapes on a catering table here. The floor stretches north and south, and there's a closet door to the west.

Beck: "Blueprints indicate a closet to the west of you. Might be useful."

>look west
Jones sees the closet door in that direction.

>look n
Jones sees the northeast corner of the ground floor in that direction.

>n
Galaxy Jones is at the northeast corner of the ground floor. The area is dedicated to celebrating the military career of Admiral Thallium. Uniforms, medals, ribbons, and other miscellanea are mounted on the wall or in showcases. All this despite the fact that no one has turned up any evidence that Thallium served in any navy of any country on any planet. One can escape to the west or south.

Jones: "Now this is some choice bullshit here."

Beck: "Looks like the record of the good Admiral's long and dedicated service."

>w
Galaxy Jones is on the north side of the ground floor. The area is dominated by a towering statue of Admiral Thallium against the north wall. The ground floor extends west and east from here. The elevator is to the south.

* * *

>s
Galaxy Jones is in the ground floor elevator hall. This hallway between the north and south ends of the ground floor is home to the elevator to the west. To the east is the entrance to a stairwell.

>look e
Jones sees the ground floor stairwell in that direction.

>look w
Jones sees the elevator door in that direction.

>gonear ninth hall
Galaxy Jones is in the ninth floor elevator hall. The elevator is to the west, the stairwell is to the east, and a corridor leads north and south. There is a bottled water vending machine here.

>look w
Jones sees the ninth floor elevator door in that direction.

>look down
Jones sees nothing in that direction.

>gonear ground hall
Galaxy Jones is in the ground floor elevator hall. This hallway between the north and south ends of the ground floor is home to the elevator to the west. To the east is the entrance to a stairwell.

>look d
Jones sees nothing in that direction.

* * *

>n
Jones approaches the Viking Building entryway, the dramatic façade towering over her.

Galaxy Jones is at the entry doorway. A glass revolving door leads into a large open space north of here. The speeder dock is to the south.

Jones peers upwards at the 100 stories of glass and steel. "What do you want to bet Thallium's got Europa all the way at the top?"

Beck: "Oh, no doubt."

>exits on
Exit listing is now on.

* * *

>n
Jones approaches the Viking Building entryway, the dramatic façade towering over her.

Galaxy Jones is at the entry doorway. A glass revolving door leads into a large open space north of here. The speeder dock is to the south.

Jones peers upwards at the 100 stories of glass and steel. "What do you want to bet Thallium's got Europa all the way at the top?"

Beck: "Oh, no doubt."

>gonear waterfall
Galaxy Jones is at the southwest corner of the ground floor. A lush waterfall here contrasts with the dusty red streets of New Reykjavik beyond the glass walls. The ground floor extends north and east.

>n
Galaxy Jones is on the west side of the ground floor. Semicircular couches open on either side of a central carpeted path leading north and south. Set in the central pillar of the building to the east is a utility door. The city looms beyond the glass wall to the west.

* * *

>purloin red cardkey
[Purloined.]

>e
(first opening the utility door)
(first unlocking the utility door)
(with the red cardkey)

Galaxy Jones is in the elevator room. This is a utility room related to the operation of the elevator, on the other side of the east wall here. There is a control panel on the wall, and a door leading west.

Hanging from a hook here is an elevator drop key.

Lying discarded on a table here is a hammer.

>w
Galaxy Jones is on the west side of the ground floor. Semicircular couches open on either side of a central carpeted path leading north and south. Set in the central pillar of the building to the east is a utility door. The city looms beyond the glass wall to the west.

* * *

>n
Jones approaches the Viking Building entryway, the dramatic façade towering over her.

Galaxy Jones is at the entry doorway. A glass revolving door leads into a large open space north of here. The speeder dock is to the south.

Jones peers upwards at the 100 stories of glass and steel. "What do you want to bet Thallium's got Europa all the way at the top?"

Beck: "Oh, no doubt."

>look d
There's nothing in that direction.

* * *

>look u
There's nothing in that direction.

>n
Jones takes a deep breath. "I'm going in."

Beck replies, "You got this, Galaxy."

Jones passes through the revolving door and into the lobby, alert to any defenses.

Galaxy Jones is in the lobby. The ground floor of the Viking Building is breathtaking. Low-G architecture means more glass and thinner supports, and the building takes advantage of that. Four walls of glass surround a central pillar in which are set the utility rooms and elevators. In between is an expanse of plants, water features, and stylish seating. Near the entryway is a front desk. A giant crystal sculpture floats above the center of the area, suspended on almost invisible cables. She may go east and west from here, north to the elevators, or south out of the building.

Suddenly two robot guards, green and red, emerge from niches in the back wall! She dives behind the front desk and draws her disruptor pistol.

Jones shouts, "I'm under fire from two ugly robot things!"

Beck responds, "Monitoring your suit radar."

>look d
Yards and yards of white and grey marble, rare for Mars.

Beck: "Robot on your right!"

One robot tries to flank Jones, but a shot from her disruptor sends it scurrying back.

>look u
The whole ground floor is bright and airy, its ceiling covered with reflective pyramids. Supporting struts criss-cross the area, from which sparkling crystal chandeliers are suspended.

>look out
(outside)
Outside the building are the red-dusted streets of New Reykjavik.

Zip! Disruptor fire scorches a nearby couch.

Beck: "How's it going in there?"

"Jones: "You know -- like all art, it's hit or miss."

>look in
What exactly should Jones look into?

A robot fires a blistering shot into the front desk.

>desk
I didn't understand that sentence.

>look in desk
As soon as Jones starts to act, an energy beam zips past her head, forcing her back down behind the desk.

One of the robots fires directly above her head.

Jones: "I could use some ideas here!"

* * *

>n
Jones approaches the Viking Building entryway, the dramatic façade towering over her.

Galaxy Jones is at the entry doorway. A glass revolving door leads into a large open space north of here. The speeder dock is to the south.

Jones peers upwards at the 100 stories of glass and steel. "What do you want to bet Thallium's got Europa all the way at the top?"

Beck: "Oh, no doubt."

>look u
Jones sees nothing unexpected in that direction.

>n
Jones takes a deep breath. "I'm going in."

Beck replies, "You got this, Galaxy."

Jones passes through the revolving door and into the lobby, alert to any defenses.

Galaxy Jones is in the lobby. The ground floor of the Viking Building is breathtaking. Low-G architecture means more glass and thinner supports, and the building takes advantage of that. Four walls of glass surround a central pillar in which are set the utility rooms and elevators. In between is an expanse of plants, water features, and stylish seating. Near the entryway is a front desk. A giant crystal sculpture floats above the center of the area, suspended on almost invisible cables. She may go east and west from here, north to the elevators, or south out of the building.

Suddenly two robot guards, green and red, emerge from niches in the back wall! She dives behind the front desk and draws her disruptor pistol.

Jones shouts, "I'm under fire from two ugly robot things!"

Beck responds, "Monitoring your suit radar."

>look up
Jones sees nothing unexpected in that direction.

>x ceiling
The whole ground floor is bright and airy, its ceiling covered with reflective pyramids. Supporting struts criss-cross the area, from which sparkling crystal chandeliers are suspended.

One of the robots fires directly above Jones's head.

* * *

>e
Jones crosses the floor carefully, disruptor pistol at the ready.

Galaxy Jones is at the southeast corner of the ground floor. The centerpiece of this area is the actual Viking 2 lander, which landed right here on Utopia Planitia. The glass walls look out onto the city. She can go north or west from here.

Admiral Thallium's voice booms from the ceiling. "Little Galaxy thinks she's beaten the big bad Admiral. Sorry dear, that was only a taste."

>w
Galaxy Jones is in the lobby. The ground floor of the Viking Building is breathtaking. Low-G architecture means more glass and thinner supports, and the building takes advantage of that. Four walls of glass surround a central pillar in which are set the utility rooms and elevators. In between is an expanse of plants, water features, and stylish seating. Near the entryway is a front desk. Jones may go east and west from here, north to the elevators, or south out of the building. There are two niches in the central wall from which the guard robots emerged.

Spread across the floor in a tangled ruin are the remains of a giant crystal sculpture and two guard robots.

>read note
There's nothing like that nearby.

>x desk
There's not much on the desk other than a note that says "94556".

>e
Galaxy Jones is at the southeast corner of the ground floor. The centerpiece of this area is the actual Viking 2 lander, which landed right here on Utopia Planitia. The glass walls look out onto the city. Jones can go north or west from here.

>n
Galaxy Jones is on the east side of the ground floor. Apparently some kind of function was happening here before Admiral Thallium emptied the building, for there is an array of canapes on a catering table here. The floor stretches north and south, and there's a closet door to the west.

Beck: "Blueprints indicate a closet to the west of you. Might be useful."

>94556
An indicator light glows green.

Jones: "I've unlocked the east side utility door."

>2456
An indicator light blinks red.

>x door
A typical white metal utility door. Next to it is a keypad with the digits 0-9. An indicator light glows green.

* * *

>x desk
There's not much on the desk other than a note that says "37914".

>e
Jones crosses the floor carefully, disruptor pistol at the ready.

Galaxy Jones is at the southeast corner of the ground floor. The centerpiece of this area is the actual Viking 2 lander, which landed right here on Utopia Planitia. The glass walls look out onto the city. She can go north or west from here.

Admiral Thallium's voice booms from the ceiling. "Little Galaxy thinks she's beaten the big bad Admiral. Sorry dear, that was only a taste."

* * *

>n
Galaxy Jones is on the east side of the ground floor. Apparently some kind of function was happening here before Admiral Thallium emptied the building, for there is an array of canapes on a catering table here. The floor stretches north and south, and there's a closet door to the west.

Beck: "Blueprints indicate a closet to the west of you. Might be useful."

>type 37914
(on the keypad)
An indicator light glows green.

Jones: "I've unlocked the east side utility door."

>w
(first opening the closet door)

Galaxy Jones is in the maintenance closet. A bare, white-walled room containing various maintenance items.

There is an Atmo-Suit hanging from a hook here.

On the shelf is a red cardkey.

* * *

>read note
There's nothing like that nearby.

>x desk
There's not much on the desk other than a note that says "0".

>e
Jones crosses the floor carefully, disruptor pistol at the ready.

Galaxy Jones is at the southeast corner of the ground floor. The centerpiece of this area is the actual Viking 2 lander, which landed right here on Utopia Planitia. The glass walls look out onto the city. She can go north or west from here.

Admiral Thallium's voice booms from the ceiling. "Little Galaxy thinks she's beaten the big bad Admiral. Sorry dear, that was only a taste."

* * *

>n
Galaxy Jones is on the east side of the ground floor. Apparently some kind of function was happening here before Admiral Thallium emptied the building, for there is an array of canapes on a catering table here. The floor stretches north and south, and there's a closet door to the west.

Beck: "Blueprints indicate a closet to the west of you. Might be useful."

>0
An indicator light glows green.

Jones: "I've unlocked the east side utility door."

>w
(first opening the closet door)

Galaxy Jones is in the maintenance closet. A bare, white-walled room containing various maintenance items.

There is an Atmo-Suit hanging from a hook here.

On the shelf is a red cardkey.

* * *

>x pillar
The central area where the elevators and utility rooms are.

>l
Galaxy Jones is in the lobby. The ground floor of the Viking Building is breathtaking. Low-G architecture means more glass and thinner supports, and the building takes advantage of that. Four walls of glass surround a central pillar in which are set the utility rooms and elevators. In between is an expanse of plants, water features, and stylish seating. Near the entryway is a front desk. Jones may go east and west from here, north to the elevators, or south out of the building. There are two niches in the central wall from which the guard robots emerged.

Spread across the floor in a tangled ruin are the remains of a giant crystal sculpture and two guard robots.

>x rooms
You can't use multiple objects with that verb.

>x room
The utility rooms are somewhere around the central pillar.

>x utility room
The utility rooms are somewhere around the central pillar.

>sw
Jones can go south out of the building or north to the elevator. The ground floor continues east and west.

>w
Jones crosses the floor carefully, disruptor pistol at the ready.

Galaxy Jones is at the southwest corner of the ground floor. A lush waterfall here contrasts with the dusty red streets of New Reykjavik beyond the glass walls. The ground floor extends north and east.

Admiral Thallium's voice booms from the ceiling. "Little Galaxy thinks she's beaten the big bad Admiral. Sorry dear, that was only a taste."

>x pillar
The central area where the elevators and utility rooms are.

>x elevators
They're in the center of the building.

>n
Galaxy Jones is on the west side of the ground floor. Semicircular couches open on either side of a central carpeted path leading north and south. Set in the central pillar of the building to the east is a utility door. The city looms beyond the glass wall to the west.

* * *

>e
(first opening the utility door)
(first unlocking the utility door)
Jones lacks a key that fits the utility door.

>x pillar
The central area where the elevators and utility rooms are.

>x rooms
The utility rooms are somewhere around the central pillar.

>x glass wall
Outside the building are the red-dusted streets of New Reykjavik.

>x chandeliers
A baroque conglomeration of gold, silver, and crystal.

>x struts
Thin but incredibly strong.

>x supports
Thin but incredibly strong.

>x pyramids
Angled reflective surfaces on the ceiling meant to disperse light.

>take elevators
I mean, Jones can take the elevator, but not in the way you mean.

>take pyramids
Jones can't take that.

>move it
Jones can't move that.

>move elevators
Usually one moves an elevator by pressing a button.

>drink
(Jones)
There's nothing suitable to drink here.

>drink water
There's nothing like that nearby.

>s
Galaxy Jones is at the southwest corner of the ground floor. A lush waterfall here contrasts with the dusty red streets of New Reykjavik beyond the glass walls. The ground floor extends north and east.

>drubj
That's not a verb I recognise.

>drink
(the waterfall)
Jones decides the water probably isn't clean enough to drink.

>drink water
Jones decides the water probably isn't clean enough to drink.

>put gun in water
The waterfall is closed.

>x waterfall
The waterfall descends the length of an artificial rock formation fringed by wide-leaved Earth plants and ferns. The water collects in a basin at the bottom, where it begins its journey again. A single coin sits on the bottom of the basin.

Jones: "One coin? Not very generous people around here."

>put gun in water
Jones puts the disruptor pistol into the waterfall.

>take coin
Taken.

>take all
disruptor pistol: Taken.

>x waterfall
The waterfall descends the length of an artificial rock formation fringed by wide-leaved Earth plants and ferns. The water collects in a basin at the bottom, where it begins its journey again.

>look in waterfall
The waterfall descends the length of an artificial rock formation fringed by wide-leaved Earth plants and ferns. The water collects in a basin at the bottom, where it begins its journey again.

>search it
The waterfall descends the length of an artificial rock formation fringed by wide-leaved Earth plants and ferns. The water collects in a basin at the bottom, where it begins its journey again.

>put gun in waterfall
Jones puts the disruptor pistol into the waterfall.

>search it
Jones finds nothing of interest.

>look in waterfall
The waterfall descends the length of an artificial rock formation fringed by wide-leaved Earth plants and ferns. The water collects in a basin at the bottom, where it begins its journey again. A single coin sits on the bottom of the basin.

>take coin
Jones already has that.

* * *

>drink water
Jones decides the water probably isn't clean enough to drink.

>take all
I'm not sure what you're referring to.

>x water
The waterfall descends the length of an artificial rock formation fringed by wide-leaved Earth plants and ferns. The water collects in a basin at the bottom, where it begins its journey again. A single coin sits on the bottom of the basin.

Jones: "One coin? Not very generous people around here."

* * *

>take coin
Taken.

>undo
Galaxy Jones is at the southwest corner of the ground floor.
[Previous turn undone.]

>take all
I'm not sure what you're referring to.

>take coin
Taken.

* * *

>purloin elevator drop key
Which do you mean, the elevator drop key or the drop key hole?

>n
I only understood you as far as wanting to purloin north.

>n
Jones approaches the Viking Building entryway, the dramatic façade towering over her.

Galaxy Jones is at the entry doorway. A glass revolving door leads into a large open space north of here. The speeder dock is to the south.

Jones peers upwards at the 100 stories of glass and steel. "What do you want to bet Thallium's got Europa all the way at the top?"

Beck: "Oh, no doubt."

* * *

>e
(first opening the utility door)
(first unlocking the utility door)
(with the red cardkey)

Galaxy Jones is in the elevator room. This is a utility room related to the operation of the elevator, on the other side of the east wall here. There is a control panel on the wall, and a door leading west.

Hanging from a hook here is an elevator drop key.

Lying discarded on a table here is a hammer.

>take key
(the elevator drop key)
Taken.

>a key
Which do you mean, the elevator drop key or the red cardkey?

>drop key
Which do you mean, the elevator drop key or the red cardkey?

>a drop key
Beck: "I'm not sure what that is."

>x it
A drop key is a special device used to open an elevator door from the outside. It consists of a thin shaft which is hinged at th-- oh just Google it.

>a drop key
Beck: "Huh. You learn something every day."

* * *

>show building to beck
(first taking the building entryway)
Not gonna happen.

* * *

>show pistol to beck
Beck: "Uh, you know what that's for, right?"

>show speeder to beck
(first taking the speeder)
Stop being silly.

>drop pistol
That would be ill-advised.

>actions
Actions listing on.

>show speeder to beck
[showing the speeder to Beck]
(first taking the speeder)
[(1) taking the speeder - silently]
Stop being silly.
[(1) taking the speeder - silently - failed the Check taking the speeder-vehicle]

[showing the speeder to Beck - failed the carrying requirements rule]

* * *

>show speeder to beck
(first taking the speeder)
Stop being silly.