Would you like to play with accessibility on? (recommended for mobile)

>n
 _________      __                     _____                     
 __/ ____/___ _/ /___ __  ____  __     __/ /___  ____  ___  _____
 _/ / __/ __ `/ / __ `/ |/ / / / /____ _/ / __ \/ __ \/ _ \/ ___/
 / /_/ / /_/ / / /_/ />  </ /_/ / _/ /_/ / /_/ / / / /  __(__  ) 
 \____/\__,_/_/\__,_/_/|_|\__, /  _\____/\____/_/ /_/\___/____/  
 _____________________________/ 

An Interactive Adventure by Phil Riley
Release 3 / Serial number 230322 / Inform 7 build 6M62 (I6/v6.34 lib 6/12N) SD

A sleek dark red speeder roars into the dock of the Viking Building. A tall woman in a battle-ready jumpsuit climbs out of it: Galaxy Jones.

Galaxy Jones is in the speeder dock. A safe harbor from the periodic dust storms of Utopia Planitia, the dock features several dozen speeder bays. Only a few are filled right now. The building entryway is to the north, under a red stone façade carved into the likeness of a fearsome Viking.

Jones's speeder, Galaxy One, sits in one of the parking bays.

Jones's handler Beck comes over her headset. "Alright, what's going on?"

She replies, "I'm in the speeder dock. No movement. What can I expect inside?"

"Blueprints show the ground floor is one big empty space with elevators in the center. Not a lot of places for resistance to hide, but you can never tell. Be careful.

"And one other thing, Jones: if you need help you can ASK BECK FOR HELP. You can also ASK BECK ABOUT things or ASK BECK ABOUT GAME for more information about the game. Finally, you can cause help to repeat from the beginning by saying ASK BECK TO RESET HELP"

* * *

Would you like to play with accessibility on? (recommended for mobile)

>frotz me
Jones is bathed in a sickly yellow light, bright enough to read by.

* * *

Would you like to play with accessibility on? (recommended for mobile)

>a dock
Beck: "It's almost empty. Guess everyone went home when Thallium went ape."

>ask about dock
Beck: "It's almost empty. Guess everyone went home when Thallium went ape."

>a speeder
Beck: "I keep reminding you, but you still haven't taken it in for yearly maintenance."

>n
Jones approaches the Viking Building entryway, the dramatic façade towering over her.

Galaxy Jones is at the entry doorway. A glass revolving door leads into a large open space north of here. The speeder dock is to the south.

Jones looks up at the 100 stories of glass and steel. "What do you want to bet Thallium's got Europa all the way at the top?"

Beck: "Oh, no doubt."

* * *

>ask about dock
Beck: "It's almost empty. Guess everyone went home when Thallium went ape."

>ask about speeder
Beck: "I keep reminding you, but you still haven't taken it in for yearly maintenance."

* * *

Would you like to play with accessibility on? (recommended for mobile)

>ask about bays
Jones: "Beck, how about the parking bays?"

Beck: "Hmm. Don't have much to say about that right now."

* * *

Would you like to play with accessibility on? (recommended for mobile)

>ask about dock
Beck: "It's almost empty. Guess everyone went home when Thallium went ape."

>ask about bays
Jones: "Beck, how about the parking bays?"

Beck: "Hmm. Don't have much to say about that right now."

* * *

>ask about dock
Beck: "It's almost empty. Guess everyone went home when Thallium went ape."

>ask about speeder
Jones: "Beck, how about the speeder?"

Beck: "I keep reminding you, but you still haven't taken it in for yearly maintenance."

>ask about dock
Beck: "Guess everyone went home when Thallium went ape."

>actions
Actions listing on.

>ask about dock
[implicit-quizzing the speeder dock]
[(1) quizzing Beck about the speeder dock]

Beck: "Guess everyone went home when Thallium went ape."
[(1) quizzing Beck about the speeder dock - failed]

[implicit-quizzing the speeder dock - failed]

>ask about speeder
[implicit-quizzing the speeder]
[(1) quizzing Beck about the speeder]

Jones: "Beck, what do you think about the speeder?"

Beck: "I keep reminding you, but you still haven't taken it in for yearly maintenance."
[(1) quizzing Beck about the speeder - failed]

[implicit-quizzing the speeder - failed]

* * *

>ask about dock
Beck: "It's almost empty. Guess everyone went home when Thallium went ape."

>n
Jones approaches the Viking Building entryway, the dramatic façade towering over her.

Galaxy Jones is at the entry doorway. A glass revolving door leads into a large open space north of here. The speeder dock is to the south.

Jones looks up at the 100 stories of glass and steel. "What do you want to bet Thallium's got Europa all the way at the top?"

Beck: "Oh, no doubt."

>ask about dock
Beck: "It's almost empty. Guess everyone went home when Thallium went ape."

>ask about doorwaay
Beck: "I'm not sure what you're asking about, Jones."

* * *

>actions
Actions listing on.

>ask about doorway
[implicit-quizzing the entry doorway]
[(1) quizzing Beck about the entry doorway]
[(1) quizzing Beck about the entry doorway - succeeded]

[implicit-quizzing the entry doorway - failed]

* * *

Would you like to play with accessibility on? (recommended for mobile)

>ask about me
Jones: "How's my status?"

Beck: "All systems look good."

>ask about beck
Jones: "How're you doing, Beck?"

Beck: "I'm just happy to serve."

>n
Jones approaches the Viking Building entryway, the dramatic façade towering over her.

Galaxy Jones is at the entry doorway. A glass revolving door leads into a large open space north of here. The speeder dock is to the south.

Jones peers upwards at the 100 stories of glass and steel. "What do you want to bet Thallium's got Europa all the way at the top?"

Beck: "Oh, no doubt."

>look up
There's nothing in that direction.

>n
Jones takes a deep breath. "I'm going in."

Beck replies, "You got this, Galaxy."

Jones passes through the revolving door and into the lobby, alert to any defenses.

Galaxy Jones is in the lobby. The ground floor of the Viking Building is breathtaking. Low-G architecture means more glass and thinner supports, and the building takes advantage of that. Four walls of glass surround a central pillar in which are set the utility rooms and elevators. In between is an expanse of plants, water features, and stylish seating. Near the entryway is a front desk. A giant crystal sculpture floats above the center of the area, suspended on almost invisible cables. She may go east and west from here, north to the elevators, or south out of the building.

>shoot art
Suddenly two robot guards, green and red, emerge from niches in the back wall! Jones dives behind the front desk and draws her disruptor pistol.

Jones shouts, "I'm under fire from two ugly robot things!"

Beck responds, "Monitoring your suit radar."

>shoot art
Jones fires the disruptor into the sculpture's main support cable, snapping it. The huge crystal blob starts to sag, straining the other cables. In quick succession they break as well, and the whole installation plummets to the ground, right on top of the hapless guard robots.
 _________      __                     _____                     
 __/ ____/___ _/ /___ __  ____  __     __/ /___  ____  ___  _____
 _/ / __/ __ `/ / __ `/ |/ / / / /____ _/ / __ \/ __ \/ _ \/ ___/
 / /_/ / /_/ / / /_/ />  </ /_/ / _/ /_/ / /_/ / / / /  __(__  ) 
 \____/\__,_/_/\__,_/_/|_|\__, /  _\____/\____/_/ /_/\___/____/  
 _____________________________/ 

[Your score has just gone up by one point.]

Beck: "What was that crash? What's going on?"

Jones: "That, my friend, was what you'd call a work of art. Targets terminated."

>look up
The whole ground floor is bright and airy, its ceiling covered with reflective pyramids. Supporting struts criss-cross the area, from which sparkling crystal chandeliers are suspended.

>look down
Yards and yards of white and grey marble, rare for Mars.

* * *

Would you like to play with accessibility on? (recommended for mobile)

>ask about speeder
Beck: "I keep reminding you, but you still haven't taken it in for yearly maintenance."

>ask about speeder
Jones: "Beck, tell me about the speeder."

Beck: "I keep reminding you, but you still haven't taken it in for yearly maintenance."

>ask about speeder
Jones: "Beck, what do you think about the speeder?"

Beck: "I keep reminding you, but you still haven't taken it in for yearly maintenance."

>ask about speeder
Jones: "Beck, how about the speeder?"

Beck: "I keep reminding you, but you still haven't taken it in for yearly maintenance."

>ask about speeder
Jones: "Beck, what do you think about the speeder?"

Beck: "I keep reminding you, but you still haven't taken it in for yearly maintenance."

* * *

>ask about speeder
Beck: "I keep reminding you, but you still haven't taken it in for yearly maintenance."

>ask beck about speeder
Beck: "I keep reminding you, but you still haven't taken it in for yearly maintenance."

* * *

>ask about speeder
Beck: "I keep reminding you, but you still haven't taken it in for yearly maintenance."

>n
Jones approaches the Viking Building entryway, the dramatic façade towering over her.

Galaxy Jones is at the entry doorway. A glass revolving door leads into a large open space north of here. The speeder dock is to the south.

Jones peers upwards at the 100 stories of glass and steel. "What do you want to bet Thallium's got Europa all the way at the top?"

Beck: "Oh, no doubt."

>n
Jones takes a deep breath. "I'm going in."

Beck replies, "You got this, Galaxy."

Jones passes through the revolving door and into the lobby, alert to any defenses.

Galaxy Jones is in the lobby. The ground floor of the Viking Building is breathtaking. Low-G architecture means more glass and thinner supports, and the building takes advantage of that. Four walls of glass surround a central pillar in which are set the utility rooms and elevators. In between is an expanse of plants, water features, and stylish seating. Near the entryway is a front desk. A giant crystal sculpture floats above the center of the area, suspended on almost invisible cables. She may go east and west from here, north to the elevators, or south out of the building.

>ask about art
Suddenly two robot guards, green and red, emerge from niches in the back wall! Jones dives behind the front desk and draws her disruptor pistol.

Jones shouts, "I'm under fire from two ugly robot things!"

Beck responds, "Monitoring your suit radar."

>ask about art
Jones: "Beck, how about the giant sculpture?"

Beck: "While I normally dislike Rambutan's work, this one has a certain power to it."

>d
Should Jones burrow downward?

Jones: "I could use some ideas here!"

>e
Trying to reach an exit would surely get Jones shot.

Jones: "I'm pinned down here!"

>u
Jones can neither climb walls nor fly.

Beck: "Robot on your right!"

One robot tries to flank Jones, but a shot from her disruptor sends it scurrying back.

>ne
That would just get Jones lost in a maze of couches.

Zip! Disruptor fire scorches a nearby couch.

>shoot art
Jones fires the disruptor into the sculpture's main support cable, snapping it. The huge crystal blob starts to sag, straining the other cables. In quick succession they break as well, and the whole installation plummets to the ground, right on top of the hapless guard robots.
 _________      __                     _____                     
 __/ ____/___ _/ /___ __  ____  __     __/ /___  ____  ___  _____
 _/ / __/ __ `/ / __ `/ |/ / / / /____ _/ / __ \/ __ \/ _ \/ ___/
 / /_/ / /_/ / / /_/ />  </ /_/ / _/ /_/ / /_/ / / / /  __(__  ) 
 \____/\__,_/_/\__,_/_/|_|\__, /  _\____/\____/_/ /_/\___/____/  
 _____________________________/ 

[Your score has just gone up by one point.]

Beck: "What was that crash? What's going on?"

Jones: "That, my friend, was what you'd call a work of art. Targets terminated."

* * *

>e
Jones crosses the floor carefully, disruptor pistol at the ready.

Galaxy Jones is at the southeast corner of the ground floor. The centerpiece of this area is the actual Viking 2 lander, which landed right here on Utopia Planitia. The glass walls look out onto the city. She can go north or west from here.

Admiral Thallium's voice booms from the ceiling. "Little Galaxy thinks she's beaten the big bad Admiral. Sorry dear, that was only a taste."

>d
Should Jones burrow downward?

>n
Galaxy Jones is on the east side of the ground floor. Apparently some kind of function was happening here before Admiral Thallium emptied the building, for there is an array of canapes on a catering table here. The floor stretches north and south, and there's a closet door to the west.

Beck: "Blueprints indicate a closet to the west of you. Might be useful."

>d
Should Jones burrow downward?

>n
Galaxy Jones is at the northeast corner of the ground floor. The area is dedicated to celebrating the military career of Admiral Thallium. Uniforms, medals, ribbons, and other miscellanea are mounted on the wall or in showcases. All this despite the fact that no one has turned up any evidence that Thallium served in any navy of any country on any planet. One can escape to the west or south.

Jones: "Now this is some choice bullshit here."

Beck: "Looks like the record of the good Admiral's long and dedicated service."

>d
Should Jones burrow downward?

>w
Galaxy Jones is on the north side of the ground floor. The area is dominated by a towering statue of Admiral Thallium against the north wall. The ground floor extends west and east from here. The elevator is to the south.

>d
Should Jones burrow downward?

>s
Galaxy Jones is in the ground floor elevator hall. This hallway between the north and south ends of the ground floor is home to the elevator to the west. To the east is the entrance to a stairwell.

>d
Should Jones burrow downward?

>in
That way leads straight into a wall.

>d
Should Jones burrow downward?

>s
Galaxy Jones is in the lobby. The ground floor of the Viking Building is breathtaking. Low-G architecture means more glass and thinner supports, and the building takes advantage of that. Four walls of glass surround a central pillar in which are set the utility rooms and elevators. In between is an expanse of plants, water features, and stylish seating. Near the entryway is a front desk. Jones may go east and west from here, north to the elevators, or south out of the building. There are two niches in the central wall from which the guard robots emerged.

Spread across the floor in a tangled ruin are the remains of a giant crystal sculpture and two guard robots.

>in
Jones can go south out of the building or north to the elevator. The ground floor continues east and west.

>e
Galaxy Jones is at the southeast corner of the ground floor. The centerpiece of this area is the actual Viking 2 lander, which landed right here on Utopia Planitia. The glass walls look out onto the city. Jones can go north or west from here.

>in
That way leads through the glass wall.

>out
But Jones isn't in anything at the moment.

>u
Jones can neither climb walls nor fly.

>rules
Rules tracing now switched on. Type "rules off" to switch it off again, or "rules all" to include even rules which do not apply.

[Rule "reset conversed this turn rule" applies.]
[Rule "clear LPR rule" applies.]

>u
[Rule "After deciding the scope of the player" applies.]
[Rule "After deciding the scope of the player" applies.]
[Rule "After deciding the scope of the player" applies.]
[Rule "declare everything initially unmentioned rule" applies.]
[Rule "standard set going variables rule" applies.]
[Rule "assign alternative door targets rule" applies.]
[Rule "announce items from multiple object lists rule" applies.]
[Rule "set pronouns from items from multiple object lists rule" applies.]
[Rule "before stage rule" applies.]
[Rule "keychain-aware carrying requirements rule" applies.]
[Rule "instead stage rule" applies.]
[Rule "Instead of going nowhere" applies.]
Jones can neither climb walls nor fly.

[Rule "A first turn sequence rule" applies.]
[Rule "every turn stage rule" applies.]
[Rule "Every turn when the mauve guard robot is in the tenth-floor-region and the mauve guard robot is not under attack" applies.]
[Rule "reset protocol rule" applies.]
[Rule "A last turn sequence rule" applies.]
[Rule "notify score changes rule" applies.]
[Rule "show us the people rule" applies.]
[Rule "reset conversed this turn rule" applies.]
[Rule "clear LPR rule" applies.]

* * *

Would you like to play with accessibility on? (recommended for mobile)

>ask about suit
(the black jumpsuit)

Jones: "Beck, tell me about the black jumpsuit."

Beck: "That allows me to see and hear what's going on there."

>ask about suit
(the black jumpsuit)

Jones: "Beck, how about the black jumpsuit?"

Beck: "That allows me to see and hear what's going on there."

>ask about suit
(the black jumpsuit)

Jones: "Beck, what do you think about the black jumpsuit?"

Beck: "That allows me to see and hear what's going on there."

>ask about suit
(the black jumpsuit)

Jones: "Beck, how about the black jumpsuit?"

Beck: "That allows me to see and hear what's going on there."

>ask beck about building
Jones: "Beck, what do you think about the building entryway?"

Beck: "Extravagant, as always."

>n
Jones approaches the Viking Building entryway, the dramatic façade towering over her.

Galaxy Jones is at the entry doorway. A glass revolving door leads into a large open space north of here. The speeder dock is to the south.

Jones peers upwards at the 100 stories of glass and steel. "What do you want to bet Thallium's got Europa all the way at the top?"

Beck: "Oh, no doubt."

>ask beck about door
Jones: "Beck, how about the entry door?"

Beck: "Hmm. Don't have much to say about that right now."

>n
Jones takes a deep breath. "I'm going in."

Beck replies, "You got this, Galaxy."

Jones passes through the revolving door and into the lobby, alert to any defenses.

Galaxy Jones is in the lobby. The ground floor of the Viking Building is breathtaking. Low-G architecture means more glass and thinner supports, and the building takes advantage of that. Four walls of glass surround a central pillar in which are set the utility rooms and elevators. In between is an expanse of plants, water features, and stylish seating. Near the entryway is a front desk. A giant crystal sculpture floats above the center of the area, suspended on almost invisible cables. She may go east and west from here, north to the elevators, or south out of the building.

>ask beck about sculpture
Jones: "Beck, what do you think about the giant sculpture?"
Suddenly two robot guards, green and red, emerge from niches in the back wall! Jones dives behind the front desk and draws her disruptor pistol.

Jones shouts, "I'm under fire from two ugly robot things!"

Beck responds, "Monitoring your suit radar."

>ask beck about sculpture
Jones: "Beck, tell me about the giant sculpture."

Beck: "While I normally dislike Rambutan's work, this one has a certain power to it."

A robot fires a blistering shot into the front desk.

Jones: "I could use some ideas here!"

* * *

Would you like to play with accessibility on? (recommended for mobile)

>ask beck about beck
Beck: "I'm just happy to serve."

* * *

Would you like to play with accessibility on? (recommended for mobile)

>ask beck about building
Beck: "Extravagant, as always."

>n
Jones approaches the Viking Building entryway, the dramatic façade towering over her.

Galaxy Jones is at the entry doorway. A glass revolving door leads into a large open space north of here. The speeder dock is to the south.

Jones looks up at the 100 stories of glass and steel. "What do you want to bet Thallium's got Europa all the way at the top?"

Beck: "Oh, no doubt."

>ask beck about building
Beck: "Extravagant, as always."

>ask beck about dock
Beck: "I'm not sure what you're asking about, Jones."

>ask beck about entry
Which do you mean, the building entryway or the entry door?

>door
Beck: "Hmm. Don't have much to say about that right now."

>ask beck about entryway
Beck: "Extravagant, as always."

>n
Jones takes a deep breath. "I'm going in."

Beck replies, "You got this, Galaxy."

Jones passes through the revolving door and into the lobby, alert to any defenses.

Galaxy Jones is in the lobby. The ground floor of the Viking Building is breathtaking. Low-G architecture means more glass and thinner supports, and the building takes advantage of that. Four walls of glass surround a central pillar in which are set the utility rooms and elevators. In between is an expanse of plants, water features, and stylish seating. Near the entryway is a front desk. A giant crystal sculpture floats above the center of the area, suspended on almost invisible cables. She may go east and west from here, north to the elevators, or south out of the building.

>ask beck about art
Suddenly two robot guards, green and red, emerge from niches in the back wall! Jones dives behind the front desk and draws her disruptor pistol.

Jones shouts, "I'm under fire from two ugly robot things!"

Beck responds, "Monitoring your suit radar."

>ask beck about art
Beck: "While I normally dislike Rambutan's work, this one has a certain power to it."

Beck: "How's it going in there?"

"Jones: "You know -- like all art, it's hit or miss."

>shoot art
Jones fires the disruptor into the sculpture's main support cable, snapping it. The huge crystal blob starts to sag, straining the other cables. In quick succession they break as well, and the whole installation plummets to the ground, right on top of the hapless guard robots.
 _________      __                     _____                     
 __/ ____/___ _/ /___ __  ____  __     __/ /___  ____  ___  _____
 _/ / __/ __ `/ / __ `/ |/ / / / /____ _/ / __ \/ __ \/ _ \/ ___/
 / /_/ / /_/ / / /_/ />  </ /_/ / _/ /_/ / /_/ / / / /  __(__  ) 
 \____/\__,_/_/\__,_/_/|_|\__, /  _\____/\____/_/ /_/\___/____/  
 _____________________________/ 

[Your score has just gone up by one point.]

Beck: "What was that crash? What's going on?"

Jones: "That, my friend, was what you'd call a work of art. Targets terminated."

>ask beck about art
Beck: "While I normally dislike Rambutan's work, this one has a certain power to it."

>ask beck about robot
Beck: "I've really come to appreciate art a lot more since then."

>ask beck about art
Beck: "While I normally dislike Rambutan's work, this one has a certain power to it."

* * *

Would you like to play with accessibility on? (recommended for mobile)

>ask beck about dock
Beck: "I'm not sure what you're asking about, Jones."

>ask about dock
Beck: "It's almost empty. Guess everyone went home when Thallium went ape."

>actions
Actions listing on.

>ask beck about dock
[asking Beck about "dock"]
Beck: "I'm not sure what you're asking about, Jones."
[asking Beck about "dock" - succeeded]

>ask about dock
[implicit-quizzing the speeder dock]
[(1) quizzing Beck about the speeder dock]
Beck: "It's almost empty. Guess everyone went home when Thallium went ape."
[(1) quizzing Beck about the speeder dock - failed]

[implicit-quizzing the speeder dock - failed]

* * *

>ask beck about dock
Beck: "I'm not sure what you're asking about, Jones."

>n
Jones approaches the Viking Building entryway, the dramatic façade towering over her.

Galaxy Jones is at the entry doorway. A glass revolving door leads into a large open space north of here. The speeder dock is to the south.

Jones looks up at the 100 stories of glass and steel. "What do you want to bet Thallium's got Europa all the way at the top?"

Beck: "Oh, no doubt."

>ask beck about dock
Beck: "I'm not sure what you're asking about, Jones."

>actions
Actions listing on.

* * *

>ask beck about dock
[asking Beck about "dock"]
Beck: "I'm not sure what you're asking about, Jones."
[asking Beck about "dock" - succeeded]

>ask beck about speeder dock
[asking Beck about "speeder dock"]
Beck: "I'm not sure what you're asking about, Jones."
[asking Beck about "speeder dock" - succeeded]

* * *

Would you like to play with accessibility on? (recommended for mobile)

>ask beck about game
Beck: "Well, you can ask about: INTERACTIVE FICTION, COMMANDS, or CREDITS."

>ask about credits
"Here are the credits:"

Extensions by:
Standard Rules version 3/120430 by Graham Nelson
Deluxe Doors version 4 by Emily Short
Skeleton Keys by Emily Short
Epistemology version 9 by Eric Eve
Conversation Framework version 11 by Eric Eve
Gender Options version 3/210331 by Nathanael Nerode
Exit Lister version 11 by Eric Eve

Story by Phil Riley.
Programming by Phil Riley.
Playtesting by Leon Lin, Oliver Matthias, Jade, John Ziegler, and Kenneth Pedersen.
Invaluable inspiration from Laura Taalman.

>ask about graham nelson
Beck: "I'm not sure what you're asking about, Jones."

>n
Jones approaches the Viking Building entryway, the dramatic façade towering over her.

Galaxy Jones is at the entry doorway. A glass revolving door leads into a large open space north of here. The speeder dock is to the south.

Jones looks up at the 100 stories of glass and steel. "What do you want to bet Thallium's got Europa all the way at the top?"

Beck: "Oh, no doubt."

>ask about doorway
Jones: "Beck, tell me about the entry doorway."

>ask about speeder
Beck: "I keep reminding you, but you still haven't taken it in for yearly maintenance."

* * *

Would you like to play with accessibility on? (recommended for mobile)

>ask beck about pistol
Jones: "Beck, tell me about the disruptor pistol."

Beck: "Uh, you know what that's for, right?"

>ask beck about suit
(the black jumpsuit)

Jones: "Beck, how about the black jumpsuit?"

Beck: "Hmm. Don't have much to say about that right now."

* * *

Would you like to play with accessibility on? (recommended for mobile)

>ask beck about speeder
Beck: "I keep reminding you, but you still haven't taken it in for yearly maintenance."

>ask about speeder
Jones: "Beck, tell me about the speeder.

Beck: "I keep reminding you, but you still haven't taken it in for yearly maintenance."

* * *

Would you like to play with accessibility on? (recommended for mobile)

>ask beck for help
Beck: "Looks like you're managing okay."

>a help
Beck: "I'm not sure what you're asking about, Jones."

>ask for help
Beck: "Looks like you're managing okay."

>n
Jones approaches the Viking Building entryway, the dramatic façade towering over her.

Galaxy Jones is at the entry doorway. A glass revolving door leads into a large open space north of here. The speeder dock is to the south.

Jones looks up at the 100 stories of glass and steel. "What do you want to bet Thallium's got Europa all the way at the top?"

Beck: "Oh, no doubt."

>climb building
Even if that were feasible, Jones is afraid of heights.

>u
Jones can neither climb walls nor fly.

>d
Is jones going to burrow downward?

>n
Jones takes a deep breath. "I'm going in."

Beck replies, "You got this, Galaxy."

Jones passes through the revolving door and into the lobby, alert to any defenses.

Galaxy Jones is in the lobby. The ground floor of the Viking Building is breathtaking. Low-G architecture means more glass and thinner supports, and the building takes advantage of that. Four walls of glass surround a central pillar in which are set the utility rooms and elevators. In between is an expanse of plants, water features, and stylish seating. Near the entryway is a front desk. A giant crystal sculpture floats above the center of the area, suspended on almost invisible cables. She may go east and west from here, north to the elevators, or south out of the building.

>x building
Suddenly two robot guards, green and red, emerge from niches in the back wall! Jones dives behind the front desk and draws her disruptor pistol.

Jones shouts, "I'm under fire from two ugly robot things!"

Beck responds, "Monitoring your suit radar."

>x building
The entryway (exit actually) leads out to the speeder dock.

Beck: "How's it going in there?"

"Jones: "You know -- like all art, it's hit or miss."

>x glass
Which do you mean, the building entryway, outside, or the giant sculpture?

>outside
Outside the building are the red-dusted streets of New Reykjavik.

A robot fires a blistering shot into the front desk.

>x entryway
The entryway (exit actually) leads out to the speeder dock.

>x sculpture
It's a huge crystal abstraction, provocative in its arrogance but evocative of nothing. A typical public installation by the artist Rambutan. It's held up by metal cables.

Beck: "Robot on your right!"

One robot tries to flank Jones, but a shot from her disruptor sends it scurrying back.

>ask beck about robots
Beck: "Keep your head down and keep firing."

>ask for help
Beck: "I dunno, maybe shoot the robots?"

>shoot robot
Oof. Big miss.

>shoot robot
Jones's shot hits the red and green guard robots dead on, but nothing happens, almost as if the robot had absorbed the energy.

Jones: "Target seems to be absorbing disruptor fire. This will make things a little harder."

One robot tries to flank Jones, but a shot from her disruptor sends it scurrying back.

* * *

Would you like to play with accessibility on? (recommended for mobile)

>credits
"The people responsible:"

Extensions by:
Standard Rules version 3/120430 by Graham Nelson
Deluxe Doors version 4 by Emily Short
Skeleton Keys by Emily Short
Epistemology version 9 by Eric Eve
Conversation Framework version 11 by Eric Eve
Gender Options version 3/210331 by Nathanael Nerode
Exit Lister version 11 by Eric Eve

Story by Phil Riley.
Programming by Phil Riley.
Playtesting by Leon Lin, Oliver Matthias, Jade, John Ziegler, and Kenneth Pedersen.
Invaluable inspiration from Laura Taalman.

I beg your pardon?

* * *

Would you like to play with accessibility on? (recommended for mobile)

>d
Is jones going to burrow downward?

>in
What does Jones want to enter?

>out
But Jones isn't in anything at the moment.

>gonear ground hall
Galaxy Jones is in the ground floor elevator hall. This hallway between the north and south ends of the ground floor is home to the elevator to the west. To the east is the entrance to a stairwell.

>in
What does Jones want to enter?

* * *

>d
Is jones going to burrow downward?

>u
Jones can't go that way.

>n
Jones approaches the Viking Building entryway, the dramatic façade towering over her.

Galaxy Jones is at the entry doorway. A glass revolving door leads into a large open space north of here. The speeder dock is to the south.

Jones peers upwards at the 100 stories of glass and steel. "What do you want to bet Thallium's got Europa all the way at the top?"

Beck: "Oh, no doubt."

>d
Jones can't go that way.

>u
Jones can't go that way.

>n
Jones takes a deep breath. "I'm going in."

Beck replies, "You got this, Galaxy."

Jones passes through the revolving door and into the lobby, alert to any defenses.

Galaxy Jones is in the lobby. The ground floor of the Viking Building is breathtaking. Low-G architecture means more glass and thinner supports, and the building takes advantage of that. Four walls of glass surround a central pillar in which are set the utility rooms and elevators. In between is an expanse of plants, water features, and stylish seating. Near the entryway is a front desk. A giant crystal sculpture floats above the center of the area, suspended on almost invisible cables. She may go east and west from here, north to the elevators, or south out of the building.

>d
Suddenly two robot guards, green and red, emerge from niches in the back wall! Jones dives behind the front desk and draws her disruptor pistol.

Jones shouts, "I'm under fire from two ugly robot things!"

Beck responds, "Monitoring your suit radar."

>d
Trying to reach an exit would surely get Jones shot.

Jones: "I'm pinned down here!"

>shoot art
Jones fires the disruptor into the sculpture's main support cable, snapping it. The huge crystal blob starts to sag, straining the other cables. In quick succession they break as well, and the whole installation plummets to the ground, right on top of the hapless guard robots.
 _________      __                     _____                     
 __/ ____/___ _/ /___ __  ____  __     __/ /___  ____  ___  _____
 _/ / __/ __ `/ / __ `/ |/ / / / /____ _/ / __ \/ __ \/ _ \/ ___/
 / /_/ / /_/ / / /_/ />  </ /_/ / _/ /_/ / /_/ / / / /  __(__  ) 
 \____/\__,_/_/\__,_/_/|_|\__, /  _\____/\____/_/ /_/\___/____/  
 _____________________________/ 

[Your score has just gone up by one point.]

Beck: "What was that crash? What's going on?"

Jones: "That, my friend, was what you'd call a work of art. Targets terminated."

>d
Jones can't go that way.

>in
Jones can't go that way.

>out
Jones leaves the building.

Galaxy Jones is at the entry doorway. A glass revolving door leads into a large open space north of here. The speeder dock is to the south.

>rules
Rules tracing now switched on. Type "rules off" to switch it off again, or "rules all" to include even rules which do not apply.

[Rule "reset conversed this turn rule" applies.]
[Rule "clear LPR rule" applies.]

>d
[Rule "After deciding the scope of the player" applies.]
[Rule "After deciding the scope of the player" applies.]
[Rule "After deciding the scope of the player" applies.]
[Rule "declare everything initially unmentioned rule" applies.]
[Rule "standard set going variables rule" applies.]
[Rule "assign alternative door targets rule" applies.]
[Rule "announce items from multiple object lists rule" applies.]
[Rule "set pronouns from items from multiple object lists rule" applies.]
[Rule "before stage rule" applies.]
[Rule "keychain-aware carrying requirements rule" applies.]
[Rule "instead stage rule" applies.]
[Rule "investigate player's awareness before action rule" applies.]
[Rule "player aware of his own actions rule" applies.]
[Rule "check stage rule" applies.]
[Rule "can't travel in what's not a vehicle rule" applies.]
[Rule "can't go through undescribed doors rule" applies.]
[Rule "can't go through closed doors rule" applies.]
[Rule "determine map connection rule" applies.]
[Rule "can't go that way rule" applies.]
Jones can't go that way.

[Rule "A first turn sequence rule" applies.]
[Rule "every turn stage rule" applies.]
[Rule "Every turn when the mauve guard robot is in the tenth-floor-region and the mauve guard robot is not under attack" applies.]
[Rule "reset protocol rule" applies.]
[Rule "A last turn sequence rule" applies.]
[Rule "notify score changes rule" applies.]
[Rule "show us the people rule" applies.]
[Rule "reset conversed this turn rule" applies.]
[Rule "clear LPR rule" applies.]

* * *

Would you like to play with accessibility on? (recommended for mobile)

>frotz speeder
(the speeder)
Although you complete the spell, nothing seems to have happened.

>frotz pistol
There is an almost blinding flash of light as the disruptor pistol begins to glow! It slowly fades to a less painful level, but the disruptor pistol is now quite usable as a light source.

>i
Jones is carrying:
  a disruptor pistol (providing light)

>frotz jones
Jones is bathed in a sickly yellow light, bright enough to read by.

* * *

Would you like to play with accessibility on? (recommended for mobile)

>gonear cybernetica office
(the Cybernetica office)
Galaxy Jones is in the Cybernetica office. It's spacious and luxurious, designed to make developers forget how spent they are from months of overwork and abuse. Ergonomic desks and chairs fill space like a furniture fractal, before giving way to an open area, presumably for group activities.

As soon as Jones steps into the office, a shot zaps just past her nose. She dives to the ground, protected by the maze of desks and chairs. Peeking through the mesh back of one of the chairs, she takes notice of both the purple guard robot training its disruptor on the room, and the chair's fine construction and lumbar support.

Jones (whispering): "We've got another one! I'm out of sight for now, but it's going to be hard to get a shot off at this 'bot."

Beck: "What's the situation?"

Jones: "I'm on the floor with desks and chairs all around. The target is a few yards off, coming this way. I can get a shot in, but it might just absorb it anyway."

Beck: "Well, see if you can sneak up on it. Maybe close up you can find a way past its defenses."

>move closer to robot
Jones creeps a little ways toward the guard robot.

>move closer to desk
There's no sneaking up on that right now.

>e
Jones can leave through the door to the west.

>move closer to robot
Slowly, slowly, Jones gets a little closer. Just a little more...

She must have poked up her shoulder or something, for the guard robot fires his disruptor. The shot takes out a window on the east side of the room. The electrostatic field around the building keeps the atmosphere from pouring out.

>e
The atmosphere is too thin out there. Jones needs protective gear.

>purloin suit
(the black jumpsuit)
[Purloined.]

>e
The atmosphere is too thin out there. Jones needs protective gear.

* * *

>purloin atmo
[Purloined.]

>e
You'll never get out without being shot.

>leave
Jones starts to stand, and a shot zips by, way too close. She hits the deck.

>w
(first opening the Cybernetica door)
The guard robot moves a little farther away from Jones.

Trying to reach an exit would surely get her shot.

>s
Jones can leave through the door to the west. She can also go east through the broken window.

>e
You'll never get out without being shot.

>shoot robot
Jones raises her head and fires wide. The robot fires back. Jones ducks and crawls off among the labyrinth of desks.

Beck: "Are you still shooting at those things? Even if you hit 'em it's not going to leave a scratch."

Jones (whispering): "So what do you propose?"

Beck: "Get closer. Keep your head down, but move in closer to it until you can get a good shot in."

The guard robot moves a little farther away from her.

>ask beck for help
Beck: "The robot's got you pinned down good, yeah? And you can't get a good shot in? And even if you did, it would probably just be absorbed?"

>ask beck for help
Beck: "When will you start listening to your handler? When? I've been giving you good advice, just spelling out what to do, and you don't pay attention."

>ask beck for help
Beck: "Sneak up on the stupid robot already!"

>ask beck for help
Beck: "Sneak up on the stupid robot already!"

>e
You'll never get out without being shot.

>sneak up on robot
Jones creeps a little ways toward the guard robot.

>sneak up on robot
Slowly, slowly, Jones gets a little closer. Just a little more...

>sneak up on robot
Jones is right up next to the robot, crouched beneath a desk. She can see right up under its armor.

>shoot robot
Jones aims the pistol upward under the robot's enhanced armor and fires. She flinches back when the robot's innards explode downward in a shower of sparks. It topples over, dead. Jones stands up and surveys her handiwork.

 _________      __                     _____                     
 __/ ____/___ _/ /___ __  ____  __     __/ /___  ____  ___  _____
 _/ / __/ __ `/ / __ `/ |/ / / / /____ _/ / __ \/ __ \/ _ \/ ___/
 / /_/ / /_/ / / /_/ />  </ /_/ / _/ /_/ / /_/ / / / /  __(__  ) 
 \____/\__,_/_/\__,_/_/|_|\__, /  _\____/\____/_/ /_/\___/____/  
 _____________________________/ 

[Your score has just gone up by one point.]

Jones: "Better than a video game. "

Beck: "Nice, but don't forget to credit your handler."

Jones: "Yes, yes, thanks for helping me not get killed."

Beck: "You're welcome."

>e
Jones: "I'm going out the window to see if I can find a way to get up to the tenth floor."

Beck: "Whoa whoa whoa, Jones. You know you're not good with heights."

Jones: "Ask Thallium how how much that matters once I've kicked his ass. Watch me, I'll look down and not even flinch."

Jones puts on the Atmo-Suit.

Galaxy Jones is on a ledge. She's plastered up against the wall, trying not to look down.

>look down
Okay, fine. Jones look down, slowly, slowly... and there's a window cleaner's scaffold, about six feet below her.

Jones: "Okay, so. There's a window washing platform right below me. I might be able to drop down to it, but I won't be able to get back up."

Beck: "Take it easy, Jones."

* * *

>shoot robot
Jones raises her head and fires wide. The robot fires back. Jones ducks and crawls off among the labyrinth of desks.

Beck: "Are you still shooting at those things? Even if you hit 'em it's not going to leave a scratch."

Jones (whispering): "So what do you propose?"

Beck: "Get closer. Keep your head down, but move in closer to it until you can get a good shot in."

>shoot robot
Jones raises her head and fires wide. The robot fires back. Jones ducks and crawls off among the labyrinth of desks.

>move closer to robot
There's nothing like that nearby.

* * *

>stand up
That would be suicide.

>sneak up on robot
Jones creeps a little ways toward the guard robot.

* * *

>sneak up on robot
Slowly, slowly, Jones gets a little closer. Just a little more...

She must have poked up her shoulder or something, for the guard robot fires his disruptor. The shot takes out a window on the east side of the room. The electrostatic field around the building keeps the atmosphere from pouring out.

>sneak up on robot
Jones is right up next to the robot, crouched beneath a desk. She can see right up under its armor.

* * *

>stand up
You are already standing up.

>restart
Are you sure you want to restart?

* * *

Would you like to play with accessibility on? (recommended for mobile)

>n
 _________      __                     _____                     
 __/ ____/___ _/ /___ __  ____  __     __/ /___  ____  ___  _____
 _/ / __/ __ `/ / __ `/ |/ / / / /____ _/ / __ \/ __ \/ _ \/ ___/
 / /_/ / /_/ / / /_/ />  </ /_/ / _/ /_/ / /_/ / / / /  __(__  ) 
 \____/\__,_/_/\__,_/_/|_|\__, /  _\____/\____/_/ /_/\___/____/  
 _____________________________/ 

An Interactive Adventure by Phil Riley
Release 3 / Serial number 230326 / Inform 7 build 6M62 (I6/v6.34 lib 6/12N) SD

A sleek dark red speeder roars into the dock of the Viking Building. A tall woman in a battle-ready jumpsuit and carrying a disruptor pistol climbs out of it: Galaxy Jones.

Galaxy Jones is in the speeder dock. A safe harbor from the periodic dust storms of Utopia Planitia, the dock features several dozen speeder bays. Only a few are filled right now. The building entryway is to the north, under a red stone façade carved into the likeness of a fearsome Viking.

Jones's speeder, Galaxy One, sits in one of the parking bays.

Jones's handler Beck comes over her headset. "Alright, what's going on?"

She replies, "I'm in the speeder dock. No movement. What can I expect inside?"

"Blueprints show the ground floor is one big empty space with elevators in the center. Not a lot of places for resistance to hide, but you can never tell. Be careful.

"And one other thing, Jones: if you need help you can ASK BECK FOR HELP. You can also ASK BECK ABOUT things or ASK BECK ABOUT GAME for more information about the game. Finally, you can cause help to repeat from the beginning by saying ASK BECK TO RESET HELP"

>ask about doorway
Beck: "I don't have much to say about that."

>ask about speeder dock
Beck: "It's almost empty. Guess everyone went home when Thallium went ape."

>n
Jones takes a deep breath. "I'm going in."

Beck replies, "You got this, Galaxy."

Jones passes through the revolving door and into the lobby, alert to any defenses.

Galaxy Jones is in the lobby. The ground floor of the Viking Building is breathtaking. Low-G architecture means more glass and thinner supports, and the building takes advantage of that. Four walls of glass surround a central pillar in which are set the utility rooms and elevators. In between is an expanse of plants, water features, and stylish seating. Near the entryway is a front desk. A giant crystal sculpture floats above the center of the area, suspended on almost invisible cables. She may go east and west from here, north to the elevators, or south out of the building.

I beg your pardon?

>ask about lobby
Suddenly two robot guards, green and red, emerge from niches in the back wall! Jones dives behind the front desk and draws her disruptor pistol.

Jones shouts, "I'm under fire from two ugly robot things!"

Beck responds, "Monitoring your suit radar."

>ask about lobby
Beck: "Impressive place."

A robot fires a blistering shot into the front desk.

>shoot robot
Oops! Jones misses.

>shoot at robot
Jones's shot hits the red and green guard robots dead on, but nothing happens, almost as if the robot had absorbed the energy.

Jones: "Target seems to be absorbing disruptor fire. This will make things a little harder."

Zip! Disruptor fire scorches a nearby couch.

>kill roboy
There's nothing like that nearby.

>kill robot
As soon as Jones starts to act, an energy beam zips past her head, forcing her back down behind the desk.

Zip! Disruptor fire scorches a nearby couch.

>attack roboy
There's nothing like that nearby.

>attack robot
As soon as Jones starts to act, an energy beam zips past her head, forcing her back down behind the desk.

The two robots coordinate fire over the desk, narrowly missing her.

>a robot
Beck: "It doesn't look like shooting the robots is doing any good. Is there another way you can hurt them?"

>kick desk
I didn't understand that sentence.

>hit desk
As soon as Jones starts to act, an energy beam zips past her head, forcing her back down behind the desk.

A robot fires a blistering shot into the front desk.

>x desk
There's not much on the desk other than a sticky note that says "0".

The two robots coordinate fire over the desk, narrowly missing Jones.

>shoot robot
Jones sticks her head out from behind the desk and squeezes off a shot at the red and green guard robots. In her haste it goes wide of the target.

One of the robots fires directly above Jones's head.

>shoot couch
Jones only uses violent means when absolutely necessary.

>shoot art
Jones fires the disruptor into the sculpture's main support cable, snapping it. The huge crystal blob starts to sag, straining the other cables. In quick succession they break as well, and the whole installation plummets to the ground, right on top of the hapless guard robots.
 _________      __                     _____                     
 __/ ____/___ _/ /___ __  ____  __     __/ /___  ____  ___  _____
 _/ / __/ __ `/ / __ `/ |/ / / / /____ _/ / __ \/ __ \/ _ \/ ___/
 / /_/ / /_/ / / /_/ />  </ /_/ / _/ /_/ / /_/ / / / /  __(__  ) 
 \____/\__,_/_/\__,_/_/|_|\__, /  _\____/\____/_/ /_/\___/____/  
 _____________________________/ 

[Your score has just gone up by one point.]

Beck: "What was that crash? What's going on?"

Jones: "That, my friend, was what you'd call a work of art. Targets terminated."

>gonear air
(the air handling room)
Galaxy Jones is in the air handling room. There is a good number of loud fans and other air handling machinery here. A small hinged vent opening leads into some ductwork, and from there to the outside. A door leads west.

>w
(first opening the air handling door)

Galaxy Jones is on the north side of the Consolidated Microthings office. This is the company cafeteria. The elevator is south, the air handling room is to the east, and the office continues to the west and southeast.

Thallium's voice booms over the office PA: "You can run, Jones, but you can't - well, there aren't very many places you can hide."

>se
Galaxy Jones is on the east side of the Consolidated Microthings office. This part of the office is currently unused. Jones can go northwest or south from here.

* * *

>s
Galaxy Jones is at the southeast corner of the Consolidated Microthings office. This corner of the floor contains the gym and other company amenities. Reception is to the west, and an empty area lies to the north.

Jones sees the mauve guard robot a couple of steps to the west.

>shoot robot
The shot narrowly misses the guard robot.

A couple of steps to the west, the mauve guard robot heads east.

Beck: "I don't think I like Thallium's choice of friends much."

>shoot robot
The strikes a window and reflects at a crazy angle around the room.

The mauve guard robot approaches from the west.

The robot slaughters Jones.

    *** Jones was killed by the mauve guard robot ***

In that game you scored 1 out of a possible 10, in 22 turns.

Would you like to RESTART, RESTORE a saved game, QUIT, or UNDO the last command?

>undo
Galaxy Jones is at the southeast corner of the Consolidated Microthings office.
[Previous turn undone.]

>e
From here, one can go north or west.

The mauve guard robot approaches from the west.

Jones doesn't stand a chance against the mauve guard robot's terrible knives.

    *** Jones was killed by the mauve guard robot ***

In that game you scored 1 out of a possible 10, in 22 turns.

Would you like to RESTART, RESTORE a saved game, QUIT, or UNDO the last command?

>undo
Galaxy Jones is at the southeast corner of the Consolidated Microthings office.
[Previous turn undone.]

>ne
From here, one can go north or west.

The mauve guard robot approaches from the west.

The guard robot moves in on Jones with its slashing knife arms, slicing her to ribbons.

    *** Jones was killed by the mauve guard robot ***

In that game you scored 1 out of a possible 10, in 22 turns.

Would you like to RESTART, RESTORE a saved game, QUIT, or UNDO the last command?

>undo
Galaxy Jones is at the southeast corner of the Consolidated Microthings office.
[Previous turn undone.]

>n
Galaxy Jones is on the east side of the Consolidated Microthings office. This part of the office is currently unused. Jones can go northwest or south from here.

The mauve guard robot appears nearby to the south, coming from the west.

>nw
Galaxy Jones is on the north side of the Consolidated Microthings office. This is the company cafeteria. The elevator is south, the air handling room is to the east, and the office continues to the west and southeast.

The mauve guard robot appears nearby to the southeast, coming from the south.

>e
Galaxy Jones is in the air handling room. There is a good number of loud fans and other air handling machinery here. A small hinged vent opening leads into some ductwork, and from there to the outside. A door leads west.

* * *

>z
Jones stands around and waits.

>w
Galaxy Jones is on the north side of the Consolidated Microthings office. This is the company cafeteria. The elevator is south, the air handling room is to the east, and the office continues to the west and southeast.

Thallium: "Jones, you still hanging around with that loser Beck?"

>w
Galaxy Jones is at the northwest corner of the Consolidated Microthings office. Various executive offices line the north and west walls here. Jones can go east or south.

Beck: "I've seen more intimidating kitchen appliances!"

Jones sees the mauve guard robot a couple of steps to the south.

>x guard
This one looks, if anything, even meaner than the ones Jones has already seen. There is a small vent on the top of its head, probably to dispose of excess heat.

A couple of steps to the south, the mauve guard robot heads north.

>e
Galaxy Jones is on the north side of the Consolidated Microthings office. This is the company cafeteria. The elevator is south, the air handling room is to the east, and the office continues to the west and southeast.

The mauve guard robot appears nearby to the west, coming from the south.

Thallium: "Don't you just hate it, Jones -- not knowing when death will just jump out at you?"

>e
Galaxy Jones is in the air handling room. There is a good number of loud fans and other air handling machinery here. A small hinged vent opening leads into some ductwork, and from there to the outside. A door leads west.

* * *

>s
Galaxy Jones is in the tenth floor elevator hall. The elevator car to the west stands open. There is a stairwell to the east. The hall runs north and south into a sumptuous corporate office.

>restart
Are you sure you want to restart?

* * *

>n
Jones approaches the Viking Building entryway, the dramatic façade towering over her.

Galaxy Jones is at the entry doorway. A glass revolving door leads into a large open space north of here. The speeder dock is to the south.

Jones looks up at the 100 stories of glass and steel. "What do you want to bet Thallium's got Europa all the way at the top?"

Beck: "Oh, no doubt."

>ask about building
Beck: "Extravagant, as always."

* * *

>ask beck about building
Jones: "Beck, what do you think about the building entryway?"

Beck: "Extravagant, as always."

>ask beck about beck
Jones: "Beck, tell me about Beck."

Beck: "I'm just happy to serve."

>ask beck about me
Jones: "Beck, how about Jones?"

Beck: "Well, I think you're very nice, Jones."

* * *

>ask beck about lobby
Beck: "I'm not sure what you're asking about, Jones."

>n
Jones takes a deep breath. "I'm going in."

Beck replies, "You got this, Galaxy."

Jones passes through the revolving door and into the lobby, alert to any defenses.

Galaxy Jones is in the lobby. The ground floor of the Viking Building is breathtaking. Low-G architecture means more glass and thinner supports, and the building takes advantage of that. Four walls of glass surround a central pillar in which are set the utility rooms and elevators. In between is an expanse of plants, water features, and stylish seating. Near the entryway is a front desk. A giant crystal sculpture floats above the center of the area, suspended on almost invisible cables. She may go east and west from here, north to the elevators, or south out of the building.

>ask beck about lobby
Suddenly two robot guards, green and red, emerge from niches in the back wall! Jones dives behind the front desk and draws her disruptor pistol.

Jones shouts, "I'm under fire from two ugly robot things!"

Beck responds, "Monitoring your suit radar."

>restore
Restore failed.

>restart
Are you sure you want to restart?

* * *

>restart
Are you sure you want to restart?

* * *

>ask beck about art
Jones: "Beck, what do you think about the giant sculpture?"
Suddenly two robot guards, green and red, emerge from niches in the back wall! Jones dives behind the front desk and draws her disruptor pistol.

Jones shouts, "I'm under fire from two ugly robot things!"

Beck responds, "Monitoring your suit radar."

* * *

>gonear ground hall
Galaxy Jones is in the ground floor elevator hall. This hallway between the north and south ends of the ground floor is home to the elevator to the west. To the east is the entrance to a stairwell.

>scope
1: Jones (1141720)
2: an elevator door (1142296)
3: a small hole (1148216)
4: a stairwell (1142328)
5: an elevator shaft (1142360)
6: a black jumpsuit (1141752)
7: a suit light (1141336)
8: a disruptor pistol (1141784)
9: Beck (1141272)

* * *

>look up
Beyond the glass ceiling, the building looms above Jones, 100 stories tall.

>x up
There's nothing in that direction.

* * *

>n
Jones takes a deep breath. "I'm going in."

Beck replies, "You got this, Galaxy."

Jones passes through the revolving door and into the lobby, alert to any defenses.

Galaxy Jones is in the lobby. The ground floor of the Viking Building is breathtaking. Low-G architecture means more glass and thinner supports, and the building takes advantage of that. Four walls of glass surround a central pillar in which are set the utility rooms and elevators. In between is an expanse of plants, water features, and stylish seating. Near the entryway is a front desk. A giant crystal sculpture floats above the center of the area, suspended on almost invisible cables. She may go east and west from here, north to the elevators, or south out of the building.

* * *

I beg your pardon?

>z
Suddenly two robot guards, green and red, emerge from niches in the back wall! Jones dives behind the front desk and draws her disruptor pistol.

Jones shouts, "I'm under fire from two ugly robot things!"

Beck responds, "Monitoring your suit radar."

>shoot robot
Jones's shot hits a robot dead on, but nothing happens, almost as if the robot had absorbed the energy.

Jones: "Target seems to be absorbing disruptor fire. This will make things a little harder."

Beck: "Got it."

The two robots coordinate fire over the desk, narrowly missing her.

>ask beck for help
Beck: "Well, if your energy weapon won't hurt them, maybe direct physical force will?"

Beck: "Robot on your right!"

One robot tries to flank Jones, but a shot from her disruptor sends it scurrying back.

Beck: "How's it going in there?"

"Jones: "You know -- like all art, it's hit or miss."

>ask beck for help
Beck: "It would have to be something large. Throwing your shoe at them isn't going to cut it."

>throw shoe
There's nothing like that nearby.

>ask beck for help
Beck: "That sculpture up there seems pretty big."

>throw shoe
There's nothing like that nearby.

>ask beck for help
Beck: "That sculpture up there seems pretty big."

The two robots coordinate fire over the desk, narrowly missing Jones.

>shoot art
Jones fires the disruptor into the sculpture's main support cable, snapping it. The huge crystal blob starts to sag, straining the other cables. In quick succession they break as well, and the whole installation plummets to the ground, right on top of the hapless guard robots.
 _________      __                     _____                     
 __/ ____/___ _/ /___ __  ____  __     __/ /___  ____  ___  _____
 _/ / __/ __ `/ / __ `/ |/ / / / /____ _/ / __ \/ __ \/ _ \/ ___/
 / /_/ / /_/ / / /_/ />  </ /_/ / _/ /_/ / /_/ / / / /  __(__  ) 
 \____/\__,_/_/\__,_/_/|_|\__, /  _\____/\____/_/ /_/\___/____/  
 _____________________________/ 

[Your score has just gone up by one point.]

Beck: "What was that crash? What's going on?"

Jones: "That, my friend, was what you'd call a work of art. Targets terminated."

>x it
Jones can't see 'it' (nothing) at the moment.

>x art
Jones digs through the ruins and finds a cable with hooks at either end, which she takes.

>x it
Jones searches some more, but nothing further turns up.

>x cable
This is a strong but slender cable, presumably of carbon nanotubes. There are steel hooks at either end.

>hook cable to me
Jones would achieve nothing by this.

>w
Jones crosses the floor carefully, disruptor pistol at the ready.

Galaxy Jones is at the southwest corner of the ground floor. A lush indoor waterfall here contrasts with the dusty red streets of New Reykjavik beyond the glass walls. The ground floor extends north and east.

Admiral Thallium's voice booms from the ceiling. "Little Galaxy thinks she's beaten the big bad Admiral. Sorry dear, that was only a taste."

>d
Is jones going to burrow downward?

>w
Jones can't walk through walls. Try north or east.

>take coin
There's nothing like that nearby.

>x water
The waterfall descends the length of an artificial rock formation fringed by wide-leaved Earth plants and ferns. The water collects in a basin at the bottom, where it begins its journey again. A single coin sits on the bottom of the basin.

Jones: "One coin? Not very generous people around here."

>x rock
There's nothing like that nearby.

>x plants
Imported plants are a must on Mars, to relieve the stress of living on a lifeless world.

>take coin
Taken.

>x coin
A one-Areo coin, with Ares on the front and the Viking 2 lander on the back.

>ask about coin
Beck: "Might as well hold on to it. You're not getting paid for this job."

>n
Galaxy Jones is on the west side of the ground floor. Semicircular couches open on either side of a central carpeted path leading north and south. Set in the central pillar of the building to the east is a utility door. The city looms beyond the glass wall to the west.

>ne
Instead of plowing through the sea of furniture, Jones should try going north, south, or east.

>n
Galaxy Jones is at the northwest corner of the ground floor. A large relief map of Mars is mounted on the north wall here. One can leave here to the south or east.

>se
Jones ends up in a cul-de-sac of couches, and retreats. Clearer passages lie to the east and south.

>n
Jones can't walk through walls. She can go east or south from here.

>e
Galaxy Jones is on the north side of the ground floor. The area is dominated by a towering statue of Admiral Thallium against the north wall. The ground floor extends west and east from here. The elevator is to the south.

>e
Galaxy Jones is at the northeast corner of the ground floor. The area is dedicated to celebrating the military career of Admiral Thallium. Uniforms, medals, ribbons, and other miscellanea are mounted on the wall or in showcases. All this despite the fact that no one has turned up any evidence that Thallium served in any navy of any country on any planet. One can escape to the west or south.

Jones: "Now this is some choice bullshit here."

Beck: "Looks like the record of the good Admiral's long and dedicated service."

>look up
The whole ground floor is bright and airy, its ceiling covered with reflective pyramids. Supporting struts criss-cross the area, from which sparkling crystal chandeliers are suspended.

>take medal
There's nothing like that nearby.

>take medals
They're all behind glass.

>x glass
Outside the building are the red-dusted streets of New Reykjavik.

>x medal
There's nothing like that nearby.

>x medals
Jones yawns looking over the assortment of faux honors. They're all behind glass, but one of the display cases is partly open, leaving the rather garish medal inside unprotected.

>take medal
Taken.

* * *

>take pin
Taken.

>drop medal
Dropped.

>s
Galaxy Jones is on the east side of the ground floor. Apparently some kind of function was happening here before Admiral Thallium emptied the building, for there is an array of canapes on a catering table here. The floor stretches north and south, and there's a closet door to the west.

Beck: "Blueprints indicate a closet to the west of you. Might be useful."

>n
Galaxy Jones is at the northeast corner of the ground floor. The area is dedicated to celebrating the military career of Admiral Thallium. Uniforms, medals, ribbons, and other miscellanea are mounted on the wall or in showcases. All this despite the fact that no one has turned up any evidence that Thallium served in any navy of any country on any planet. One can escape to the west or south.

Also here is a garish medal (empty).

>s
Galaxy Jones is on the east side of the ground floor. Apparently some kind of function was happening here before Admiral Thallium emptied the building, for there is an array of canapes on a catering table here. The floor stretches north and south, and there's a closet door to the west.

>x table
The table is covered with a wide array of treats from the ridiculously expensive, such as shrimp tea sandwiches (where do you get shrimp on Mars?), to the just plain ridiculous, like poached ostrich eggs in jelly. A good number of forks are laid out to one side.

Jones: "What would you like me to bring you, Beck? Shrimp tea sandwiches, or poached ostrich eggs?"

Beck: "Oh, the shrimp. Definitely get the shrimp."

>take all
fork: Taken.
shrimp tea sandwich: Taken.
poached ostrich eggs in jelly: Don't even.

>w
(first opening the closet door)
Jones will have to enter the correct code on the keypad first.

>0
An indicator light by the door to the west glows green.

Jones: "I've unlocked the east side utility door."

>w
(first opening the closet door)

Galaxy Jones is in the maintenance closet. A bare, white-walled room containing various maintenance items. The exit is to the east.

There is an Atmo-Suit hanging from a hook here.

On the shelf is a red cardkey.

>take all
Atmo-Suit: Taken.
red cardkey: Taken.

>s
Jones can't go that way.

>e
Galaxy Jones is on the east side of the ground floor. Apparently some kind of function was happening here before Admiral Thallium emptied the building, for there is an array of canapes on a catering table here. The floor stretches north and south, and there's a closet door to the west.

* * *

>s
Galaxy Jones is at the southeast corner of the ground floor. The centerpiece of this area is the actual Viking 2 lander, which landed right here on Utopia Planitia. The glass walls look out onto the city. Jones can go north or west from here.

>nw
That would lead directly through the Viking 2 lander.

>w
Galaxy Jones is in the lobby. The ground floor of the Viking Building is breathtaking. Low-G architecture means more glass and thinner supports, and the building takes advantage of that. Four walls of glass surround a central pillar in which are set the utility rooms and elevators. In between is an expanse of plants, water features, and stylish seating. Near the entryway is a front desk. Jones may go east and west from here, north to the elevators, or south out of the building. There are two niches in the central wall from which the guard robots emerged.

Spread across the floor in a tangled ruin are the remains of a giant crystal sculpture and two guard robots.

>w
Galaxy Jones is at the southwest corner of the ground floor. A lush indoor waterfall here contrasts with the dusty red streets of New Reykjavik beyond the glass walls. The ground floor extends north and east.

>n
Galaxy Jones is on the west side of the ground floor. Semicircular couches open on either side of a central carpeted path leading north and south. Set in the central pillar of the building to the east is a utility door. The city looms beyond the glass wall to the west.

* * *

>e
(first opening the utility door)

Galaxy Jones is in the elevator room. This is a utility room related to the operation of the elevator, on the other side of the east wall here. There is a control panel on the wall, and a door leading west.

Hanging from a hook here is a drop key.

Lying discarded on a table here is a hammer.

>take all
hammer: Taken.
drop key: Taken.

* * *

>w
Galaxy Jones is on the west side of the ground floor. Semicircular couches open on either side of a central carpeted path leading north and south. Set in the central pillar of the building to the east is a utility door. The city looms beyond the glass wall to the west.

>s
Galaxy Jones is at the southwest corner of the ground floor. A lush indoor waterfall here contrasts with the dusty red streets of New Reykjavik beyond the glass walls. The ground floor extends north and east.

>e
Galaxy Jones is in the lobby. The ground floor of the Viking Building is breathtaking. Low-G architecture means more glass and thinner supports, and the building takes advantage of that. Four walls of glass surround a central pillar in which are set the utility rooms and elevators. In between is an expanse of plants, water features, and stylish seating. Near the entryway is a front desk. Jones may go east and west from here, north to the elevators, or south out of the building. There are two niches in the central wall from which the guard robots emerged.

Spread across the floor in a tangled ruin are the remains of a giant crystal sculpture and two guard robots.

* * *

>n
Galaxy Jones is in the ground floor elevator hall. This hallway between the north and south ends of the ground floor is home to the elevator to the west. To the east is the entrance to a stairwell.

>unlock elevator door
Jones inserts the drop key into the small hole and turns it, disengaging the lock mechanism. Then she slides the door open, exposing an empty elevator shaft to the west.

>e
As soon as Jones enters the stairwell, a disruptor blast from above zings past her shoulder, and she beats a hasty retreat. She won't be going up the stairs until she can clear out the resistance, and she can't do that from here.

Jones: "I've got gunfire from somewhere up the stairs. I'll have to get above them and take them out from behind."

Beck: "Sounds like a plan."

Galaxy Jones is in the ground floor elevator hall. This hallway between the north and south ends of the ground floor is home to the elevator to the west. To the east is the entrance to a stairwell. The elevator door is open, revealing the bottom of the elevator shaft. Jones could climb into it, if she wished.

>w
Jones climbs into the elevator shaft.

Galaxy Jones is in the ground floor elevator shaft. She is at the bottom of a dark well. Shining her suit light up, she can see that the elevator car is several floors up, unmoving. There is a ladder running up the wall next to the door.

Beck: "Ooh. It's like we're in an action film."

>e
Galaxy Jones is in the ground floor elevator hall. This hallway between the north and south ends of the ground floor is home to the elevator to the west. To the east is the entrance to a stairwell. The elevator door is open, revealing the bottom of the elevator shaft. Jones could climb into it, if she wished.

>climb in
You must name something more substantial.

>w
Galaxy Jones is in the ground floor elevator shaft. Jones is at the bottom of a dark well. Shining her suit light up, she can see that the elevator car is several floors up, unmoving. There is a ladder running up the wall next to the door.

>u
Jones climbs up the shaft, stopping at each floor to test each door. She gets all the way to the ninth floor, directly below the elevator car, before finding one that opens.

Galaxy Jones is in the ninth floor elevator shaft. The door to the east is open.

Beck: "Huh. Seems like it should have taken longer than that."

>e
 _________      __                     _____                     
 __/ ____/___ _/ /___ __  ____  __     __/ /___  ____  ___  _____
 _/ / __/ __ `/ / __ `/ |/ / / / /____ _/ / __ \/ __ \/ _ \/ ___/
 / /_/ / /_/ / / /_/ />  </ /_/ / _/ /_/ / /_/ / / / /  __(__  ) 
 \____/\__,_/_/\__,_/_/|_|\__, /  _\____/\____/_/ /_/\___/____/  
 _____________________________/ 

[Your score has just gone up by one point.]

Jones: "Finally out of the shaft. That was quite a climb."

Beck: "This floor is just offices. Check the building management office to the west. It might have some useful stuff."

Jones exits the shaft, the door sliding closed behind her.

Galaxy Jones is in the ninth floor elevator hall. The elevator is to the west, the stairwell is to the east, and a corridor leads north and south. There is a bottled water vending machine here.

>buy water with coin
Jones inserts the coin in the machine and takes the bottle that appears a few seconds later.

>undo
Galaxy Jones is in the ninth floor elevator hall.
[Previous turn undone.]

>buy water with money
Jones inserts the coin in the machine and takes the bottle that appears a few seconds later.

>buy water with coin
There's nothing like that nearby.

>n
Galaxy Jones is in the ninth floor north hallway. This anonymous corporate hallway ends here at the north end of the building. An open doorway leads west. To the east is a door with a swipe lock, labeled "Cybernetica Inc."

>w
Galaxy Jones is at the north end of the building management office. The building management office is a bunch of desks and task boards. There is a particularly large desk against the west window. The office exit is to the east, and the office continues to the south.

>pick desk with pin
Jones pushes the pin into the keyhole and wiggles it around. After a few seconds of this the desk drawer pops open. It contains a black cardkey.
 _________      __                     _____                     
 __/ ____/___ _/ /___ __  ____  __     __/ /___  ____  ___  _____
 _/ / __/ __ `/ / __ `/ |/ / / / /____ _/ / __ \/ __ \/ _ \/ ___/
 / /_/ / /_/ / / /_/ />  </ /_/ / _/ /_/ / /_/ / / / /  __(__  ) 
 \____/\__,_/_/\__,_/_/|_|\__, /  _\____/\____/_/ /_/\___/____/  
 _____________________________/ 

[Your score has just gone up by one point.]

Beck: "Galaxy Jones, master thief!"

>take cardkey
(the black cardkey)
Taken.

>s
Galaxy Jones is at the south end of the building management office. The building management office is a bunch of desks and task boards. There is a filing cabinet against the east wall. The office exit is to the east, and the office continues to the north.

A screwdriver sits atop the filing cabinet.

>take tool
Jones reaches for the screwdriver, but she fumbles it and it rolls off the back of the filing cabinet.

Jones: "Damn."

Beck: "What? What's going on?"

Jones: "Just being clumsy is all."

>take screwdriver
Jones reaches behind the cabinet to retrieve the screwdriver. A swipe and a hiss make her recoil.

Jones: "Holy --!"

Beck: "What now?"

Jones: "There's a cat here! Behind a filing cabinet. Gotta get behind there to get a screwdriver, so I need a way to drive off the cat."

>take screwdriver
Forget it. Jones isn't getting another scratch.

>drop shrimp
Sensing food, the black cat pokes its head out, grabs the shrimp in its jaws, and races off. Jones takes the screwdriver.

 _________      __                     _____                     
 __/ ____/___ _/ /___ __  ____  __     __/ /___  ____  ___  _____
 _/ / __/ __ `/ / __ `/ |/ / / / /____ _/ / __ \/ __ \/ _ \/ ___/
 / /_/ / /_/ / / /_/ />  </ /_/ / _/ /_/ / /_/ / / / /  __(__  ) 
 \____/\__,_/_/\__,_/_/|_|\__, /  _\____/\____/_/ /_/\___/____/  
 _____________________________/ 

[Your score has just gone up by one point.]

Jones: "Aha! No creature is too fearsome for Galaxy Jones!"

Beck: "Congratulations on your victory."

>e
Galaxy Jones is in the ninth floor south hallway. This anonymous corporate hallway ends here at the south end of the building. An open doorway leads west. To the east is a door with a swipe lock, labeled "Martian Chemical."

* * *

>e
(first opening the Martian Chemical door)

Galaxy Jones is in the Martian Chemical office. This seems like the business office of the chemical company rather than the lab. Most of the room is taken up by desks and other office stuff. There is a cabinet that looks intriguing, however.

>take gel
Taken.

>s
The only way to leave the office is through the door to the west.

>n
The only way to leave the office is through the door to the west.

>w
Galaxy Jones is in the ninth floor south hallway. This anonymous corporate hallway ends here at the south end of the building. An open doorway leads west. To the east is a door with a swipe lock, labeled "Martian Chemical."

>n
Galaxy Jones is in the ninth floor elevator hall. The elevator is to the west, the stairwell is to the east, and a corridor leads north and south. There is a bottled water vending machine here.

* * *

>n
Galaxy Jones is in the ninth floor north hallway. This anonymous corporate hallway ends here at the north end of the building. An open doorway leads west. To the east is a door with a swipe lock, labeled "Cybernetica Inc."

I beg your pardon?

>unlock door
(with the black cardkey)
Jones unlocks the Cybernetica door.

>e
(first opening the Cybernetica door)

Galaxy Jones is in the Cybernetica office. It's spacious and luxurious, designed to make developers forget how spent they are from months of overwork and abuse. Ergonomic desks and chairs fill space like a furniture fractal, before giving way to an open area, presumably for group activities.

As soon as Jones steps into the office, a shot zaps just past her nose. She dives to the ground, protected by the maze of desks and chairs. Peeking through the mesh back of one of the chairs, she takes notice of both the purple guard robot training its disruptor on the room, and the chair's fine construction and lumbar support.

Jones (whispering): "We've got another one! I'm out of sight for now, but it's going to be hard to get a shot off at this 'bot."

Beck: "What's the situation?"

Jones: "I'm on the floor with desks and chairs all around. The target is a few yards off, coming this way. I can get a shot in, but it might just absorb it anyway."

Beck: "Well, see if you can sneak up on it. Maybe close up you can find a way past its defenses."

>crawl toward robot
Jones creeps a little ways toward the guard robot.

>crawl towards robot
Slowly, slowly, Jones gets a little closer. Just a little more...

She must have poked up her shoulder or something, for the guard robot fires his disruptor. The shot takes out a window on the east side of the room. The electrostatic field around the building keeps the atmosphere from pouring out.

>creep toward robot
Jones is right up next to the robot, crouched beneath a desk. She can see right up under its armor.

>creep toward robot
Jones is right up next to the robot, crouched beneath a desk. She can see right up under its armor.

>stand up
That would be suicide.

>hit robot
Fine way for Jones to get herself killed.

>shoot robot
Jones aims the pistol upward under the robot's enhanced armor and fires. She flinches back when the robot's innards explode downward in a shower of sparks. It topples over, dead. Jones stands up and surveys her handiwork.

 _________      __                     _____                     
 __/ ____/___ _/ /___ __  ____  __     __/ /___  ____  ___  _____
 _/ / __/ __ `/ / __ `/ |/ / / / /____ _/ / __ \/ __ \/ _ \/ ___/
 / /_/ / /_/ / / /_/ />  </ /_/ / _/ /_/ / /_/ / / / /  __(__  ) 
 \____/\__,_/_/\__,_/_/|_|\__, /  _\____/\____/_/ /_/\___/____/  
 _____________________________/ 

[Your score has just gone up by one point.]

Jones: "Better than a video game. "

Beck: "Nice, but don't forget to credit your handler."

Jones: "Yes, yes, thanks for helping me not get killed."

Beck: "You're welcome."

>hit robot
Jones only uses violent means when absolutely necessary.

>stand up
Jones is already standing up.

>leave
Jones: "I'm going out the window to see if I can find a way to get up to the tenth floor."

Beck: "Whoa whoa whoa, Jones. You know you're not good with heights."

Jones: "Ask Thallium how how much that matters once I've kicked his ass. Watch me, I'll look down and not even flinch."

Jones puts on the Atmo-Suit.

Galaxy Jones is on a ledge. The ledge runs north and south. Jones is plastered up against the wall, trying not to look down.

>n
A metal cable running up and down halts Jones's progress in that direction.

>x cable
(the cable with hooks at either end)
This is a strong but slender cable, presumably of carbon nanotubes. There are steel hooks at either end.

>x metal cable
It looks very tense. It runs up and down.

>s
A metal cable running up and down halts Jones's progress in that direction.

>look down
Are you sure? Jones is really afraid of heights.

>look down
Okay, fine. Jones looks down, slowly, slowly... and there's a window cleaner's scaffold, about six feet below her.

Jones: "Okay, so. There's a window washing platform right below me. I might be able to drop down to it, but I won't be able to get back up."

Beck: "Take it easy, Jones."

>d
Jones drops off the ledge onto the scaffold. It rocks unnervingly for a moment.

Galaxy Jones is on a window washing scaffold. It's lined up with the eighth floor window. There doesn't seem to be any way to get into the building here. Mounted on the scaffold is a control panel with two buttons: one indicating up and one indicating down.

>u
If you want to go up and down, use the buttons.

>d
If you want to go up and down, use the buttons.

>e
That way leads to a quick death.

>w
None of the windows here are open.

>s
That way leads to a quick death.

>n
That way leads to a quick death.

>press button
Which do you mean, the scaffold up button or the scaffold down button?

>up
Jones presses the button, and the scaffold begins to rise.

Galaxy Jones is on a window washing scaffold. It's lined up with the ninth floor window. She could climb back into the building through the window here. Mounted on the scaffold is a control panel with two buttons: one indicating up and one indicating down.

Jones: "Beck?"

Beck: "Yes?"

Jones: "I hate it out here."

Beck: "Well, there's the open window right next to you."

>w
Galaxy Jones is in the Cybernetica office. It's spacious and luxurious, designed to make developers forget how spent they are from months of overwork and abuse. Ergonomic desks and chairs fill space like a furniture fractal, before giving way to an open area, presumably for group activities. One of the windows along the east side of the office is broken.

The remains of the purple guard robot are sprawled on the ground.

Jones takes off the Atmo-Suit.

>x robot
The tattered guts of the purple guard robot spill out from its armored carapace.

>e
Jones puts on the Atmo-Suit.

Galaxy Jones is on a window washing scaffold. It's lined up with the ninth floor window. She could climb back into the building through the window here. Mounted on the scaffold is a control panel with two buttons: one indicating up and one indicating down.

>press up button
Jones presses the button, and the scaffold begins to rise.

Galaxy Jones is on a window washing scaffold. It's lined up with the tenth floor. Instead of a window, there's what appears to be an exhaust vent. If it's for forced air, though, the fan is currently not running. Mounted on the scaffold is a control panel with two buttons: one indicating up and one indicating down.

Jones: "Alright, I'm by the tenth floor now. What's this grille thing here?"

Beck: "That's an exhaust vent. There's an air handling room on this floor which it leads into. If you can remove the cover you should be able to access the whole floor from here."

>open vent
Jones loosens the screws with the screwdriver and opens the grille.

>w
Jones climbs inside the vent, crawls along a short length of ductwork, and emerges through another hinged grille, into the air handling room.
 _________      __                     _____                     
 __/ ____/___ _/ /___ __  ____  __     __/ /___  ____  ___  _____
 _/ / __/ __ `/ / __ `/ |/ / / / /____ _/ / __ \/ __ \/ _ \/ ___/
 / /_/ / /_/ / / /_/ />  </ /_/ / _/ /_/ / /_/ / / / /  __(__  ) 
 \____/\__,_/_/\__,_/_/|_|\__, /  _\____/\____/_/ /_/\___/____/  
 _____________________________/ 

[Your score has just gone up by one point.]

Galaxy Jones is in the air handling room. There is a good number of loud fans and other air handling machinery here. A small hinged vent opening leads into some ductwork, and from there to the outside. A door leads west.

She takes off the Atmo-Suit.

Jones: "Ha! I'm in!"

Beck: "Be careful, you're likely to run into more resistance here. The floor is all one open office, so any guard robots will have good line of sight."

Jones: "Got it."

Beck: "And Jones? Save your game."

>e
Jones puts on the Atmo-Suit.

Galaxy Jones is on a window washing scaffold. It's lined up with the tenth floor. Instead of a window, there's what appears to be an exhaust vent. If it's for forced air, though, the fan is currently not running. Mounted on the scaffold is a control panel with two buttons: one indicating up and one indicating down.

>enter grille
Jones climbs inside the vent, crawls along a short length of ductwork, and emerges through another hinged grille, into the air handling room.

Galaxy Jones is in the air handling room. There is a good number of loud fans and other air handling machinery here. A small hinged vent opening leads into some ductwork, and from there to the outside. A door leads west.

She takes off the Atmo-Suit.

>w
(first opening the air handling door)

Galaxy Jones is on the north side of the Consolidated Microthings office. This is the company cafeteria. The elevator is south, the air handling room is to the east, and the office continues to the west and southeast.

>drop suit
Which do you mean, the Atmo-Suit, the black jumpsuit, or the suit light?

>atmo
Dropped.

>e
Galaxy Jones is in the air handling room. There is a good number of loud fans and other air handling machinery here. A small hinged vent opening leads into some ductwork, and from there to the outside. A door leads west.

>e
The atmosphere is too thin out there. Jones needs protective gear.

>w
Galaxy Jones is on the north side of the Consolidated Microthings office. This is the company cafeteria. The elevator is south, the air handling room is to the east, and the office continues to the west and southeast.

Also here is an Atmo-Suit.

Thallium's voice booms over the office PA: "You can run, Jones, but you can't - well, there aren't very many places you can hide."

>take suit
(the Atmo-Suit)
Taken.

>e
Galaxy Jones is in the air handling room. There is a good number of loud fans and other air handling machinery here. A small hinged vent opening leads into some ductwork, and from there to the outside. A door leads west.

>w
Galaxy Jones is on the north side of the Consolidated Microthings office. This is the company cafeteria. The elevator is south, the air handling room is to the east, and the office continues to the west and southeast.

>x light
It automatically goes on when it gets dark. Cool.

Thallium: "Jones, you still hanging around with that loser Beck?"

>x suit
Which do you mean, the Atmo-Suit, the black jumpsuit, or the suit light?

>jumpsuit
It's an advanced Smart Suit, able to communicate sound, vision, and radar back to Beck at Galaxy Base. Also it has a neat light.

>remove jumpsuit
Jones needs the jumpsuit to complete her mission.

>nw
The elevator is south of here, and the floor extends west and southeast. The door to the air handling room is to the east.

Thallium: "Don't you just hate it, Jones -- not knowing when death will just jump out at you?"

>se
Galaxy Jones is on the east side of the Consolidated Microthings office. This part of the office is currently unused. Jones can go northwest or south from here.

>s
Galaxy Jones is at the southeast corner of the Consolidated Microthings office. This corner of the floor contains the gym and other company amenities. Reception is to the west, and an empty area lies to the north.

Beck: "Come and get us, ugly!"

Jones: "'Us'? Seems like I'm the only one with her life on the line."

Jones sees the mauve guard robot a couple of steps to the west.

>n
Galaxy Jones is on the east side of the Consolidated Microthings office. This part of the office is currently unused. Jones can go northwest or south from here.

* * *

>w
Galaxy Jones is at the northwest corner of the Consolidated Microthings office. Various executive offices line the north and west walls here. Jones can go east or south.

>s
Galaxy Jones is on the west side of the Consolidated Microthings office. This ocean of desks looks out toward the Utopia Tower, twice the height of the Viking Building, where Jones is now. One can go north or south.

Thallium: "I bet you're just dying to meet Europa, right, Jones?"

>s
Galaxy Jones is at the southwest corner of the Consolidated Microthings office. This looks like the IT area of the office. Numerous desks and an abundance of computer parts are here. Jones can go north or east from here.

There is a present with a note attached sitting on a desk here.

The mauve guard robot appears a couple of steps to the east, coming from the north.

>take present
Taken.

A couple of steps to the east, the mauve guard robot heads west.

>n
Galaxy Jones is on the west side of the Consolidated Microthings office. This ocean of desks looks out toward the Utopia Tower, twice the height of the Viking Building, where Jones is now. One can go north or south.

The mauve guard robot appears nearby to the south, coming from the east.

Thallium: "Don't you just hate it, Jones -- not knowing when death will just jump out at you?"

>n
Galaxy Jones is at the northwest corner of the Consolidated Microthings office. Various executive offices line the north and west walls here. Jones can go east or south.

A couple of steps to the south, the mauve guard robot heads north.

* * *

>s
Galaxy Jones is in the tenth floor elevator hall. The elevator car to the west stands open. There is a stairwell to the east. The hall runs north and south into a sumptuous corporate office.

>w
Galaxy Jones is in the elevator car. It's luxurious, with gold-plated walls and crystal lighting on the ceiling. The button panel is lacquered dark mahogany with what look like real ivory buttons. The carpeting is soft and plush. A golden keyhole sits above the buttons.

One of the ceiling panels looks loose.

Admiral Thallium's voice oozes from concealed speakers: "Yes, Jones, that is real ivory. I imported the elephant here myself for a hunt on my estate. You have no idea how much money it takes to simulate an African jungle on Mars. In retrospect I should have gotten an Indian elephant."

>u
Jones can neither climb walls nor fly.

>open panel
(the ceiling panel)
Jones removes the ceiling panel, exposing a hole wide enough for her to squeeze through.

>u
Galaxy Jones is on the top of the elevator car. The elevator shaft extends many hundreds of feet above her. She can see down into the elevator car from here.

>d
Galaxy Jones is in the elevator car. It's luxurious, with gold-plated walls and crystal lighting on the ceiling. The button panel is lacquered dark mahogany with what look like real ivory buttons. The carpeting is soft and plush. A golden keyhole sits above the buttons. There is a hole in the ceiling big enough for Jones to squeeze through.

>open present
Jones rips the package open and discovers a golden key.

>put key in hole
Which do you mean, the golden key, the black cardkey, the drop key, or the red cardkey?

>golden
Jones puts the key in the keyhole and turns. There is a pleasant chime, and some buttons light up.
 _________      __                     _____                     
 __/ ____/___ _/ /___ __  ____  __     __/ /___  ____  ___  _____
 _/ / __/ __ `/ / __ `/ |/ / / / /____ _/ / __ \/ __ \/ _ \/ ___/
 / /_/ / /_/ / / /_/ />  </ /_/ / _/ /_/ / /_/ / / / /  __(__  ) 
 \____/\__,_/_/\__,_/_/|_|\__, /  _\____/\____/_/ /_/\___/____/  
 _____________________________/ 

[Your score has just gone up by one point.]

Galaxy Jones is in the elevator car. It's luxurious, with gold-plated walls and crystal lighting on the ceiling. The button panel is lacquered dark mahogany with what look like real ivory buttons. The carpeting is soft and plush. A golden key rests in a golden keyhole above the buttons. The buttons 1, 9, 10, and 100 are illuminated. There is a hole in the ceiling big enough for Jones to squeeze through.

>take key
(the golden key)
Jones tries to take the key out of the keyhole, but it seems to be stuck there.

>press 9
The elevator quickly arrives at its destination.

Galaxy Jones is in the elevator car. It's luxurious, with gold-plated walls and crystal lighting on the ceiling. The button panel is lacquered dark mahogany with what look like real ivory buttons. The carpeting is soft and plush. A golden key rests in a golden keyhole above the buttons. The buttons 1, 9, 10, and 100 are illuminated. There is a hole in the ceiling big enough for Jones to squeeze through.

Thallium: "Jones, you still hanging around with that loser Beck?"

>e
Galaxy Jones is in the ninth floor elevator hall. The elevator is to the west, the stairwell is to the east, and a corridor leads north and south. There is a bottled water vending machine here.

>n
Galaxy Jones is in the ninth floor north hallway. This anonymous corporate hallway ends here at the north end of the building. An open doorway leads west. To the east is a door with a swipe lock, labeled "Cybernetica Inc."

>e
Galaxy Jones is in the Cybernetica office. It's spacious and luxurious, designed to make developers forget how spent they are from months of overwork and abuse. Ergonomic desks and chairs fill space like a furniture fractal, before giving way to an open area, presumably for group activities. One of the windows along the east side of the office is broken.

The remains of the purple guard robot are sprawled on the ground.

>e
Jones puts on the Atmo-Suit.

Galaxy Jones is on a ledge. The ledge runs north and south. Jones is plastered up against the wall, trying not to look down. The scaffold is right above her head.

>d
That would be a long fall.

>u
If only Jones could climb walls.

>jump
That would be a long fall.

>jump on scaffold
Jones can't make that jump.

>w
Galaxy Jones is in the Cybernetica office. It's spacious and luxurious, designed to make developers forget how spent they are from months of overwork and abuse. Ergonomic desks and chairs fill space like a furniture fractal, before giving way to an open area, presumably for group activities. One of the windows along the east side of the office is broken.

The remains of the purple guard robot are sprawled on the ground.

Jones takes off the Atmo-Suit.

>w
Galaxy Jones is in the ninth floor north hallway. This anonymous corporate hallway ends here at the north end of the building. An open doorway leads west. To the east is a door with a swipe lock, labeled "Cybernetica Inc."

>w
Galaxy Jones is at the north end of the building management office. The building management office is a bunch of desks and task boards. There is a particularly large desk against the west window. The office exit is to the east, and the office continues to the south.

>s
Galaxy Jones is at the south end of the building management office. The building management office is a bunch of desks and task boards. There is a filing cabinet against the east wall. The office exit is to the east, and the office continues to the north.

>e
Galaxy Jones is in the ninth floor south hallway. This anonymous corporate hallway ends here at the south end of the building. An open doorway leads west. To the east is a door with a swipe lock, labeled "Martian Chemical."

>n
Galaxy Jones is in the ninth floor elevator hall. The elevator is to the west, the stairwell is to the east, and a corridor leads north and south. There is a bottled water vending machine here.

>w
(first opening the ninth floor elevator door)
Galaxy Jones is in the elevator car. It's luxurious, with gold-plated walls and crystal lighting on the ceiling. The button panel is lacquered dark mahogany with what look like real ivory buttons. The carpeting is soft and plush. A golden key rests in a golden keyhole above the buttons. The buttons 1, 9, 10, and 100 are illuminated. There is a hole in the ceiling big enough for Jones to squeeze through.

>press 1
The elevator quickly arrives at its destination.

Galaxy Jones is in the elevator car. It's luxurious, with gold-plated walls and crystal lighting on the ceiling. The button panel is lacquered dark mahogany with what look like real ivory buttons. The carpeting is soft and plush. A golden key rests in a golden keyhole above the buttons. The buttons 1, 9, 10, and 100 are illuminated. There is a hole in the ceiling big enough for Jones to squeeze through.

>e
Galaxy Jones is in the ground floor elevator hall. This hallway between the north and south ends of the ground floor is home to the elevator to the west. To the east is the entrance to a stairwell. The elevator door is open, revealing the bottom of the elevator shaft. Jones could climb into it, if she wished.

>d
Is jones going to burrow downward?

>s
Galaxy Jones is in the lobby. The ground floor of the Viking Building is breathtaking. Low-G architecture means more glass and thinner supports, and the building takes advantage of that. Four walls of glass surround a central pillar in which are set the utility rooms and elevators. In between is an expanse of plants, water features, and stylish seating. Near the entryway is a front desk. Jones may go east and west from here, north to the elevators, or south out of the building. There are two niches in the central wall from which the guard robots emerged.

Spread across the floor in a tangled ruin are the remains of a giant crystal sculpture and two guard robots.

>s
Jones leaves the building.

Galaxy Jones is at the entry doorway. A glass revolving door leads into a large open space north of here. The speeder dock is to the south.

>s
Jones slinks back to the speeder dock.

Galaxy Jones is in the speeder dock. A safe harbor from the periodic dust storms of Utopia Planitia, the dock features several dozen speeder bays. Only a few are filled right now. The building entryway is to the north, under a red stone façade carved into the likeness of a fearsome Viking.

Her speeder, Galaxy One, sits in one of the parking bays.

>n
Galaxy Jones is at the entry doorway. A glass revolving door leads into a large open space north of here. The speeder dock is to the south.

>n
Galaxy Jones is in the lobby. The ground floor of the Viking Building is breathtaking. Low-G architecture means more glass and thinner supports, and the building takes advantage of that. Four walls of glass surround a central pillar in which are set the utility rooms and elevators. In between is an expanse of plants, water features, and stylish seating. Near the entryway is a front desk. Jones may go east and west from here, north to the elevators, or south out of the building. There are two niches in the central wall from which the guard robots emerged.

Spread across the floor in a tangled ruin are the remains of a giant crystal sculpture and two guard robots.

>n
Galaxy Jones is in the ground floor elevator hall. This hallway between the north and south ends of the ground floor is home to the elevator to the west. To the east is the entrance to a stairwell. The elevator door is open, revealing the bottom of the elevator shaft. Jones could climb into it, if she wished.

>w
Galaxy Jones is in the elevator car. It's luxurious, with gold-plated walls and crystal lighting on the ceiling. The button panel is lacquered dark mahogany with what look like real ivory buttons. The carpeting is soft and plush. A golden key rests in a golden keyhole above the buttons. The buttons 1, 9, 10, and 100 are illuminated. There is a hole in the ceiling big enough for Jones to squeeze through.

>press 100
The elevator accelerates upwards at a frightening rate. The numbers climb towards 100. Soon the elevator slows, and the door opens on the 100th floor.

Jones: "Holy - This thing goes fast."

Galaxy Jones is in the elevator car. It's luxurious, with gold-plated walls and crystal lighting on the ceiling. The button panel is lacquered dark mahogany with what look like real ivory buttons. The carpeting is soft and plush. A golden key rests in a golden keyhole above the buttons. The buttons 1, 9, 10, and 100 are illuminated. There is a hole in the ceiling big enough for Jones to squeeze through.

>e
Galaxy Jones is in the 100th floor elevator hall. The luxury is staggering.  The walls are made of polished black marble, and the floors are covered in plush black carpeting that muffles the sound of footsteps. The ceiling is high and adorned with a crystal chandelier. The elevator doors to the west are gold-plated. Sumptuous living quarters are visible to the north and south.

>n
Galaxy Jones is in the northern corner of the penthouse. This is Thallium's bedroom. Apart from the expansive round bed in the center of the room, notable features include the line of dummies displaying his various suits of clothes, a large vanity table, and the complete lack of mirrors on the ceiling, thankfully. One may leave the room to the southwest, south, and southeast.

>x dummies
The best outfit is his Napoleon outfit.

>hit dummy
Jones lets off a little steam.

>e
The diamond-shaped penthouse bends to the southeast and southwest.

>se
Galaxy Jones is in the eastern corner of the penthouse. This is apparently an office. A huge desk constructed of bubinga wood and carved in intricate patterns sits before the panoramic window. Video screens, currently displaying Thallium's logo, line the walls. Jones can go northwest or southwest.

>x screen
They are showing Thallium's logo, the ten planets in order overlaid with the motto "Planetas Vincam".

>x planet
Which do you mean, outside or Admiral Thallium's logo?

>logo
The ten planets in order overlaid with the motto "Planetas Vincam".

>x outside
(outside)
Looking down at New Reykjavik, one can trace the history of the city, as it expanded radially from its original domes, the multiple frontiers colliding and interfering like ripples in a pond, until eventually, the map gave way to rectangular regularity. The Viking Building stands near the periphery, overlooking the vast red plain of Utopia Planitia.

>x planets
The ten planets in order overlaid with the motto "Planetas Vincam".

>x motto
The ten planets in order overlaid with the motto "Planetas Vincam".

>ask beck about motto
Beck: "Hmm. Don't have much to say about that right now."

>sw
Galaxy Jones is in the southern corner of the penthouse. This must be Thallium's "treasure room", to go by the obscene display of wealth. The most notable feature is the array of diamonds lining the walls. Everything else here pales in comparison. The penthouse continues to the northwest, north, and northeast.

Thallium seems to speak from all around Jones. "You like diamonds, Jones? Of course you do -- they're a girl's best friend, after all."

Jones snorts, "Sure, Thallium."

>n
Galaxy Jones is in the 100th floor elevator hall. The luxury is staggering.  The walls are made of polished black marble, and the floors are covered in plush black carpeting that muffles the sound of footsteps. The ceiling is high and adorned with a crystal chandelier. The elevator doors to the west are gold-plated. Sumptuous living quarters are visible to the north and south.

>s
Galaxy Jones is in the southern corner of the penthouse. This must be Thallium's "treasure room", to go by the obscene display of wealth. The most notable feature is the array of diamonds lining the walls. Everything else here pales in comparison. The penthouse continues to the northwest, north, and northeast.

>x diamond
So many of them, from the tiny to the obscenely large. It looks like it wouldn't be hard to pry one out.

>pry one
There's nothing like that nearby.

>pry diamond
You pry one of the diamonds out of the wall.

Thallium giggles. "Oh, I hope you're not disappointed, Jones."

>nw
Galaxy Jones is in the western corner of the penthouse. The purpose of this room is unclear. Instead of the black carpet that plagues the rest of the penthouse, the floor is fashioned from a striking polished red granite. Instead of windows, there are walls. Thallium's personal insignia, the ten planets in order overlaid with the motto "Planetas Vincam", is carved into the deep red wood outer wall, and inlaid with ebony. In the center of the room is a thin metal pillar ending in a claw, which looks like it's meant to hold something. Finally, there is something that looks like an electronic eye set into the inner wall. One may leave to the northeast or southeast.

>put diamond in claw
As soon as Jones inserts the diamond into the claw, laser beams spring from five emitters on the walls. They hit the diamond and refract and disperse without any effect.

>se
Galaxy Jones is in the southern corner of the penthouse. This must be Thallium's "treasure room", to go by the obscene display of wealth. The most notable feature is the array of diamonds lining the walls. Everything else here pales in comparison. The penthouse continues to the northwest, north, and northeast.

>take diamond
Jones has already taken a diamond. Isn't one enough?

>smash diamonds
(with the hammer)
Jones only uses violent means when absolutely necessary.

>x diamonds
So many of them, from the tiny to the obscenely large. It looks like it wouldn't be hard to pry one out.

>nw
Galaxy Jones is in the western corner of the penthouse. The purpose of this room is unclear. Instead of the black carpet that plagues the rest of the penthouse, the floor is fashioned from a striking polished red granite. Instead of windows, there are walls. Thallium's personal insignia, the ten planets in order overlaid with the motto "Planetas Vincam", is carved into the deep red wood outer wall, and inlaid with ebony. In the center of the room is a thin metal pillar ending in a claw, which looks like it's meant to hold something. Finally, there is something that looks like an electronic eye set into the inner wall. One may leave to the northeast or southeast.

>take diamond
Taken.

>x it
Jones: "Hmm. This is made of glass."

Thallium: "Poor, sad Jones. But here's the thing. There is a real diamond in there; it's just you'll never find it before the building's defenses flood the whole floor with poisonous gas. Or maybe I'm bluffing. Maybe I'm not. Can you afford to gamble?"

Jones tosses the fake away.

>se
Galaxy Jones is in the southern corner of the penthouse. This must be Thallium's "treasure room", to go by the obscene display of wealth. The most notable feature is the array of diamonds lining the walls. Everything else here pales in comparison. The penthouse continues to the northwest, north, and northeast.

>take diamond
Jones will never find the real diamond this way.

>smash diamond
(with the hammer)
Jones commences to smash all of the diamonds. After destroying several dozen fraudulent gems, she finds one that won't break. She takes the real diamond.

Thallium: "Wow, clever solution. Be careful you don't cut yourself."

Jones: "I appreciate your concern."

>x glass
The remains of dozens of glass diamonds litter the floor.

>l
Galaxy Jones is in the southern corner of the penthouse. This must be Thallium's "treasure room", to go by the obscene display of wealth. The most notable feature is the array of diamonds lining the walls. Everything else here pales in comparison. Broken glass litters the floor. The penthouse continues to the northwest, north, and northeast.

>nw
Galaxy Jones is in the western corner of the penthouse. The purpose of this room is unclear. Instead of the black carpet that plagues the rest of the penthouse, the floor is fashioned from a striking polished red granite. Instead of windows, there are walls. Thallium's personal insignia, the ten planets in order overlaid with the motto "Planetas Vincam", is carved into the deep red wood outer wall, and inlaid with ebony. In the center of the room is a thin metal pillar ending in a claw, which looks like it's meant to hold something. Finally, there is something that looks like an electronic eye set into the inner wall. One may leave to the northeast or southeast.

>x diamond
Maybe 2.5 carats, it's a beautiful gem, if you're into diamonds.

>put it in claw
As soon as insert the diamond into the claw, laser beams spring from five emitters on the walls. They hit the diamond and join into a single more powerful beam that strikes the electronic eye on the wall. A sound like a sliding door comes from behind Jones, and she spins around to see the red wall slide down into the floor. It exposes a control panel of sorts, featuring a large red button labeled "Press Me".

>take diamond
Taken.

>l
Galaxy Jones is in the western corner of the penthouse. The purpose of this room is unclear. Instead of the black carpet that plagues the rest of the penthouse, the floor is fashioned from a striking polished red granite. Instead of windows, there are walls. A control panel is set into the outer wall. In the center of the room is a thin metal pillar ending in a claw, which looks like it's meant to hold something. Finally, there is something that looks like an electronic eye set into the inner wall. One may leave to the northeast or southeast.

>c panel
I didn't understand that sentence.

>x panel
Jones discovers a secret panel, which when opened exposes a small black button.

>x panel
The panel features two buttons, one a large red button labeled "Press Me", and the other a small black button without a label."

>press black button
Somewhere beyond this room comes the sound of something heavy being moved.

Beck: "Why didn't you press the button that said 'Press Me'? Maybe we should press it anyway. Please?"

>press red button
Thallium's voice startles Jones, and she forgets the button for a moment.

"Yes, yes, press it!", Thallium squeaks.

>press red button
Jones presses the red button, but nothing seems to happen. After a few seconds, however, she starts to feel light-headed, and shortly after she starts to suffocate. It's not a nice way to die.

    *** Galaxy Jones was killed by poison gas. ***

In that game you scored 7 out of a possible 10, in 229 turns.

Would you like to RESTART, RESTORE a saved game, QUIT, or UNDO the last command?

>undo
Galaxy Jones is in the western corner of the penthouse.
[Previous turn undone.]

>e
The diamond-shaped penthouse bends to the northeast and southeast.

>s
The diamond-shaped penthouse bends to the northeast and southeast.

>ne
Galaxy Jones is in the northern corner of the penthouse. This is Thallium's bedroom. Apart from the expansive round bed in the center of the room, notable features include the line of dummies displaying his various suits of clothes, a large vanity table, and the complete lack of mirrors on the ceiling, thankfully. One may leave the room to the southwest, south, and southeast.

* * *

>e
Galaxy Jones is on the roof stairs. Thick slabs of marble lead from the hall to the west to the rooftop door above.

>e
Jones may go west back to the 100th floor, or up to the roof.

>u
(first opening the roof access door)
Jones opens the door and steps through onto the roof. The door crashes shut, and a lock audibly clicks.
 _________      __                     _____                     
 __/ ____/___ _/ /___ __  ____  __     __/ /___  ____  ___  _____
 _/ / __/ __ `/ / __ `/ |/ / / / /____ _/ / __ \/ __ \/ _ \/ ___/
 / /_/ / /_/ / / /_/ />  </ /_/ / _/ /_/ / /_/ / / / /  __(__  ) 
 \____/\__,_/_/\__,_/_/|_|\__, /  _\____/\____/_/ /_/\___/____/  
 _____________________________/ 

[Your score has just gone up by one point.]

Jones walks out onto the luxurious penthouse roof. Admiral Thallium turns from the railing to face her. He is dressed in an absurd elaboration of a Martian Admiral's uniform. He looks Jones up and down with a lecherous leer. "Ah, Galaxy Jones, as lovely as ever. If it weren't so unbearably cliché I'd ask you to join me in my rise to greatness. But alas, you are too habituated to the smug high of 'goodness'." He sighs dramatically. "We've trodden similar ground before; no need to discuss it further. Although I would challenge any of your various amoureux to conjugate 'tread' correctly.

"Anyway, I guess this is the time where you do something predictably undignified and violent. Before you do I feel I should inform you that your sidearm has been rendered quite ineffective by my personal security field. But do go ahead and try it."

Jones sneers. "I wouldn't give you the satisfaction," she says, looking around. "I see you don't have any of your robot pets up here. How are you going to stop me from rescuing Europa?"

"Oh please, while we're trying things, try that too. I wish you luck breaking the silnium bars of the cage."

"What's silnium?"

"A superstrong material invented here in my Martian Chemical laboratory. We had a press conference for it -- weren't you watching?"

"Couldn't be bothered."

"Oh for frotz sake, Jones, you're so frustrating!"

Thallium turns his back on Jones and stares out over the city.

Galaxy Jones is on the penthouse roof. It is an extravagant and opulent space, designed to showcase Thallium's wealth and power. Much of the rooftop is devoted to an outdoor lounge area, with comfortable seating and a fire pit, centered around a hot tub and flanked by a bar. All around is the city of New Reykjavik, and beyond that the red Martian landscape. Around the entirety of the roof is an electrostatic field designed to keep air in and particulates out. To the north is a large cage, and to the west is a landing pad. Jones can distantly see a woman lying on the floor of the cage. A green and black flyer sits on the landing pad.

Admiral Thallium is sulking.

>frotz rooftop
Although you complete the spell, nothing seems to have happened.

>frotz me
Jones is bathed in a sickly yellow light, bright enough to read by.

>frotz thallium
(Admiral Thallium)
Jones would rather not touch Thallium.

>frotz cage
Although you complete the spell, nothing seems to have happened.

>frotz cable
There is an almost blinding flash of light as the cable with hooks at either end begins to glow! It slowly fades to a less painful level, but the cable with hooks at either end is now quite usable as a light source.

>w
Thallium trails after Jones.

Um, Jones -- that harlot you're so bent on freeing from captivity is over there. Now get out of the way, I'm trying to escape."

Thallium pushes past Jones. She attempts to grab his shoulder, but she is thrown back by an unseen force.

Thallium smirks. "Personal security field, remember? Now I must be off."

Jones watches as Thallium boards the flyer. It takes off a moment later.

Galaxy Jones is on the flyer pad. This is what one would expect from a rooftop flyer pad: landing lights surrounding a large letter F painted in white on a red background. Europa's cage is to the northeast and the rest of the rooftop is to the east.

>x flyer
(Admiral Thallium's flyer)
Hovering above Jones, it's distinctly menacing. It's not visibly armed, but it conveys the impression of a beast about to strike. It's flying low, the rails of its landing gear just a few feet above Jones's head.

Thallium's flyer hovers over the rooftop. "Jones!"  he bellows. "Play time is over. I grow weary of your intransigence. In a moment this roof will be swarmed by guard robots -- of many different colors -- so many robots you couldn't possibly vandalize them all.  Say your prayers, Jones, or whatever you do when you're about to die."

Jones rolls her eyes.

A little ways off, a small red flyer aims for the rooftop and accelerates.

>ne
Thallium's flyer floats after Jones.

Galaxy Jones is next to the cage. The closely-set silnium bars seem to dash all hope of a rescue. The flyer pad is to the southwest and the rest of the rooftop to the south.

Europa Callisto is lying at the center of the cage, out of Jones's reach.

Admiral Thallium's flyer is hovering above you.

>x cage
(the cage)
The cage is huge for holding just one prisoner. The silnium bars are grey and iridescent. They run both horizontally and vertically, creating a lattice. The floor is hard and cold.

>enter cage
Jones gets onto the cage.

>l
Galaxy Jones is standing on the cage. The closely-set silnium bars seem to dash all hope of a rescue. The flyer pad is to the southwest and the rest of the rooftop to the south.

Europa Callisto is lying at the center of the cage, out of Jones's reach.

Admiral Thallium's flyer is hovering above you.

Thallium's flyer is circling you not too far away. "Give up, Jones! You'll never get through my silnium bars, haha!"

>x bars
The cage is huge for holding just one prisoner. The silnium bars are grey and iridescent. They run both horizontally and vertically, creating a lattice. The floor is hard and cold.

>x lattice
The cage is huge for holding just one prisoner. The silnium bars are grey and iridescent. They run both horizontally and vertically, creating a lattice. The floor is hard and cold.

>x floor
There's nothing like that nearby.

>x prisoner
Europa Callisto is a stunningly beautiful woman with long ice-blue hair and piercing blue eyes. Right now she's looking pretty ragged, though.

>throw cable at flyer
(Admiral Thallium's flyer)
 _________      __                     _____                     
 __/ ____/___ _/ /___ __  ____  __     __/ /___  ____  ___  _____
 _/ / __/ __ `/ / __ `/ |/ / / / /____ _/ / __ \/ __ \/ _ \/ ___/
 / /_/ / /_/ / / /_/ />  </ /_/ / _/ /_/ / /_/ / / / /  __(__  ) 
 \____/\__,_/_/\__,_/_/|_|\__, /  _\____/\____/_/ /_/\___/____/  
 _____________________________/ 

[Your score has just gone up by one point.]

Jones throws the cable up to the flyer where it hooks around the rail, and attaches the other end to the cage, then jumps off the cage to escape the aftermath. Seeing his flyer's predicament, Thallium jumps out of the craft and disappears below the edge of the roof. The flyer reaches the end of its tether and slingshots downwards, slamming into side of the building.

The cage has tilted to the side, one attachment torn loose from the rooftop. Jones crawls into the cage to see to Europa Callisto.

"Europa! Can you hear me? I need you to move to get out of this cage. I can't carry you through that small opening. Europa!"

Europa moans but doesn't show any signs of having understood Jones.

Galaxy Jones is in the cage. The whole structure is tilted, leaving a hole at the eastern end. The flyer pad is to the southwest and the rest of the rooftop to the south.

Jones is kneeling at Europa Callisto's side, trying to rouse her.

Jones tries the strength of the bars just in case. They don't budge.

The red flyer, now recognizable as Galaxy's own, settles down onto the landing pad.

>give cable to europa
There's nothing like that nearby.

>i
Jones is carrying:
  a diamond
  an Atmo-Suit
  a bottle of Electrofil quick-setting conductive polymer gel
  a screwdriver
  a black cardkey
  a full water bottle
  a drop key
  a hammer
  a red cardkey
  a fork
  a safety pin
  a black jumpsuit (being worn)
  a disruptor pistol

>give fork to europa
Europa Callisto doesn't seem interested.

Beck sticks his head out of the door of the flyer and yells "C'mon Jones, get Europa and get in the flyer!"

>x europa
Europa Callisto is a stunningly beautiful woman with long ice-blue hair and piercing blue eyes. Right now she's looking pretty ragged, though.

>x diamond
Maybe 2.5 carats, it's a beautiful gem, if you're into diamonds.

* * *

>ask beck about art
Beck: "While I normally dislike Rambutan's work, this one has a certain power to it. It's even better in thousands of tiny pieces."

>ask beck about ruin
Beck: "Might be something useful in there.

>ask beck about beck
Jones: "How're you doing, Beck?"

Beck: "I'm just happy to serve."

>ask beck about pistol
Beck: "Uh, you know what that's for, right?"

* * *

>e
Suddenly two robot guards, green and red, emerge from niches in the back wall! Jones dives behind the front desk and draws her disruptor pistol.

Jones shouts, "I'm under fire from two ugly robot things!"

Beck responds, "Monitoring your suit radar."

>undo
Galaxy Jones is in the lobby.
[Previous turn undone.]

>w
Suddenly two robot guards, green and red, emerge from niches in the back wall! Jones dives behind the front desk and draws her disruptor pistol.

Jones shouts, "I'm under fire from two ugly robot things!"

Beck responds, "Monitoring your suit radar."

>shoot robot
Jones sticks her head out from behind the desk and squeezes off a shot at the red and green guard robots. In Jones's haste it goes wide of the target.

The robots intone "Destroy Jones" in an eerie drone.

>shoot robot
A perfect shot! Yet, somehow, the robot is unscathed.

Jones: "Target seems to be absorbing disruptor fire. This will make things a little harder."

Beck: "How's it going in there?"

"Jones: "You know -- like all art, it's hit or miss."

>shoot robot
A barrage of fire from the robots prevents Jones from firing.

>shoot robot
Jones's shot hits the red and green guard robots dead on, but nothing happens, almost as if the robot had absorbed the energy.

Zip! Disruptor fire scorches a nearby couch.

>shoot art
Jones fires the disruptor into the sculpture's main support cable, snapping it. The huge crystal blob starts to sag, straining the other cables. In quick succession they break as well, and the whole installation plummets to the ground, right on top of the hapless guard robots.
 _________      __                     _____                     
 __/ ____/___ _/ /___ __  ____  __     __/ /___  ____  ___  _____
 _/ / __/ __ `/ / __ `/ |/ / / / /____ _/ / __ \/ __ \/ _ \/ ___/
 / /_/ / /_/ / / /_/ />  </ /_/ / _/ /_/ / /_/ / / / /  __(__  ) 
 \____/\__,_/_/\__,_/_/|_|\__, /  _\____/\____/_/ /_/\___/____/  
 _____________________________/ 

[Your score has just gone up by one point.]

Beck: "What was that crash? What's going on?"

Jones: "That, my friend, was what you'd call a work of art. Targets terminated."

>x art
Jones digs through the ruins and finds a cable with hooks at either end, which she takes.

>retart
I didn't understand that sentence.

>restart
Are you sure you want to restart?

* * *

>scenes
Scene 'Entire Game' playing (for 0 mins now)
(Scene monitoring now switched on. Type "scenes off" to switch it off again.)

>n
Jones approaches the Viking Building entryway, the dramatic façade towering over her.

Galaxy Jones is at the entry doorway. A glass revolving door leads into a large open space north of here. The speeder dock is to the south.

Jones peers upwards at the 100 stories of glass and steel. "What do you want to bet Thallium's got Europa all the way at the top?"

Beck: "Oh, no doubt."

>n
Jones takes a deep breath. "I'm going in."

Beck replies, "You got this, Galaxy."

Jones passes through the revolving door and into the lobby, alert to any defenses.

Galaxy Jones is in the lobby. The ground floor of the Viking Building is breathtaking. Low-G architecture means more glass and thinner supports, and the building takes advantage of that. Four walls of glass surround a central pillar in which are set the utility rooms and elevators. In between is an expanse of plants, water features, and stylish seating. Near the entryway is a front desk. A giant crystal sculpture floats above the center of the area, suspended on almost invisible cables. She may go east and west from here, north to the elevators, or south out of the building.

[Scene 'Lobby Shootout' begins]

>n
Suddenly two robot guards, green and red, emerge from niches in the back wall! Jones dives behind the front desk and draws her disruptor pistol.

Jones shouts, "I'm under fire from two ugly robot things!"

Beck responds, "Monitoring your suit radar."

>e
Trying to reach an exit would surely get Jones shot.

Jones: "I'm pinned down here!"

Zip! Disruptor fire scorches a nearby couch.

Jones: "I could use some ideas here!"

>stand up
Trying to reach an exit would surely get Jones shot.

>take note
There's nothing like that nearby.

* * *

>x desk
There's not much on the desk other than a note that says "0".

A robot fires a blistering shot into the front desk.

>take note
As soon as Jones starts to act, an energy beam zips past her head, forcing her back down behind the desk.

>shoot art
Jones fires the disruptor into the sculpture's main support cable, snapping it. The huge crystal blob starts to sag, straining the other cables. In quick succession they break as well, and the whole installation plummets to the ground, right on top of the hapless guard robots.
 _________      __                     _____                     
 __/ ____/___ _/ /___ __  ____  __     __/ /___  ____  ___  _____
 _/ / __/ __ `/ / __ `/ |/ / / / /____ _/ / __ \/ __ \/ _ \/ ___/
 / /_/ / /_/ / / /_/ />  </ /_/ / _/ /_/ / /_/ / / / /  __(__  ) 
 \____/\__,_/_/\__,_/_/|_|\__, /  _\____/\____/_/ /_/\___/____/  
 _____________________________/ 

[Your score has just gone up by one point.]

Beck: "What was that crash? What's going on?"

Jones: "That, my friend, was what you'd call a work of art. Targets terminated."

[Scene 'Lobby Shootout' ends]
[Scene 'Lobby Shootout Aftermath' begins]

>z
Jones stands around and waits.

>take art
Jones might find something useful in the mixture of sculpture and robots, but the thing as a whole is a huge mess.

>x it
Jones digs through the ruins and finds a cable with hooks at either end, which she takes.

>scenes
Scene 'Entire Game' playing (for 11 mins now)
Scene 'Lobby Shootout' ended
Scene 'Lobby Shootout Aftermath' playing (for 4 mins now)
(Scene monitoring now switched on. Type "scenes off" to switch it off again.)

>w
Jones crosses the floor carefully, disruptor pistol at the ready.

Galaxy Jones is at the southwest corner of the ground floor. A lush waterfall here contrasts with the dusty red streets of New Reykjavik beyond the glass walls. The ground floor extends north and east.

[Scene 'Lobby Shootout Aftermath' ends]
Admiral Thallium's voice booms from the ceiling. "Little Galaxy thinks she's beaten the big bad Admiral. Sorry dear, that was only a taste."

* * *

>e
Suddenly two robot guards, green and red, emerge from niches in the back wall! Jones dives behind the front desk and draws her disruptor pistol.

Jones shouts, "I'm under fire from two ugly robot things!"

Beck responds, "Monitoring your suit radar."

>w
Galaxy Jones is in the lobby. The ground floor of the Viking Building is breathtaking. Low-G architecture means more glass and thinner supports, and the building takes advantage of that. Four walls of glass surround a central pillar in which are set the utility rooms and elevators. In between is an expanse of plants, water features, and stylish seating. Near the entryway is a front desk. A giant crystal sculpture floats above the center of the area, suspended on almost invisible cables. Jones may go east and west from here, north to the elevators, or south out of the building. There are two niches in the central wall from which the guard robots emerged.

Suddenly two robot guards, green and red, emerge from niches in the back wall! She dives behind the front desk and draws her disruptor pistol.

Jones shouts, "I'm under fire from two ugly robot things!"

Beck responds, "Monitoring your suit radar."

>restart
Are you sure you want to restart?

* * *

>n
Jones approaches the Viking Building entryway, the dramatic façade towering over her.

Galaxy Jones is at the entry doorway. A glass revolving door leads into a large open space north of here. The speeder dock is to the south.

Jones peers upwards at the 100 stories of glass and steel. "What do you want to bet Thallium's got Europa all the way at the top?"

Beck: "Oh, no doubt."

>n
Jones takes a deep breath. "I'm going in."

Beck replies, "You got this, Galaxy."

Jones passes through the revolving door and into the lobby, alert to any defenses.

Galaxy Jones is in the lobby. The ground floor of the Viking Building is breathtaking. Low-G architecture means more glass and thinner supports, and the building takes advantage of that. Four walls of glass surround a central pillar in which are set the utility rooms and elevators. In between is an expanse of plants, water features, and stylish seating. Near the entryway is a front desk. A giant crystal sculpture floats above the center of the area, suspended on almost invisible cables. She may go east and west from here, north to the elevators, or south out of the building.

[Scene 'Lobby Shootout' begins]
[Scene 'Lobby Shootout' ends]
[Scene 'Lobby Shootout Aftermath' begins]

* * *

>n
Suddenly two robot guards, green and red, emerge from niches in the back wall! Jones dives behind the front desk and draws her disruptor pistol.

Jones shouts, "I'm under fire from two ugly robot things!"

Beck responds, "Monitoring your suit radar."

>l
Galaxy Jones is in the lobby. The ground floor of the Viking Building is breathtaking. Low-G architecture means more glass and thinner supports, and the building takes advantage of that. Four walls of glass surround a central pillar in which are set the utility rooms and elevators. In between is an expanse of plants, water features, and stylish seating. Near the entryway is a front desk. A giant crystal sculpture floats above the center of the area, suspended on almost invisible cables. Jones may go east and west from here, north to the elevators, or south out of the building. There are two niches in the central wall from which the guard robots emerged.

Two guard robots prowl the lobby, trying to outflank her.

>w
Trying to reach an exit would surely get Jones shot.

Jones: "I'm pinned down here!"

A robot fires a blistering shot into the front desk.

* * *

>n
Suddenly two robot guards, green and red, emerge from niches in the back wall! Jones dives behind the front desk and draws her disruptor pistol.

Jones shouts, "I'm under fire from two ugly robot things!"

Beck responds, "Monitoring your suit radar."

>s
Galaxy Jones is in the lobby. The ground floor of the Viking Building is breathtaking. Low-G architecture means more glass and thinner supports, and the building takes advantage of that. Four walls of glass surround a central pillar in which are set the utility rooms and elevators. In between is an expanse of plants, water features, and stylish seating. Near the entryway is a front desk. A giant crystal sculpture floats above the center of the area, suspended on almost invisible cables. Jones may go east and west from here, north to the elevators, or south out of the building.

>z
Jones stands around and waits.

Suddenly two robot guards, green and red, emerge from niches in the back wall! She dives behind the front desk and draws her disruptor pistol.

Jones shouts, "I'm under fire from two ugly robot things!"

Beck responds, "Monitoring your suit radar."

* * *

>n
Suddenly two robot guards, green and red, emerge from niches in the back wall! Jones dives behind the front desk and draws her disruptor pistol.

Jones shouts, "I'm under fire from two ugly robot things!"

Beck responds, "Monitoring your suit radar."

>shoot art
Jones fires the disruptor into the sculpture's main support cable, snapping it. The huge crystal blob starts to sag, straining the other cables. In quick succession they break as well, and the whole installation plummets to the ground, right on top of the hapless guard robots.
 _________      __                     _____                     
 __/ ____/___ _/ /___ __  ____  __     __/ /___  ____  ___  _____
 _/ / __/ __ `/ / __ `/ |/ / / / /____ _/ / __ \/ __ \/ _ \/ ___/
 / /_/ / /_/ / / /_/ />  </ /_/ / _/ /_/ / /_/ / / / /  __(__  ) 
 \____/\__,_/_/\__,_/_/|_|\__, /  _\____/\____/_/ /_/\___/____/  
 _____________________________/ 

[Your score has just gone up by one point.]

Beck: "What was that crash? What's going on?"

Jones: "That, my friend, was what you'd call a work of art. Targets terminated."

>n
Galaxy Jones is in the ground floor elevator hall. This hallway between the north and south ends of the ground floor is home to the elevator to the west. To the east is the entrance to a stairwell.

Admiral Thallium's voice booms from the ceiling. "Little Galaxy thinks she's beaten the big bad Admiral. Sorry dear, that was only a taste."

>n
Galaxy Jones is on the north side of the ground floor. The area is dominated by a towering statue of Admiral Thallium against the north wall. The ground floor extends west and east from here. The elevator is to the south.

>ask about admiral
(Admiral Thallium)

Beck: "Wonderful man, can't get enough of him."

>ask about statue
Beck: "We'll come back and knock it over later."

* * *

>s
Suddenly two robot guards, green and red, emerge from niches in the back wall! Jones dives behind the front desk and draws her disruptor pistol.

Jones shouts, "I'm under fire from two ugly robot things!"

Beck responds, "Monitoring your suit radar."

>e
Trying to reach an exit would surely get Jones shot.

Jones: "I'm pinned down here!"

>shoot robots
Oops! Jones misses.

The robots intone "Destroy Jones" in an eerie drone.

>shoot robots
Oof. Big miss.

>shoot robots
A barrage of fire from the robots prevents Jones from firing.

Beck: "How's it going in there?"

"Jones: "You know -- like all art, it's hit or miss."

>shoot robots
Jones sticks her head out from behind the desk and squeezes off a shot at the red and green guard robots. In Jones's haste it goes wide of the target.

One of the robots fires directly above her head.

>shoot robots
A perfect shot! Yet, somehow, the robot is unscathed.

Jones: "Target seems to be absorbing disruptor fire. This will make things a little harder."

One of the robots fires directly above Jones's head.

>shoot robots
Jones sticks her head out from behind the desk and squeezes off a shot at the red and green guard robots. In Jones's haste it goes wide of the target.

Jones: "I could use some ideas here!"

>shoot robots
Jones's shot goes wide, reflecting off one of the building struts and into the suspended sculpture. The artwork begins to spin wildly, straining its cables.

The robots intone "Destroy Jones" in an eerie drone.

>shoot robots
A perfect shot! Yet, somehow, the robot is unscathed.

The robots intone "Destroy Jones" in an eerie drone.

>shoot art
Jones fires the disruptor into the sculpture's main support cable, snapping it. The huge crystal blob starts to sag, straining the other cables. In quick succession they break as well, and the whole installation plummets to the ground, right on top of the hapless guard robots.
 _________      __                     _____                     
 __/ ____/___ _/ /___ __  ____  __     __/ /___  ____  ___  _____
 _/ / __/ __ `/ / __ `/ |/ / / / /____ _/ / __ \/ __ \/ _ \/ ___/
 / /_/ / /_/ / / /_/ />  </ /_/ / _/ /_/ / /_/ / / / /  __(__  ) 
 \____/\__,_/_/\__,_/_/|_|\__, /  _\____/\____/_/ /_/\___/____/  
 _____________________________/ 

[Your score has just gone up by one point.]

Beck: "What was that crash? What's going on?"

Jones: "That, my friend, was what you'd call a work of art. Targets terminated."

* * *

>x plants
Suddenly two robot guards, green and red, emerge from niches in the back wall! Jones dives behind the front desk and draws her disruptor pistol.

Jones shouts, "I'm under fire from two ugly robot things!"

Beck responds, "Monitoring your suit radar."

>x plants
The ground floor is huge and made for holding people comfortably. Thus the hundreds of seats amidst Earth pleasures such as water and living green plants.

A robot fires a blistering shot into the front desk.

>x water features
The ground floor is huge and made for holding people comfortably. Thus the hundreds of seats amidst Earth pleasures such as water and living green plants.

The two robots coordinate fire over the desk, narrowly missing Jones.

>x desk
There's not much on the desk other than a sticky note that says "0".

Beck: "Robot on your right!"

One robot tries to flank Jones, but a shot from her disruptor sends it scurrying back.

>take note
As soon as Jones starts to act, an energy beam zips past her head, forcing her back down behind the desk.

>fire at robot
A perfect shot! Yet, somehow, the robot is unscathed.

Jones: "Target seems to be absorbing disruptor fire. This will make things a little harder."

* * *

Would you like to play with accessibility on? (recommended for mobile)

>no
 _________      __                     _____                     
 __/ ____/___ _/ /___ __  ____  __     __/ /___  ____  ___  _____
 _/ / __/ __ `/ / __ `/ |/ / / / /____ _/ / __ \/ __ \/ _ \/ ___/
 / /_/ / /_/ / / /_/ />  </ /_/ / _/ /_/ / /_/ / / / /  __(__  ) 
 \____/\__,_/_/\__,_/_/|_|\__, /  _\____/\____/_/ /_/\___/____/  
 _____________________________/ 

An Interactive Adventure by Phil Riley
Release 3 / Serial number 230326 / Inform 7 build 6M62 (I6/v6.34 lib 6/12N) SD

A sleek dark red speeder roars into the dock of the Viking Building. A tall woman in a battle-ready jumpsuit and carrying a disruptor pistol climbs out of it: Galaxy Jones.

Galaxy Jones is in the speeder dock. A safe harbor from the periodic dust storms of Utopia Planitia, the dock features several dozen speeder bays. Only a few are filled right now. The building entryway is to the north, under a red stone façade carved into the likeness of a fearsome Viking.

Jones's speeder, Galaxy One, sits in one of the parking bays.

Jones's handler Beck comes over her headset. "Alright, what's going on?"

She replies, "I'm in the speeder dock. No movement. What can I expect inside?"

"Blueprints show the ground floor is one big empty space with elevators in the center. Not a lot of places for resistance to hide, but you can never tell. Be careful.

"And one other thing, Jones: if you need help you can ASK BECK FOR HELP. You can also ASK BECK ABOUT things or ASK BECK ABOUT GAME for more information about the game. Finally, you can cause help to repeat from the beginning by saying ASK BECK TO RESET HELP"

>gonear cage
(the cage)
Galaxy Jones is next to the cage. The closely-set silnium bars seem to dash all hope of a rescue. The flyer pad is to the southwest and the rest of the rooftop to the south.

Europa Callisto is lying at the center of the cage, out of Jones's reach.

Jones tries the strength of the bars just in case. They don't budge.

South of the cage, Thallium crosses the roof to the flyer pad, where he boards the waiting flyer. The flyer lifts off and moves towards Jones.

>purloin cable
(the cable with hooks at either end)
[Purloined.]

>up
Jones gets onto the cage.

Thallium's flyer hovers over the rooftop. "Jones!"  he bellows. "Play time is over. I grow weary of your intransigence. In a moment this roof will be swarmed by guard robots -- of many different colors -- so many robots you couldn't possibly vandalize them all.  Say your prayers, Jones, or whatever you do when you're about to die."

Jones rolls her eyes.

A little ways off, a small red flyer aims for the rooftop and accelerates.

>throw cable at flyer
(Admiral Thallium's flyer)
 _________      __                     _____                     
 __/ ____/___ _/ /___ __  ____  __     __/ /___  ____  ___  _____
 _/ / __/ __ `/ / __ `/ |/ / / / /____ _/ / __ \/ __ \/ _ \/ ___/
 / /_/ / /_/ / / /_/ />  </ /_/ / _/ /_/ / /_/ / / / /  __(__  ) 
 \____/\__,_/_/\__,_/_/|_|\__, /  _\____/\____/_/ /_/\___/____/  
 _____________________________/ 

[Your score has just gone up by one point.]

Jones throws the cable up to the flyer where it hooks around the rail, and attaches the other end to the cage, then jumps off the cage to escape the aftermath. Seeing his flyer's predicament, Thallium jumps out of the craft and disappears below the edge of the roof. The flyer reaches the end of its tether and slingshots downwards, slamming into side of the building.

The cage has tilted to the side, one attachment torn loose from the rooftop. Jones crawls into the cage to see to Europa Callisto.

"Europa! Can you hear me? I need you to move to get out of this cage. I can't carry you through that small opening. Europa!"

Europa moans but doesn't show any signs of having understood Jones.

Galaxy Jones is in the cage. The whole structure is tilted, leaving a hole at the eastern end. The flyer pad is to the southwest and the rest of the rooftop to the south.

Jones is kneeling at Europa Callisto's side, trying to rouse her.

The red flyer, now recognizable as Galaxy's own, settles down onto the landing pad.

>purloin water
(the full water bottle)
[Purloined.]

>give water to europa
    *** The End, For Now... ***

In that game you scored 2 out of a possible 10, in 4 turns.

Extensions by:
Standard Rules version 3/120430 by Graham Nelson
Deluxe Doors version 4 by Emily Short
Skeleton Keys by Emily Short
Epistemology version 9 by Eric Eve
Conversation Framework version 11 by Eric Eve
Gender Options version 3/210331 by Nathanael Nerode
Exit Lister version 11 by Eric Eve

Story by Phil Riley.
Programming by Phil Riley.
Playtesting by Leon Lin, Oliver Matthias, Jade, John Ziegler, and Kenneth Pedersen.
Invaluable inspiration from Laura Taalman.

The story, all names, characters, and incidents portrayed in this production are fictitious. No identification with actual persons (living or deceased), places, buildings, and products is intended or should be inferred.

Promotional consideration provided by Olympus Springs of Mars, Inc.

...

<Black screen>

"Jones! Jones! Wake up! I'm trying to talk to you!"

<Cut to a shot of two closed eyes>

"C'mon, open those eyes."

<The shot widens to show Galaxy Jones, the Solar System's greatest hero, flat on the floor, seemingly unconscious>

"This is getting tiresome, Jones. Stop playing dead."

Her eyes flutter open, close again, then open. She winces and brings one hand up to shield her eyes. "Who's that?" she says, hoarsely.

Join Galaxy Jones next time in Galaxy Jones II: Existential Time Crisis!
 _________      __                     _____                     
 __/ ____/___ _/ /___ __  ____  __     __/ /___  ____  ___  _____
 _/ / __/ __ `/ / __ `/ |/ / / / /____ _/ / __ \/ __ \/ _ \/ ___/
 / /_/ / /_/ / / /_/ />  </ /_/ / _/ /_/ / /_/ / / / /  __(__  ) 
 \____/\__,_/_/\__,_/_/|_|\__, /  _\____/\____/_/ /_/\___/____/  
 _____________________________/ 

Would you like to RESTART, RESTORE a saved game, QUIT, or UNDO the last command?

* * *

Would you like to play with accessibility on? (recommended for mobile)

>remove ceiling panel
There's nothing like that nearby.

>gonear tenth hall
Galaxy Jones is in the tenth floor elevator hall. The elevator car to the west stands open. There is a stairwell to the east. The hall runs north and south into a sumptuous corporate office.

* * *

>w
Galaxy Jones is in the elevator car. It's luxurious, with gold-plated walls and crystal lighting on the ceiling. The button panel is lacquered dark mahogany with what look like real ivory buttons. The carpeting is soft and plush. A golden keyhole sits above the buttons.

One of the ceiling panels looks loose.

Admiral Thallium's voice oozes from concealed speakers: "Yes, Jones, that is real ivory. I imported the elephant here myself for a hunt on my estate. You have no idea how much money it takes to simulate an African jungle on Mars. In retrospect I should have gotten an Indian elephant."

>remove panel
Jones removes the ceiling panel, exposing a hole wide enough for her to squeeze through.

>u
Galaxy Jones is on the top of the elevator car. The elevator shaft extends many hundreds of feet above her. She can see down into the elevator car from here.

* * *

Would you like to play with accessibility on? (recommended for mobile)

>remove jumpsuit
Sorry, that's mission-critical gear.

>drop it
(first taking the black jumpsuit off)
Sorry, that's mission-critical gear.

* * *

Would you like to play with accessibility on? (recommended for mobile)

>scenes
Scene 'Entire Game' playing (for 0 mins now)
(Scene monitoring now switched on. Type "scenes off" to switch it off again.)

* * *

>e
Beck: "Robot on your right!"

One robot tries to flank Jones, but a shot from her disruptor sends it scurrying back.

>z
Beck: "How's it going in there?"

"Jones: "You know -- like all art, it's hit or miss."

Suddenly two robot guards, green and red, emerge from niches in the back wall! Jones dives behind the front desk and draws her disruptor pistol.

Jones shouts, "I'm under fire from two ugly robot things!"

Beck responds, "Monitoring your suit radar."

* * *

Would you like to play with accessibility on? (recommended for mobile)

>take jumpsuit
Jones already has that.

* * *

Would you like to play with accessibility on? (recommended for mobile)

>take light
That seems to be a part of the black jumpsuit.

>x it
It automatically goes on when it gets dark. Cool.

>ask beck about admiral
(Admiral Thallium).

Beck: "Wonderful man, can't get enough of him."

>ask beck about the admiral
(Admiral Thallium).

Beck: "Wonderful man, can't get enough of him."

>n
Jones approaches the Viking Building entryway, the dramatic façade towering over her.

Galaxy Jones is at the entry doorway. A glass revolving door leads into a large open space north of here. The speeder dock is to the south.

Jones peers upwards at the 100 stories of glass and steel. "What do you want to bet Thallium's got Europa all the way at the top?"

Beck: "Oh, no doubt."

* * *

>n
Galaxy Jones is on the north side of the ground floor. The area is dominated by a towering statue of Admiral Thallium against the north wall. The ground floor extends west and east from here. The elevator is to the south.

>ask beck about admiral
(the statue of admiral thallium)
(the statue of admiral thallium).

Beck: "We'll come back and knock it over later."

>rules
Rules tracing now switched on. Type "rules off" to switch it off again, or "rules all" to include even rules which do not apply.

[Rule "reset conversed this turn rule" applies.]
[Rule "clear LPR rule" applies.]

>ask beck about admiral
[Rule "After deciding the scope of the player" applies.]
[Rule "After deciding the scope of the player" applies.]
[Rule "After deciding the scope of the player" applies.]
[Rule "After deciding the scope of the player" applies.]
[Rule "After deciding the scope of the player" applies.]
[Rule "After deciding the scope of the player" applies.]
[Rule "After deciding the scope of the player" applies.]
[Rule "After deciding the scope of the player" applies.]
[Rule "After deciding the scope of the player" applies.]
[Rule "Does the player mean doing something to beck" applies.]
[Rule "Does the player mean doing something to beck" applies.]
(the statue of admiral thallium)
[Rule "declare everything initially unmentioned rule" applies.]
[Rule "assign alternative door targets rule" applies.]
[Rule "announce items from multiple object lists rule" applies.]
[Rule "set pronouns from items from multiple object lists rule" applies.]
[Rule "before stage rule" applies.]
[Rule "Before quizzing beck about something" applies.]
(the statue of admiral thallium).

[Rule "Before doing something other than going" applies.]
[Rule "keychain-aware carrying requirements rule" applies.]
[Rule "instead stage rule" applies.]
[Rule "Instead of quizzing Beck about the statue of admiral thallium" applies.]

Beck: "We'll come back and knock it over later."

[Rule "A first turn sequence rule" applies.]
[Rule "every turn stage rule" applies.]
[Rule "Every turn when the mauve guard robot is in the tenth-floor-region and the mauve guard robot is not under attack" applies.]
[Rule "reset protocol rule" applies.]
[Rule "A last turn sequence rule" applies.]
[Rule "notify score changes rule" applies.]
[Rule "show us the people rule" applies.]
[Rule "reset conversed this turn rule" applies.]
[Rule "clear LPR rule" applies.]

* * *

Would you like to play with accessibility on? (recommended for mobile)

>w
Jones can't just leave Europa in the hands of Admiral Thallium!

>n
Jones approaches the Viking Building entryway, the dramatic façade towering over her.

Galaxy Jones is at the entry doorway. A glass revolving door leads into a large open space north of here. The speeder dock is to the south.

Jones peers upwards at the 100 stories of glass and steel. "What do you want to bet Thallium's got Europa all the way at the top?"

Beck: "Oh, no doubt."

* * *

>z
Suddenly two robot guards, green and red, emerge from niches in the back wall! Jones dives behind the front desk and draws her disruptor pistol.

Jones shouts, "I'm under fire from two ugly robot things!"

Beck responds, "Monitoring your suit radar."

>shoot art
Jones fires the disruptor into the sculpture's main support cable, snapping it. The huge crystal blob starts to sag, straining the other cables. In quick succession they break as well, and the whole installation plummets to the ground, right on top of the hapless guard robots.
 _________      __                     _____                     
 __/ ____/___ _/ /___ __  ____  __     __/ /___  ____  ___  _____
 _/ / __/ __ `/ / __ `/ |/ / / / /____ _/ / __ \/ __ \/ _ \/ ___/
 / /_/ / /_/ / / /_/ />  </ /_/ / _/ /_/ / /_/ / / / /  __(__  ) 
 \____/\__,_/_/\__,_/_/|_|\__, /  _\____/\____/_/ /_/\___/____/  
 _____________________________/ 

[Your score has just gone up by one point.]

Beck: "What was that crash? What's going on?"

Jones: "That, my friend, was what you'd call a work of art. Targets terminated."

>w
Jones crosses the floor carefully, disruptor pistol at the ready.

Galaxy Jones is at the southwest corner of the ground floor. A lush waterfall here contrasts with the dusty red streets of New Reykjavik beyond the glass walls. The ground floor extends north and east.

Admiral Thallium's voice booms from the ceiling. "Little Galaxy thinks she's beaten the big bad Admiral. Sorry dear, that was only a taste."

>n
Galaxy Jones is on the west side of the ground floor. Semicircular couches open on either side of a central carpeted path leading north and south. Set in the central pillar of the building to the east is a utility door. The city looms beyond the glass wall to the west.

* * *

>e
(first opening the utility door)
It seems to be locked.

>purloin red card
[Purloined.]

>swipe card
What should Jones swipe the red cardkey through?

>swipe lock
What should Jones swipe the swipe lock through?

>swipe card through lock
She unlocks the utility door.

>swipe card
What should Jones swipe the red cardkey through?

>lock
(the utility door)
(with the red cardkey)
She locks the utility door.

>e
(first opening the utility door)
It seems to be locked.

* * *

Would you like to play with accessibility on? (recommended for mobile)

>x jumpsuit
There seems to be nothing special about it.

>drop it
(first taking the black jumpsuit off)
Jones needs the jumpsuit to complete her mission.

>give it to beck
Beck is just a voice in Jones's ear.

* * *

Would you like to play with accessibility on? (recommended for mobile)

>x suit
(the black jumpsuit)
It's an advanced Smart Suit, able to communicate sound, vision, and radar back to Beck at Galaxy Base. Also it has a neat light.

>l
Galaxy Jones is in the speeder dock. A safe harbor from the periodic dust storms of Utopia Planitia, the dock features several dozen speeder bays. Only a few are filled right now. The building entryway is to the north, under a red stone façade carved into the likeness of a fearsome Viking.

Jones's speeder, Galaxy One, sits in one of the parking bays.

* * *

>x jumpsuit
There seems to be nothing special about it.

>take it
That seems to be a part of Jones.

* * *

>x suit
(the black jumpsuit)
It's an advanced Smart Suit, able to communicate sound, vision, and radar back to Beck at Galaxy Base. Also it has a neat light.

>x light
There seems to be nothing special about it.

* * *

Would you like to play with accessibility on? (recommended for mobile)

>x windows
(outside)
Outside the building are the red-dusted streets of New Reykjavik.

>x speeder
(the speeder)
Galaxy One is a Dust Runner, a top-of-the-line model from Olympus Speedworks. It's deep crimson with tinted windows. Powerful turbines adorn vestigial wings that sweep back in severe rearward arcs.

>x speeder windows
The tint is too dark to see through.

>n
Jones approaches the Viking Building entryway, the dramatic façade towering over her.

Galaxy Jones is at the entry doorway. A glass revolving door leads into a large open space north of here. The speeder dock is to the south.

Jones peers upwards at the 100 stories of glass and steel. "What do you want to bet Thallium's got Europa all the way at the top?"

Beck: "Oh, no doubt."

* * *

Would you like to play with accessibility on? (recommended for mobile)

>y
Galaxy Jones!
An Interactive Adventure by Phil Riley
Release 3 / Serial number 230322 / Inform 7 build 6M62 (I6/v6.34 lib 6/12N) SD

A sleek dark red speeder roars into the dock of the Viking Building. A tall woman in a battle-ready jumpsuit climbs out of it: Galaxy Jones.

Galaxy Jones is in the speeder dock. A safe harbor from the periodic dust storms of Utopia Planitia, the dock features several dozen speeder bays. Only a few are filled right now. The building entryway is to the north, under a red stone façade carved into the likeness of a fearsome Viking.

Jones's speeder, Galaxy One, sits in one of the parking bays.

Jones's handler Beck comes over her headset. "Alright, what's going on?"

She replies, "I'm in the speeder dock. No movement. What can I expect inside?"

"Blueprints show the ground floor is one big empty space with elevators in the center. Not a lot of places for resistance to hide, but you can never tell. Be careful.

"And one other thing, Jones: if you need help you can ASK BECK FOR HELP. You can also ASK BECK ABOUT things or ASK BECK ABOUT GAME for more information about the game. Finally, you can cause help to repeat from the beginning by saying ASK BECK TO RESET HELP"