>n
Galaxy Jones is on the west side of the ground floor. Semicircular couches open on either side of a central carpeted path leading north and south. Set in the central pillar of the building to the east is a utility door. The city looms beyond the glass wall to the west.

>swipe card through lock
Jones unlocks the utility door.

>e
(first opening the utility door)

Galaxy Jones is in the elevator room. This is a utility room related to the operation of the elevator, on the other side of the east wall here. There is a control panel on the wall, and a door leading west.

Hanging from a hook here is an elevator drop key.

Lying discarded on a table here is a hammer.

>undo
Galaxy Jones is on the west side of the ground floor.
[Previous turn undone.]

>undo
Galaxy Jones is on the west side of the ground floor.
[Previous turn undone.]

>unlock door with red
Jones unlocks the utility door.

>undo
Galaxy Jones is on the west side of the ground floor.
[Previous turn undone.]

>unlock door
(with the red cardkey)
Jones unlocks the utility door.

>undo
Galaxy Jones is on the west side of the ground floor.
[Previous turn undone.]

>swipe card
What should Jones swipe the red cardkey through?

>door
She unlocks the utility door.

>gonear ninth hall
Galaxy Jones is in the ninth floor elevator hall. The elevator is to the west, the stairwell is to the east, and a corridor leads north and south. There is a bottled water vending machine here.

>n
Galaxy Jones is in the ninth floor north hallway. This anonymous corporate hallway ends here at the north end of the building. An open doorway leads west. To the east is a door with a swipe lock, labeled "Cybernetica Inc."

>purloin black cardkey
[Purloined.]

>swipe black through door
Jones unlocks the Cybernetica door.

>undo
Galaxy Jones is in the ninth floor north hallway.
[Previous turn undone.]

>swipe black through lock
Jones unlocks the Cybernetica door.

>sw
There's an open doorway to the west, a door to the east, and a hall leading south.

>w
Galaxy Jones is at the north end of the building management office. The building management office is a bunch of desks and task boards. There is a particularly large desk against the west window. The office exit is to the east, and the office continues to the south.

>gonear ground hall
Galaxy Jones is in the ground floor elevator hall. This hallway between the north and south ends of the ground floor is home to the elevator to the west. To the east is the entrance to a stairwell.

>s
Galaxy Jones is in the lobby. The ground floor of the Viking Building is breathtaking. Low-G architecture means more glass and thinner supports, and the building takes advantage of that. Four walls of glass surround a central pillar in which are set the utility rooms and elevators. In between is an expanse of plants, water features, and stylish seating. Near the entryway is a front desk. Jones may go east and west from here, north to the elevators, or south out of the building. There are two niches in the central wall from which the guard robots emerged.

Spread across the floor in a tangled ruin are the remains of a giant crystal sculpture and two guard robots.

* * *

>w
Galaxy Jones is at the southwest corner of the ground floor. A lush waterfall here contrasts with the dusty red streets of New Reykjavik beyond the glass walls. The ground floor extends north and east.

>x dusty
There's nothing like that nearby.

>x lush
There's nothing like that nearby.

>x waterfall
The waterfall descends the length of an artificial rock formation fringed by wide-leaved Earth plants and ferns. The water collects in a basin at the bottom, where it begins its journey again. A single coin sits on the bottom of the basin.

Jones: "One coin? Not very generous people around here."

>x red
An anonymous red card with a magnetic stripe.

>x streets
Outside the building are the red-dusted streets of New Reykjavik.

* * *

>swipe card through lock
Jones unlocks the utility door.

>swipe
What should Jones swipe?

>keycard
There's nothing like that nearby.

>i
Jones is carrying:
  a red cardkey
  an Atmo-Suit
  a disruptor pistol

>cardkey
I didn't understand that sentence.

>swipe
What should Jones swipe?

>cardkey
What should Jones swipe the red cardkey through?

>lock
(the utility door)
That's locked at the moment.

* * *

>swipe
What should Jones swipe?

>showme jones
Jones - person
    red cardkey - cardkey
    Atmo-Suit
    disruptor pistol
location: in the west side of the ground floor
singular-named, proper-named, unused; unlit, inedible, portable, female, seen, familiar, non-pourable, dull; not-active
list grouping key: none
printed name: "yourself"
printed plural name: "people"
indefinite article: none
most recent reference: nominal
third singular pronoun: She-pronoun
conversation: none
description: "Galaxy Jones stands at the ready."
initial appearance: none
third-plural-pronoun: They-pronoun
carrying capacity: 100
first-singular-pronoun: I-pronoun
first-plural-pronoun: We-pronoun
second-singular-pronoun: Singular-you-pronoun
second-plural-pronoun: Plural-you-pronoun
notable action: doing nothing
original location: the southwest corner of the ground floor
new location: the west side of the ground floor

>showme me
Jones - person
    red cardkey - cardkey
    Atmo-Suit
    disruptor pistol
location: in the west side of the ground floor
singular-named, proper-named, unused; unlit, inedible, portable, female, seen, familiar, non-pourable, dull; not-active
list grouping key: none
printed name: "yourself"
printed plural name: "people"
indefinite article: none
most recent reference: nominal
third singular pronoun: She-pronoun
conversation: none
description: "Galaxy Jones stands at the ready."
initial appearance: none
third-plural-pronoun: They-pronoun
carrying capacity: 100
first-singular-pronoun: I-pronoun
first-plural-pronoun: We-pronoun
second-singular-pronoun: Singular-you-pronoun
second-plural-pronoun: Plural-you-pronoun
notable action: doing nothing
original location: the southwest corner of the ground floor
new location: the west side of the ground floor

>trace 5
[Parser tracing set to level 5.]

>s
[ "s" s ]
   [NounDomain called at word 1
   seeking definite object
    Trying the north (1099924) at word 1
Parse_name called
Pass 1: 0 Pass 2: 0 Pass 3: 0
    Trying the northeast (1099956) at word 1
Parse_name called
Pass 1: 0 Pass 2: 0 Pass 3: 0
    Trying the northwest (1099988) at word 1
Parse_name called
Pass 1: 0 Pass 2: 0 Pass 3: 0
    Trying the south (1100020) at word 1
Parse_name called
Pass 1: 1 Pass 2: 1 Pass 3: 1
    Matched (1)
    Trying the southeast (1100052) at word 1
Parse_name called
Pass 1: 0 Pass 2: 0 Pass 3: 0
    Trying the southwest (1100084) at word 1
Parse_name called
Pass 1: 0 Pass 2: 0 Pass 3: 0
    Trying the east (1100116) at word 1
Parse_name called
Pass 1: 0 Pass 2: 0 Pass 3: 0
    Trying the west (1100148) at word 1
Parse_name called
Pass 1: 0 Pass 2: 0 Pass 3: 0
    Trying the up (1100180) at word 1
Parse_name called
Pass 1: 0 Pass 2: 0 Pass 3: 0
    Trying the down (1100212) at word 1
Parse_name called
Pass 1: 0 Pass 2: 0 Pass 3: 0
    Trying the inside (1100244) at word 1
Parse_name called
Pass 1: 0 Pass 2: 0 Pass 3: 0
    Trying the outside (1100276) at word 1
Parse_name called
Pass 1: 0 Pass 2: 0 Pass 3: 0
    Trying Beck (1100660) at word 1
   [ND made 1 matches]

Galaxy Jones is at the southwest corner of the ground floor. A lush waterfall here contrasts with the dusty red streets of New Reykjavik beyond the glass walls. The ground floor extends north and east.

>n
[ "n" n ]
   [NounDomain called at word 1
   seeking definite object
    Trying the north (1099924) at word 1
Parse_name called
Pass 1: 1 Pass 2: 1 Pass 3: 1
    Matched (1)
    Trying the northeast (1099956) at word 1
Parse_name called
Pass 1: 0 Pass 2: 0 Pass 3: 0
    Trying the northwest (1099988) at word 1
Parse_name called
Pass 1: 0 Pass 2: 0 Pass 3: 0
    Trying the south (1100020) at word 1
Parse_name called
Pass 1: 0 Pass 2: 0 Pass 3: 0
    Trying the southeast (1100052) at word 1
Parse_name called
Pass 1: 0 Pass 2: 0 Pass 3: 0
    Trying the southwest (1100084) at word 1
Parse_name called
Pass 1: 0 Pass 2: 0 Pass 3: 0
    Trying the east (1100116) at word 1
Parse_name called
Pass 1: 0 Pass 2: 0 Pass 3: 0
    Trying the west (1100148) at word 1
Parse_name called
Pass 1: 0 Pass 2: 0 Pass 3: 0
    Trying the up (1100180) at word 1
Parse_name called
Pass 1: 0 Pass 2: 0 Pass 3: 0
    Trying the down (1100212) at word 1
Parse_name called
Pass 1: 0 Pass 2: 0 Pass 3: 0
    Trying the inside (1100244) at word 1
Parse_name called
Pass 1: 0 Pass 2: 0 Pass 3: 0
    Trying the outside (1100276) at word 1
Parse_name called
Pass 1: 0 Pass 2: 0 Pass 3: 0
    Trying Beck (1100660) at word 1
   [ND made 1 matches]

Galaxy Jones is on the west side of the ground floor. Semicircular couches open on either side of a central carpeted path leading north and south. Set in the central pillar of the building to the east is a utility door. The city looms beyond the glass wall to the west.

* * *

>swipe
What should Jones swipe?

>trace 5
[Parser tracing set to level 5.]

* * *

>purloin bottled water
[Purloined.]

>a it
Beck: "Say Jones, you could use an endorsement contract. How about Olympus Springs water?"

Jones: "Yeah, sure."

>purloin safety pin
[Purloined.]

>showme safetypin
There seems to be no such object anywhere in the model world.

>showme safety pin
safety pin - thing
location: carried by Jones in the speeder dock
singular-named, improper-named, unused; unlit, inedible, portable, handled, neuter, unseen, unfamiliar, non-pourable, dull
list grouping key: none
printed name: "safety pin"
printed plural name: none
indefinite article: none
most recent reference: nominal
third singular pronoun: It-pronoun
conversation: none
description: "A standard silver metal safety pin."
initial appearance: none
third-plural-pronoun: They-pronoun

>drop it
Dropped.

>take it
Taken.

>showme safety pin
safety pin - thing
location: carried by Jones in the speeder dock
singular-named, improper-named, unused; unlit, inedible, portable, handled, neuter, unseen, unfamiliar, non-pourable, dull
list grouping key: none
printed name: "safety pin"
printed plural name: none
indefinite article: none
most recent reference: nominal
third singular pronoun: It-pronoun
conversation: none
description: "A standard silver metal safety pin."
initial appearance: none
third-plural-pronoun: They-pronoun

>x pin
A standard silver metal safety pin.

>showme safety pin
safety pin - thing
location: carried by Jones in the speeder dock
singular-named, improper-named, unused; unlit, inedible, portable, handled, neuter, seen, familiar, examined, non-pourable, dull
list grouping key: none
printed name: "safety pin"
printed plural name: none
indefinite article: none
most recent reference: nominal
third singular pronoun: It-pronoun
conversation: none
description: "A standard silver metal safety pin."
initial appearance: none
third-plural-pronoun: They-pronoun

>a pin
Beck: "You never know when you might need something that can get in a very small space."

* * *

>purloin bottled water
[Purloined.]

>a water
There is no reply.

>actions
Actions listing on.

>a water
[implicit-quizzing the full water bottle]
[(1) quizzing Beck about the full water bottle]
There is no reply.
[(1) quizzing Beck about the full water bottle - failed the block asking about something unknown rule]

[implicit-quizzing the full water bottle - failed the block asking about something unknown rule]

>rules
Rules tracing now switched on. Type "rules off" to switch it off again, or "rules all" to include even rules which do not apply.

[Rule "reset conversed this turn rule" applies.]
[Rule "clear LPR rule" applies.]

>a water
[Rule "declare everything initially unmentioned rule" applies.]
[Rule "assign alternative door targets rule" applies.]
[implicit-quizzing the full water bottle]
[Rule "announce items from multiple object lists rule" applies.]
[Rule "set pronouns from items from multiple object lists rule" applies.]
[Rule "before stage rule" applies.]
[Rule "After deciding the scope of the player" applies.]
[Rule "After deciding the scope of the player" applies.]
[Rule "After deciding the scope of the player" applies.]
[Rule "Before doing something other than going" applies.]
[Rule "keychain-aware carrying requirements rule" applies.]
[Rule "instead stage rule" applies.]
[Rule "Instead of implicit-quizzing" applies.]
[Rule "assign alternative door targets rule" applies.]
[(1) quizzing Beck about the full water bottle]
[Rule "announce items from multiple object lists rule" applies.]
[Rule "set pronouns from items from multiple object lists rule" applies.]
[Rule "before stage rule" applies.]
[Rule "Before doing something other than going" applies.]
[Rule "keychain-aware carrying requirements rule" applies.]
[Rule "instead stage rule" applies.]
[Rule "investigate player's awareness before action rule" applies.]
[Rule "player aware of his own actions rule" applies.]
[Rule "check stage rule" applies.]
[Rule "block asking about something unknown rule" applies.]
[Rule "block asking rule" applies.]
There is no reply.
[(1) quizzing Beck about the full water bottle - failed the block asking about something unknown rule]

[implicit-quizzing the full water bottle - failed the block asking about something unknown rule]

[Rule "A first turn sequence rule" applies.]
[Rule "every turn stage rule" applies.]
[Rule "Every turn when the mauve guard robot is in the tenth-floor-region and the mauve guard robot is not under attack" applies.]
[Rule "reset protocol rule" applies.]
[Rule "A last turn sequence rule" applies.]
[Rule "notify score changes rule" applies.]
[Rule "show us the people rule" applies.]
[Rule "reset conversed this turn rule" applies.]
[Rule "clear LPR rule" applies.]

>purloin gel
Which do you mean, the bottle of Electrofil quick-setting conductive polymer gel or the untakable bottle?

>quick-setting
Which do you mean, the bottle of Electrofil quick-setting conductive polymer gel or the untakable bottle?

>both
[Rule "declare everything initially unmentioned rule" applies.]
[Rule "assign alternative door targets rule" applies.]
[Purloined.]
[Rule "assign alternative door targets rule" applies.]
[Purloined.]

[Rule "reset conversed this turn rule" applies.]
[Rule "clear LPR rule" applies.]

>drop untakable
[Rule "After deciding the scope of the player" applies.]
[Rule "After deciding the scope of the player" applies.]
[Rule "After deciding the scope of the player" applies.]
[Rule "After deciding the scope of the player" applies.]
[Rule "After deciding the scope of the player" applies.]
[Rule "After deciding the scope of the player" applies.]
[Rule "After deciding the scope of the player" applies.]
[Rule "After deciding the scope of the player" applies.]
[Rule "After deciding the scope of the player" applies.]
[Rule "After deciding the scope of the player" applies.]
[Rule "After deciding the scope of the player" applies.]
[Rule "After deciding the scope of the player" applies.]
There's nothing like that nearby.
[Rule "clear LPR rule" applies.]

>i
[Rule "declare everything initially unmentioned rule" applies.]
[Rule "assign alternative door targets rule" applies.]
[taking inventory]
[Rule "announce items from multiple object lists rule" applies.]
[Rule "set pronouns from items from multiple object lists rule" applies.]
[Rule "before stage rule" applies.]
[Rule "Before doing something other than going" applies.]
[Rule "keychain-aware carrying requirements rule" applies.]
[Rule "instead stage rule" applies.]
[Rule "investigate player's awareness before action rule" applies.]
[Rule "player aware of his own actions rule" applies.]
[Rule "check stage rule" applies.]
[Rule "carry out stage rule" applies.]
[Rule "print empty inventory rule" applies.]
[Rule "print standard inventory rule" applies.]
Jones is carrying:
  an untakable bottle
  a bottle of Electrofil quick-setting conductive polymer gel
  a full water bottle
  a disruptor pistol
[Rule "after stage rule" applies.]

[Rule "investigate player's awareness after action rule" applies.]
[Rule "report stage rule" applies.]
[Rule "report other people taking inventory rule" applies.]
[Rule "last specific action-processing rule" applies.]
[taking inventory - succeeded]

[Rule "A first turn sequence rule" applies.]
[Rule "every turn stage rule" applies.]
[Rule "Every turn when the mauve guard robot is in the tenth-floor-region and the mauve guard robot is not under attack" applies.]
[Rule "reset protocol rule" applies.]
[Rule "A last turn sequence rule" applies.]
[Rule "notify score changes rule" applies.]
[Rule "show us the people rule" applies.]
[Rule "reset conversed this turn rule" applies.]
[Rule "clear LPR rule" applies.]

>a gel
[Rule "declare everything initially unmentioned rule" applies.]
[Rule "assign alternative door targets rule" applies.]
[implicit-quizzing the bottle of Electrofil quick-setting conductive polymer gel]
[Rule "announce items from multiple object lists rule" applies.]
[Rule "set pronouns from items from multiple object lists rule" applies.]
[Rule "before stage rule" applies.]
[Rule "After deciding the scope of the player" applies.]
[Rule "After deciding the scope of the player" applies.]
[Rule "After deciding the scope of the player" applies.]
[Rule "Before doing something other than going" applies.]
[Rule "keychain-aware carrying requirements rule" applies.]
[Rule "instead stage rule" applies.]
[Rule "Instead of implicit-quizzing" applies.]
[Rule "assign alternative door targets rule" applies.]
[(1) quizzing Beck about the bottle of Electrofil quick-setting conductive polymer gel]
[Rule "announce items from multiple object lists rule" applies.]
[Rule "set pronouns from items from multiple object lists rule" applies.]
[Rule "before stage rule" applies.]
[Rule "Before doing something other than going" applies.]
[Rule "keychain-aware carrying requirements rule" applies.]
[Rule "instead stage rule" applies.]
[Rule "investigate player's awareness before action rule" applies.]
[Rule "player aware of his own actions rule" applies.]
[Rule "check stage rule" applies.]
[Rule "block asking about something unknown rule" applies.]
[Rule "block asking rule" applies.]
There is no reply.
[(1) quizzing Beck about the bottle of Electrofil quick-setting conductive polymer gel - failed the block asking about something unknown rule]

[implicit-quizzing the bottle of Electrofil quick-setting conductive polymer gel - failed the block asking about something unknown rule]

[Rule "A first turn sequence rule" applies.]
[Rule "every turn stage rule" applies.]
[Rule "Every turn when the mauve guard robot is in the tenth-floor-region and the mauve guard robot is not under attack" applies.]
[Rule "reset protocol rule" applies.]
[Rule "A last turn sequence rule" applies.]
[Rule "notify score changes rule" applies.]
[Rule "show us the people rule" applies.]
[Rule "reset conversed this turn rule" applies.]
[Rule "clear LPR rule" applies.]

>showme ge
There seems to be no such object anywhere in the model world.
[Rule "clear LPR rule" applies.]

>showme gel
Which do you mean, the bottle of Electrofil quick-setting conductive polymer gel or the untakable bottle?

I beg your pardon?

>n
I only understood you as far as wanting to showme north.
[Rule "clear LPR rule" applies.]

>drop untakable bottle
[Rule "After deciding the scope of the player" applies.]
[Rule "After deciding the scope of the player" applies.]
[Rule "After deciding the scope of the player" applies.]
[Rule "After deciding the scope of the player" applies.]
[Rule "After deciding the scope of the player" applies.]
[Rule "After deciding the scope of the player" applies.]
[Rule "After deciding the scope of the player" applies.]
[Rule "After deciding the scope of the player" applies.]
[Rule "After deciding the scope of the player" applies.]
[Rule "After deciding the scope of the player" applies.]
[Rule "After deciding the scope of the player" applies.]
[Rule "After deciding the scope of the player" applies.]
There's nothing like that nearby.
[Rule "clear LPR rule" applies.]

>i
[Rule "declare everything initially unmentioned rule" applies.]
[Rule "assign alternative door targets rule" applies.]
[taking inventory]
[Rule "announce items from multiple object lists rule" applies.]
[Rule "set pronouns from items from multiple object lists rule" applies.]
[Rule "before stage rule" applies.]
[Rule "Before doing something other than going" applies.]
[Rule "keychain-aware carrying requirements rule" applies.]
[Rule "instead stage rule" applies.]
[Rule "investigate player's awareness before action rule" applies.]
[Rule "player aware of his own actions rule" applies.]
[Rule "check stage rule" applies.]
[Rule "carry out stage rule" applies.]
[Rule "print empty inventory rule" applies.]
[Rule "print standard inventory rule" applies.]
Jones is carrying:
  an untakable bottle
  a bottle of Electrofil quick-setting conductive polymer gel
  a full water bottle
  a disruptor pistol
[Rule "after stage rule" applies.]

[Rule "investigate player's awareness after action rule" applies.]
[Rule "report stage rule" applies.]
[Rule "report other people taking inventory rule" applies.]
[Rule "last specific action-processing rule" applies.]
[taking inventory - succeeded]

[Rule "A first turn sequence rule" applies.]
[Rule "every turn stage rule" applies.]
[Rule "Every turn when the mauve guard robot is in the tenth-floor-region and the mauve guard robot is not under attack" applies.]
[Rule "reset protocol rule" applies.]
[Rule "A last turn sequence rule" applies.]
[Rule "notify score changes rule" applies.]
[Rule "show us the people rule" applies.]
[Rule "reset conversed this turn rule" applies.]
[Rule "clear LPR rule" applies.]

>s
[Rule "After deciding the scope of the player" applies.]
[Rule "After deciding the scope of the player" applies.]
[Rule "After deciding the scope of the player" applies.]
[Rule "declare everything initially unmentioned rule" applies.]
[Rule "standard set going variables rule" applies.]
[Rule "assign alternative door targets rule" applies.]
[going south]
[Rule "announce items from multiple object lists rule" applies.]
[Rule "set pronouns from items from multiple object lists rule" applies.]
[Rule "before stage rule" applies.]
[Rule "keychain-aware carrying requirements rule" applies.]
[Rule "instead stage rule" applies.]
[Rule "Instead of going nowhere" applies.]
Jones can't just leave Europa in the hands of Admiral Thallium!

[going south - failed]

[Rule "A first turn sequence rule" applies.]
[Rule "every turn stage rule" applies.]
[Rule "Every turn when the mauve guard robot is in the tenth-floor-region and the mauve guard robot is not under attack" applies.]
[Rule "reset protocol rule" applies.]
[Rule "A last turn sequence rule" applies.]
[Rule "notify score changes rule" applies.]
[Rule "show us the people rule" applies.]
[Rule "reset conversed this turn rule" applies.]
[Rule "clear LPR rule" applies.]

>a water
[Rule "declare everything initially unmentioned rule" applies.]
[Rule "assign alternative door targets rule" applies.]
[implicit-quizzing the full water bottle]
[Rule "announce items from multiple object lists rule" applies.]
[Rule "set pronouns from items from multiple object lists rule" applies.]
[Rule "before stage rule" applies.]
[Rule "After deciding the scope of the player" applies.]
[Rule "After deciding the scope of the player" applies.]
[Rule "After deciding the scope of the player" applies.]
[Rule "Before doing something other than going" applies.]
[Rule "keychain-aware carrying requirements rule" applies.]
[Rule "instead stage rule" applies.]
[Rule "Instead of implicit-quizzing" applies.]
[Rule "assign alternative door targets rule" applies.]
[(1) quizzing Beck about the full water bottle]
[Rule "announce items from multiple object lists rule" applies.]
[Rule "set pronouns from items from multiple object lists rule" applies.]
[Rule "before stage rule" applies.]
[Rule "Before doing something other than going" applies.]
[Rule "keychain-aware carrying requirements rule" applies.]
[Rule "instead stage rule" applies.]
[Rule "investigate player's awareness before action rule" applies.]
[Rule "player aware of his own actions rule" applies.]
[Rule "check stage rule" applies.]
[Rule "block asking about something unknown rule" applies.]
[Rule "block asking rule" applies.]
There is no reply.
[(1) quizzing Beck about the full water bottle - failed the block asking about something unknown rule]

[implicit-quizzing the full water bottle - failed the block asking about something unknown rule]

[Rule "A first turn sequence rule" applies.]
[Rule "every turn stage rule" applies.]
[Rule "Every turn when the mauve guard robot is in the tenth-floor-region and the mauve guard robot is not under attack" applies.]
[Rule "reset protocol rule" applies.]
[Rule "A last turn sequence rule" applies.]
[Rule "notify score changes rule" applies.]
[Rule "show us the people rule" applies.]
[Rule "reset conversed this turn rule" applies.]
[Rule "clear LPR rule" applies.]

* * *

>purloin safety pin
[Purloined.]

>a pin
Beck: "You never know when you might need something that can get in a very small space."

* * *

>purloin water bottle
[Purloined.]

>a beck about bottke
Beck: "I'm not sure what you're asking about, Jones."

>a beck about bottle
Beck: "I'm not sure what you're asking about, Jones."

>drop it
Dropped.

* * *

>take it
Taken.

>a beck about bottle
Beck: "I'm not sure what you're asking about, Jones."

>a about bottle
Beck: "I'm not sure what you're asking about, Jones."

>a bottle
(the full water bottle)
There is no reply.

>a speeder
Beck: "I keep reminding you, but you still haven't taken it in for yearly maintenance."

>a bays
Beck: "Hmm. Don't have much to say about that right now."

>actions
Actions listing on.

>a bottle
(the full water bottle)
[implicit-quizzing the full water bottle]
[(1) quizzing Beck about the full water bottle]
There is no reply.
[(1) quizzing Beck about the full water bottle - failed the block asking about something unknown rule]

[implicit-quizzing the full water bottle - failed the block asking about something unknown rule]

* * *

>s
Galaxy Jones is in the ninth floor south hallway. This anonymous corporate hallway ends here at the south end of the building. An open doorway leads west. To the east is a door with a swipe lock, labeled "Martian Chemical."

* * *

>ask for help
Beck: "What? You don't have a shrimp tea sandwich? Didn't you examine the catering table on the ground floor. Time to go back there."

>ask about black
Beck: "I'll adopt it."

"Jones: "After it damn near took off my hand?"

>ask about black cardkey
Beck: "I'm not sure what you're asking about, Jones."

>i
Jones is carrying:
  a coin
  a hammer
  an elevator drop key
  a safety pin
  a garish medal
  a shrimp tea sandwich
  a fork
  a red cardkey
  an Atmo-Suit
  a cable with hooks at either end
  a disruptor pistol

>purloin black cardkey
[Purloined.]

>ask about black cardkey
Beck: "Hmm. Don't have much to say about that right now."

>e
Galaxy Jones is in the ninth floor south hallway. This anonymous corporate hallway ends here at the south end of the building. An open doorway leads west. To the east is a door with a swipe lock, labeled "Martian Chemical."

* * *

>n
Galaxy Jones is in the ninth floor north hallway. This anonymous corporate hallway ends here at the north end of the building. An open doorway leads west. To the east is a door with a swipe lock, labeled "Cybernetica Inc."

>ask about swipe
Beck: "I'm not sure what you're asking about, Jones."

>ask about door
Beck: "Oh, they make the best games!"

>w
Galaxy Jones is at the north end of the building management office. The building management office is a bunch of desks and task boards. There is a particularly large desk against the west window. The office exit is to the east, and the office continues to the south.

>ask about door
Beck: "I'm not sure what you're asking about, Jones."

>e
Galaxy Jones is in the ninth floor north hallway. This anonymous corporate hallway ends here at the north end of the building. An open doorway leads west. To the east is a door with a swipe lock, labeled "Cybernetica Inc."

>e
(first opening the Cybernetica door)
(first unlocking the Cybernetica door)
(with the black cardkey)

Galaxy Jones is in the Cybernetica office. It's spacious and luxurious, designed to make developers forget how spent they are from months of overwork and abuse. Ergonomic desks and chairs fill space like a furniture fractal, before giving way to an open area, presumably for group activities.

As soon as Jones steps into the office, a shot zaps just past her nose. She dives to the ground, protected by the maze of desks and chairs. Peeking through the mesh back of one of the chairs, she takes notice of both the purple guard robot training its disruptor on the room, and the chair's fine construction and lumbar support.

Jones (whispering): "We've got another one! I'm out of sight for now, but it's going to be hard to get a shot off at this 'bot."

Beck: "What's the situation?"

Jones: "I'm on the floor with desks and chairs all around. The target is a few yards off, coming this way. I might get a shot in, but it might just absorb it anyway."

Beck: "Well, see if you can sneak up on it. Maybe close up you can find a way past its defenses."

>ask about robot
(the guard robots)

Beck: "Hmm. Don't have much to say about that right now."

>ask about purple robot
Beck: "Just can't get a reliable guard robot these days."

* * *

>take screwdriver
Jones reaches behind the cabinet to retrieve the screwdriver. A swipe and a hiss make her recoil.

Jones: "Holy --!"

Beck: "What now?"

Jones: "There's a cat here! Behind a filing cabinet. Gotta get behind there to get a screwdriver, so I need a way to drive off the cat."

>ask for help
Beck: "If you haven't yet, get the screwdriver."