>gonear air
(the air handling room)
Galaxy Jones is in the air handling room. There is a good amount of loud fans and other air handling machinery here. A small hinged vent opening leads into some ductwork, and from there to the outside. A door leads west.

>e
The scaffold is not at this floor.

>enter vent
The scaffold is not at this floor.

>go near 100th
There's nothing like that nearby.

>gonear 100th
Galaxy Jones is in the 100th floor elevator hall. The luxury is staggering.  The walls are made of polished black marble, and the floors are covered in plush black carpeting that muffles the sound of footsteps. The ceiling is high and adorned with a crystal chandelier. The elevator doors to the west are gold-plated. The roof stairs, themselves of gleaming white marble, are to the east. Sumptuous living quarters are visible to the north and south.

>w
Galaxy Jones is in the placeholder room.

>d
Jones can't go that way. The only obvious exit is east (to the 100th floor elevator hall).

* * *

>gonear cybernetica office
Galaxy Jones is in the Cybernetica office. It's spacious and luxurious, designed to make developers forget how spent they are from months of overwork and abuse. Ergonomic desks and chairs fill space like a furniture fractal, before giving way to an open area, presumably for group activities. At the south end of the room is a door labeled "Inspiration Chamber".

As soon as Jones steps into the office, a shot zaps just past her nose. She dives to the ground, protected by the maze of desks and chairs. Peeking through the mesh back of one of the chairs, she takes notice of both the purple guard robot training its disruptor on the room, and the chair's fine construction and lumbar support.

Jones (whispering): "We've got another one! I'm out of sight for now, but it's going to be hard to get a shot off at this 'bot."

Beck: "What's the situation?"

Jones: "I'm on the floor with desks and chairs all around. The target is a few yards off, coming this way. I might get a shot in, but it might just absorb it anyway."

Beck: "Well, see if you can sneak up on it. Maybe close up you can find a way past its defenses."

>sneak up on robot
Jones creeps a little ways toward the guard robot.

* * *

>e
The atmosphere is too thin out there. Jones needs protective gear.

>purloin atmo-suit
[Purloined.]

>e
Jones: "I'm going out the window to see if I can find a way to get up to the tenth floor."

Beck: "Whoa whoa whoa, Jones. You know you're not good with heights."

Jones: "Ask Thallium how how much that matters once I've kicked his ass. Watch me, I'll look down and not even flinch."

(first donning the Atmo-Suit)
Galaxy Jones is on a ledge. She's plastered up against the wall, trying not to look down.

>d
Jones can't go that way. The obvious exits are west (to the cybernetica office) and inside (to the cybernetica office).

>w
Galaxy Jones is in the Cybernetica office. It's spacious and luxurious, designed to make developers forget how spent they are from months of overwork and abuse. Ergonomic desks and chairs fill space like a furniture fractal, before giving way to an open area, presumably for group activities. At the south end of the room is a door labeled "Inspiration Chamber". One of the windows along the east side of the office is broken.

The remains of the purple guard robot are sprawled on the ground.

Jones doffs the Atmo-Suit.

>e
(first donning the Atmo-Suit)
Galaxy Jones is on a ledge. She's plastered up against the wall, trying not to look down.

>look down
Jones is afraid of heights.

* * *

>look down
Really, really afraid of heights.

>look down
Okay, fine. Jones look down, slowly, slowly... and there's a window cleaner's scaffold, about six feet below her.

Jones: "Okay, so. There's a window washing platform right below me. I might be able to drop down to it, but I won't be able to get back up."

Beck: "Take it easy, Jones."

* * *

>d
Jones drops off the ledge onto the scaffold. It rocks unnervingly for a moment.

Galaxy Jones is on a window washing scaffold. It's lined up with the eighth floor window. There doesn't seem to be any way to get into the building here. Mounted on the scaffold is a control panel with two buttons: one indicating up and one indicating down.

>w
None of the windows here are open.

>e
Jones can't go that way. The obvious exits are west and inside.

>press up
(the scaffold up button)
Jones presses the button, and the scaffold begins to rise.

Galaxy Jones is on a window washing scaffold. It's lined up with the ninth floor window. She could climb back into the building through the window here. Mounted on the scaffold is a control panel with two buttons: one indicating up and one indicating down.

Jones: "Beck?"

Beck: "Yes?"

Jones: "I hate it out here."

Beck: "Well, there's the open window right next to you."

>w
Galaxy Jones is in the Cybernetica office. It's spacious and luxurious, designed to make developers forget how spent they are from months of overwork and abuse. Ergonomic desks and chairs fill space like a furniture fractal, before giving way to an open area, presumably for group activities. At the south end of the room is a door labeled "Inspiration Chamber". One of the windows along the east side of the office is broken.

The remains of the purple guard robot are sprawled on the ground.

>e
Galaxy Jones is on a window washing scaffold. It's lined up with the ninth floor window. Jones could climb back into the building through the window here. Mounted on the scaffold is a control panel with two buttons: one indicating up and one indicating down.

>in
Galaxy Jones is in the Cybernetica office. It's spacious and luxurious, designed to make developers forget how spent they are from months of overwork and abuse. Ergonomic desks and chairs fill space like a furniture fractal, before giving way to an open area, presumably for group activities. At the south end of the room is a door labeled "Inspiration Chamber". One of the windows along the east side of the office is broken.

The remains of the purple guard robot are sprawled on the ground.

>out
Galaxy Jones is on a window washing scaffold. It's lined up with the ninth floor window. Jones could climb back into the building through the window here. Mounted on the scaffold is a control panel with two buttons: one indicating up and one indicating down.

>press up
(the scaffold up button)
Jones presses the button, and the scaffold begins to rise.

Galaxy Jones is on a window washing scaffold. It's lined up with the tenth floor. Instead of a window, there's what appears to be an exhaust vent. If it's for forced air, though, the fan is currently not running. Mounted on the scaffold is a control panel with two buttons: one indicating up and one indicating down.

Jones: "Alright, I'm by the tenth floor now. What's this grill thing here?"

Beck: "That's an exhaust vent. There's an air handling room on this floor which it leads into. If you can get the cover off you should be able to access the whole floor from here."

>w
That's not something Jones can enter.

>purloin screwdriver
[Purloined.]

>open vent
Jones loosens the screws with the screwdriver and removes the grill from the vent.

>gonear cybernetica
(the Cybernetica office)
Galaxy Jones is in the Cybernetica office. It's spacious and luxurious, designed to make developers forget how spent they are from months of overwork and abuse. Ergonomic desks and chairs fill space like a furniture fractal, before giving way to an open area, presumably for group activities. At the south end of the room is a door labeled "Inspiration Chamber". One of the windows along the east side of the office is broken.

The remains of the purple guard robot are sprawled on the ground.

>e
Galaxy Jones is on a ledge. She's plastered up against the wall, trying not to look down.

>d
Galaxy Jones is on a window washing scaffold. It's lined up with the tenth floor. Instead of a window, there's what appears to be an exhaust vent. If it's for forced air, though, the fan is currently not running. Mounted on the scaffold is a control panel with two buttons: one indicating up and one indicating down.

* * *

>open vent
Jones loosens the screws with the screwdriver and removes the grill from the vent.

>press down
(the scaffold down button)
Jones presses the button, and the scaffold begins to descend.

Galaxy Jones is on a window washing scaffold. It's lined up with the ninth floor window. She could climb back into the building through the window here. Mounted on the scaffold is a control panel with two buttons: one indicating up and one indicating down.

>x vent
There's nothing like that nearby.

>w
Galaxy Jones is in the Cybernetica office. It's spacious and luxurious, designed to make developers forget how spent they are from months of overwork and abuse. Ergonomic desks and chairs fill space like a furniture fractal, before giving way to an open area, presumably for group activities. At the south end of the room is a door labeled "Inspiration Chamber". One of the windows along the east side of the office is broken.

The remains of the purple guard robot are sprawled on the ground.

* * *

>e
Galaxy Jones is on a window washing scaffold. It's lined up with the ninth floor window. Jones could climb back into the building through the window here. Mounted on the scaffold is a control panel with two buttons: one indicating up and one indicating down.

>gonear air
(the air handling room)
Galaxy Jones is in the air handling room. There is a good amount of loud fans and other air handling machinery here. A small hinged vent opening leads into some ductwork, and from there to the outside. A door leads west.

>e
Jones can't go that way. The obvious exits are west and inside (to the window washing scaffold).

>in
(first opening the vent access door)
The scaffold is not at this floor

>out
But Jones isn't in anything at the moment.

* * *

>n
Jones approaches the Viking Building entryway, the dramatic façade towering over her.

Galaxy Jones is at the entry doorway. A glass revolving door leads into a large open space north of here. The speeder dock is to the south.

Jones peers upwards at the 100 stories of glass and steel. "What do you want to bet Thallium's got Europa all the way at the top?"

Beck: "Oh, no doubt."

>n
Jones takes a deep breath. "I'm going in."

Beck replies, "You got this, Galaxy."

Jones passes through the revolving door and into the lobby, alert to any defenses.

Galaxy Jones is in the lobby. The ground floor of the Viking Building is breathtaking. Low-G architecture means more glass and thinner supports, and the building takes advantage of that. Four walls of glass surround a central pillar in which are set the utility rooms and elevators. In between is an expanse of plants, water installations, and stylish seating. Near the entryway is a front desk. A giant crystal sculpture floats above it, suspended on almost invisible cables. She may go east and west from here, north to the elevators, or south out of the building.

>z
Before Jones gets a chance to do anything, two robot guards, green and red, emerge from niches in the back wall! She dives behind the front desk and draws her disruptor pistol.

Jones shouts, "I'm under fire from two ugly robot things!"

Beck responds, "Monitoring your suit radar."

>shoot art
Jones fires the disruptor into the sculpture's main support cable, snapping it. The huge crystal blob starts to sag, straining the other cables. In quick succession they break as well, and the whole installation plummets to the ground, right on top of the hapless guard robots.
 _________      __                     _____                     
 __/ ____/___ _/ /___ __  ____  __     __/ /___  ____  ___  _____
 _/ / __/ __ `/ / __ `/ |/ / / / /____ _/ / __ \/ __ \/ _ \/ ___/
 / /_/ / /_/ / / /_/ />  </ /_/ / _/ /_/ / /_/ / / / /  __(__  ) 
 \____/\__,_/_/\__,_/_/|_|\__, /  _\____/\____/_/ /_/\___/____/  
 _____________________________/ 

[Your score has just gone up by one point.]

Beck: "What was that crash? What's going on?"

Jones: "That, my friend, was what you'd call a work of art. Targets terminated."

* * *

>take coin
Taken.

>e
Galaxy Jones is in the lobby. The ground floor of the Viking Building is breathtaking. Low-G architecture means more glass and thinner supports, and the building takes advantage of that. Four walls of glass surround a central pillar in which are set the utility rooms and elevators. In between is an expanse of plants, water installations, and stylish seating. Near the entryway is a front desk. Jones may go east and west from here, north to the elevators, or south out of the building. There are two niches in the central wall from which the guard robots emerged.

Spread across the floor in a tangled ruin are the remains of a giant crystal sculpture and two guard robots.

>e
Jones crosses the floor carefully, disruptor pistol at the ready.

Galaxy Jones is at the southeast corner of the ground floor. The centerpiece of this area is the actual Viking 2 lander, which landed right here on Utopia Planitia. The glass walls look out onto the city. She can go north or west from here.

>n
Galaxy Jones is on the east side of the ground floor. Apparently some kind of function was happening here before Admiral Thallium emptied the building, for there is an array of canapes on a catering table here. The floor stretches north and south, and there's a closet door to the west.

>x table
The table is covered with a wide array of treats from the ridiculously expensive, such as shrimp tea sandwiches (where do you get shrimp on Mars?), to the just plain ridiculous, like poached ostrich eggs in jelly. A good number of forks are laid out to one side.

Jones: "Well, at least the Admiral treats his guests right. Except me. And Europa."

>take all
fork: Taken.
shrimp tea sandwich: Taken.
poached ostrich eggs in jelly: Don't even.

>type 0
(on the keypad)
An indicator light glows green.

Jones: "I've unlocked the east side utility door."

>w
(first opening the closet door)

Galaxy Jones is in the maintenance closet. 

There is an Atmo-Suit hanging from a hook here.

On the shelf is a red cardkey.

>take all
Atmo-Suit: Taken.
red cardkey: Taken.

* * *

>e
Galaxy Jones is on the east side of the ground floor. Apparently some kind of function was happening here before Admiral Thallium emptied the building, for there is an array of canapes on a catering table here. The floor stretches north and south, and there's a closet door to the west.

>n
Galaxy Jones is at the northeast corner of the ground floor. The area is dedicated to celebrating the military career of Admiral Thallium. Uniforms, medals, ribbons, and other miscellanea are mounted on the wall or in showcases. All this despite the fact that no one has turned up any evidence that Thallium served in any navy of any country on any planet. One can escape to the west or south.

>x medal
Jones yawns looking over the assortment of faux honors. They're all behind glass, but one of the display cases is partly open, leaving the rather garish medal inside unprotected.

>take medal
(the garish medal)
Taken.

* * *

>take pin
Taken.

>s
Galaxy Jones is on the east side of the ground floor. Apparently some kind of function was happening here before Admiral Thallium emptied the building, for there is an array of canapes on a catering table here. The floor stretches north and south, and there's a closet door to the west.

* * *

>s
Galaxy Jones is at the southeast corner of the ground floor. The centerpiece of this area is the actual Viking 2 lander, which landed right here on Utopia Planitia. The glass walls look out onto the city. Jones can go north or west from here.

>w
Galaxy Jones is in the lobby. The ground floor of the Viking Building is breathtaking. Low-G architecture means more glass and thinner supports, and the building takes advantage of that. Four walls of glass surround a central pillar in which are set the utility rooms and elevators. In between is an expanse of plants, water installations, and stylish seating. Near the entryway is a front desk. Jones may go east and west from here, north to the elevators, or south out of the building. There are two niches in the central wall from which the guard robots emerged.

Spread across the floor in a tangled ruin are the remains of a giant crystal sculpture and two guard robots.

>x art
Jones digs through the ruins and finds a cable with hooks at either end, which she takes.

>w
Galaxy Jones is at the southwest corner of the ground floor. A lush waterfall here contrasts with the dusty red streets of New Reykjavik beyond the glass walls. The ground floor extends north and east.

* * *

>n
Galaxy Jones is in the ground floor elevator hall. This hallway between the north and south ends of the ground floor is home to the elevator to the west. To the east is the entrance to a stairwell.

>use drop key
(the elevator drop key)
Jones inserts the elevator drop key into the drop key hole and turns it, disengaging the lock mechanism. Then she slides the door open.

>w
Jones climbs into the elevator shaft

Galaxy Jones is in the ground floor elevator shaft. She is at the bottom of a dark well. Shining her suit light up, she can see that the elevator car is several floors up, unmoving. There is a ladder running up the wall next to the door.

>u
Galaxy Jones is in the second floor elevator shaft. The door here is closed.

>u
Galaxy Jones is in the third floor elevator shaft. The door here is closed.

>u
Galaxy Jones is in the fourth floor elevator shaft. The door here is closed.

>u
Galaxy Jones is in the fifth floor elevator shaft. The door here is closed.

>u
Galaxy Jones is in the sixth floor elevator shaft. The door here is closed.

>u
Galaxy Jones is in the seventh floor elevator shaft. The door here is closed.

>u
Galaxy Jones is in the eighth floor elevator shaft. The door here is closed.

>u
Galaxy Jones is in the ninth floor elevator shaft. The door here is closed.

>e
(first opening the ninth floor elevator door)
 _________      __                     _____                     
 __/ ____/___ _/ /___ __  ____  __     __/ /___  ____  ___  _____
 _/ / __/ __ `/ / __ `/ |/ / / / /____ _/ / __ \/ __ \/ _ \/ ___/
 / /_/ / /_/ / / /_/ />  </ /_/ / _/ /_/ / /_/ / / / /  __(__  ) 
 \____/\__,_/_/\__,_/_/|_|\__, /  _\____/\____/_/ /_/\___/____/  
 _____________________________/ 

[Your score has just gone up by one point.]

Jones: "Finally out of the shaft. That was quite a climb."

Beck: "This floor is just offices. Check the building management office to the west. It might have some useful stuff."

Galaxy Jones is in the ninth floor elevator hall. The elevator is to the west, the stairwell is to the east, and a corridor leads north and south. There is a bottled water vending machine here.

>buy water
What should Jones buy the full water bottle with?

>coin
She inserts the coin in the machine and takes the bottle that appears a few seconds later.

>n
Galaxy Jones is in the ninth floor north hallway. This anonymous corporate hallway ends here at the north end of the building. An open doorway leads west. To the east is a door labeled "Cybernetica Inc."

* * *

>w
Galaxy Jones is at the north end of the building management office. The building management office is a bunch of desks and task boards. There is a particularly large desk against the west window. The office exit is to the east, and the office continues to the south.

>x desk
It's a pretty utilitarian desk of some plastic material. It has a single drawer with a lock.

>pick desk lock with pin
Jones pushes the pin into the keyhole and wiggles it around. After a few seconds of this the desk drawer pops open. It contains a black cardkey.

>take card key
(the black cardkey)
Taken.

>s
Galaxy Jones is at the south end of the building management office. The building management office is a bunch of desks and task boards. There is a filing cabinet against the east wall. The office exit is to the east, and the office continues to the north.

A screwdriver sits atop the filing cabinet.

>take screwdriver
Jones reaches for the screwdriver, but she fumbles it and it rolls off the back of the filing cabinet.

Jones: "Damn."

Beck: "What? What's going on?"

Jones: "Just being clumsy is all."

* * *

>look behind cabinet
(taking the screwdriver)
Jones reaches behind the cabinet to retrieve the screwdriver. A swipe and a hiss make her recoil.

Jones: "Holy --!"

Beck: "What now?"

Jones: "There's a cat here! Behind a filing cabinet. Gotta get behind there to get a screwdriver, so I need a way to drive off the cat."

>drop shrim[
There's nothing like that nearby.

>drop shrimp
Sensing food, the black cat pokes its head out, grabs the shrimp in its jaws, and races off.

 _________      __                     _____                     
 __/ ____/___ _/ /___ __  ____  __     __/ /___  ____  ___  _____
 _/ / __/ __ `/ / __ `/ |/ / / / /____ _/ / __ \/ __ \/ _ \/ ___/
 / /_/ / /_/ / / /_/ />  </ /_/ / _/ /_/ / /_/ / / / /  __(__  ) 
 \____/\__,_/_/\__,_/_/|_|\__, /  _\____/\____/_/ /_/\___/____/  
 _____________________________/ 

[Your score has just gone up by one point.]

Jones: "Aha! No creature is too fearsome for Galaxy Jones!"

Beck: "Congratulations on your victory."

>e
Galaxy Jones is in the ninth floor south hallway. This anonymous corporate hallway ends here at the south end of the building. An open doorway leads west. To the east is a door labeled "Martian Chemical"

>e
(first opening the Martian Chemical door)
(first unlocking the Martian Chemical door)
(with the black cardkey)

Galaxy Jones is in the Martian Chemical office. This seems like the business office of the chemical company rather than the lab. Most of the room is taken up by desks and other office stuff. There is a cabinet that looks intriguing, however.

>look in cabinet
In the chemical cabinet is a bottle of Electrofil quick-setting conductive polymer gel.

>take gel
Taken.

>w
Galaxy Jones is in the ninth floor south hallway. This anonymous corporate hallway ends here at the south end of the building. An open doorway leads west. To the east is a door labeled "Martian Chemical"

>n
Galaxy Jones is in the ninth floor elevator hall. The elevator is to the west, the stairwell is to the east, and a corridor leads north and south. There is a bottled water vending machine here.

* * *

>e
As soon as Jones enters the stairwell, a disruptor blast from above zings past her shoulder, and she beats a hasty retreat. She won't be going up the stairs until she can clear out the resistance, and she can't do that from here.

Galaxy Jones is in the ninth floor elevator hall. The elevator is to the west, the stairwell is to the east, and a corridor leads north and south. There is a bottled water vending machine here.

>n
Galaxy Jones is in the ninth floor north hallway. This anonymous corporate hallway ends here at the north end of the building. An open doorway leads west. To the east is a door labeled "Cybernetica Inc."

>e
(first opening the Cybernetica door)
(first unlocking the Cybernetica door)
(with the black cardkey)

Galaxy Jones is in the Cybernetica office. It's spacious and luxurious, designed to make developers forget how spent they are from months of overwork and abuse. Ergonomic desks and chairs fill space like a furniture fractal, before giving way to an open area, presumably for group activities. At the south end of the room is a door labeled "Inspiration Chamber".

As soon as Jones steps into the office, a shot zaps just past her nose. She dives to the ground, protected by the maze of desks and chairs. Peeking through the mesh back of one of the chairs, she takes notice of both the purple guard robot training its disruptor on the room, and the chair's fine construction and lumbar support.

Jones (whispering): "We've got another one! I'm out of sight for now, but it's going to be hard to get a shot off at this 'bot."

Beck: "What's the situation?"

Jones: "I'm on the floor with desks and chairs all around. The target is a few yards off, coming this way. I might get a shot in, but it might just absorb it anyway."

Beck: "Well, see if you can sneak up on it. Maybe close up you can find a way past its defenses."

>sneak up on robot
Jones creeps a little ways toward the guard robot.

>g
Slowly, slowly, Jones gets a little closer. Just a little more...

She must have poked up her shoulder or something, for the guard robot fires his disruptor. The shot takes out a window on the east side of the room. The electrostatic field around the building keeps the atmosphere from pouring out.

>g
Jones is right up next to the robot, crouched beneath a desk. She'll never get a better shot.

>shoot robot
Jones aims the pistol upward under the robot's enhanced armor and fires. She flinches back when the robot's innards explode downward in a shower of sparks. It topples over, dead.

 _________      __                     _____                     
 __/ ____/___ _/ /___ __  ____  __     __/ /___  ____  ___  _____
 _/ / __/ __ `/ / __ `/ |/ / / / /____ _/ / __ \/ __ \/ _ \/ ___/
 / /_/ / /_/ / / /_/ />  </ /_/ / _/ /_/ / /_/ / / / /  __(__  ) 
 \____/\__,_/_/\__,_/_/|_|\__, /  _\____/\____/_/ /_/\___/____/  
 _____________________________/ 

[Your score has just gone up by one point.]

Jones: "Better than a video game. "

Beck: "Nice, but don't forget to credit your handler."

Jones: "Yes, yes, thanks for helping me not get killed."

Beck: "You're welcome."

>e
Jones: "I'm going out the window to see if I can find a way to get up to the tenth floor."

Beck: "Whoa whoa whoa, Jones. You know you're not good with heights."

Jones: "Ask Thallium how how much that matters once I've kicked his ass."

(first donning the Atmo-Suit)
Jones needs to be able to move around quickly. Better not wear the Atmo-Suit.

She can't go outside without an atmo-suit.

>look down
There's nothing in that direction.

* * *

>wear suit
Variable unavailable for this action, activity or rulebook: internal ID number 20007/1
Jones needs to be able to move around quickly. Better not wear the Atmo-Suit.

>e
Jones: "I'm going out the window to see if I can find a way to get up to the tenth floor."

Beck: "Whoa whoa whoa, Jones. You know you're not good with heights."

Jones: "Ask Thallium how how much that matters once I've kicked his ass. Watch me, I'll look down and not even flinch."

(first donning the Atmo-Suit)
Galaxy Jones is on a ledge. She's plastered up against the wall, trying not to look down.

>look down
Jones is afraid of heights.

* * *

>d
Jones drops off the ledge onto the scaffold. It rocks unnervingly for a moment.

Galaxy Jones is on a window washing scaffold. It's lined up with the eighth floor window. There doesn't seem to be any way to get into the building here. Mounted on the scaffold is a control panel with two buttons: one indicating up and one indicating down.

>press up
(the scaffold up button)
Jones presses the button, and the scaffold begins to rise.

Galaxy Jones is on a window washing scaffold. It's lined up with the ninth floor window. She could climb back into the building through the window here. Mounted on the scaffold is a control panel with two buttons: one indicating up and one indicating down.

Jones: "Beck?"

Beck: "Yes?"

Jones: "I hate it out here."

Beck: "Well, there's the open window right next to you."

>press up
(the scaffold up button)
Jones presses the button, and the scaffold begins to rise.

Galaxy Jones is on a window washing scaffold. It's lined up with the tenth floor. Instead of a window, there's what appears to be an exhaust vent. If it's for forced air, though, the fan is currently not running. Mounted on the scaffold is a control panel with two buttons: one indicating up and one indicating down.

Jones: "Alright, I'm by the tenth floor now. What's this grill thing here?"

Beck: "That's an exhaust vent. There's an air handling room on this floor which it leads into. If you can get the cover off you should be able to access the whole floor from here."

* * *

>w
That's not something Jones can enter.

>unscrew vent
You must supply a second noun.

>with the screwdriver
That's not a verb I recognise.

>unscrew vent with screwdriver
There's nothing like that nearby.

>open vent
Jones can't reach into the south end of the building management office.

>remove screws
(the exhaust vent)
Jones doesn't have anything to remove the screws with.

>remove screws with screwdriver
There's nothing like that nearby.

>purloin screwdriver
[Purloined.]

>remove screws with screwdriver
Jones loosens the screws with the screwdriver and removes the grill from the vent.

>open vent
Jones loosens the screws with the screwdriver and removes the grill from the vent.

>open vent with screwdriver
Jones loosens the screws with the screwdriver and removes the grill from the vent.

>w
Jones climbs inside the vent, crawls along a short length of duct work, and emerges through another, hinged grill, into the air handling room.
 _________      __                     _____                     
 __/ ____/___ _/ /___ __  ____  __     __/ /___  ____  ___  _____
 _/ / __/ __ `/ / __ `/ |/ / / / /____ _/ / __ \/ __ \/ _ \/ ___/
 / /_/ / /_/ / / /_/ />  </ /_/ / _/ /_/ / /_/ / / / /  __(__  ) 
 \____/\__,_/_/\__,_/_/|_|\__, /  _\____/\____/_/ /_/\___/____/  
 _____________________________/ 

[Your score has just gone up by one point.]

Galaxy Jones is in the air handling room. There is a good amount of loud fans and other air handling machinery here. A small hinged vent opening leads into some ductwork, and from there to the outside. A door leads west.

She takes off the Atmo-Suit.

Jones: "Ha! I'm in!"

Beck: "Be careful, you're likely to run into more resistance here. The floor is all one open office, so any guard robots will have good line of sight."

Jones: "Got it."

Beck: "And Jones? Save your game."

>in
(first donning the Atmo-Suit)
(first opening the vent access door)

Galaxy Jones is on a window washing scaffold. It's lined up with the tenth floor. Instead of a window, there's what appears to be an exhaust vent. If it's for forced air, though, the fan is currently not running. Mounted on the scaffold is a control panel with two buttons: one indicating up and one indicating down.

>w
Jones climbs inside the vent, crawls along a short length of duct work, and emerges through another, hinged grill, into the air handling room.

Galaxy Jones is in the air handling room. There is a good amount of loud fans and other air handling machinery here. A small hinged vent opening leads into some ductwork. A door leads west.

She takes off the Atmo-Suit.

>e
Jones can't go that way. The obvious exits are west and inside (to the window washing scaffold).

>in
(first donning the Atmo-Suit)

Galaxy Jones is on a window washing scaffold. It's lined up with the tenth floor. Instead of a window, there's what appears to be an exhaust vent. If it's for forced air, though, the fan is currently not running. Mounted on the scaffold is a control panel with two buttons: one indicating up and one indicating down.

>w
Jones climbs inside the vent, crawls along a short length of duct work, and emerges through another, hinged grill, into the air handling room.

Galaxy Jones is in the air handling room. There is a good amount of loud fans and other air handling machinery here. A small hinged vent opening leads into some ductwork. A door leads west.

She takes off the Atmo-Suit.

* * *

>w
(first opening the air handling door)

Galaxy Jones is on the north side of the Consolidated Microthings office. This is the company cafeteria. The elevator is south, the air handling room is to the east, and the office continues to the west and southeast.

* * *

>s
Galaxy Jones is in the tenth floor elevator hall. The elevator car to the west stands open. There is a stairwell to the east. The hall runs north and south into a sumptuous corporate office.

>w
Galaxy Jones is in the elevator car. It's luxurious, with gold-plated walls and crystal lighting on the ceiling. The button panel is lacquered dark mahogany with what looks like real ivory buttons. The carpeting is soft and plush. A golden keyhole sits above the buttons.

One of the ceiling panels looks loose.

>w
Jones can't go that way. The obvious exits are east (to the tenth floor elevator hall) and up.

>open panel
Jones removes the ceiling panel, exposing a hole wide enough for her to climb through.

>e
Galaxy Jones is in the tenth floor elevator hall. The elevator car to the west stands open. There is a stairwell to the east. The hall runs north and south into a sumptuous corporate office.

* * *

>w
Galaxy Jones is in the elevator car. It's luxurious, with gold-plated walls and crystal lighting on the ceiling. The button panel is lacquered dark mahogany with what looks like real ivory buttons. The carpeting is soft and plush. A golden keyhole sits above the buttons.

The mauve guard robot appears to the east, coming from the south.

>u
Galaxy Jones is on the top of the elevator car. The elevator shaft extends many hundreds of feet above here. You can see down into the elevator car from here.

The mauve guard robot enters the elevator car below.

>jump on robot
Jones drops down through the ceiling and on to the guard robot. It swings around looking for her, obviously panicked that it can't bring its gun to bear on its attacker. Jones manages to hang on.

The mauve guard robot struggles against her hold on it, to no avail.

>pour gel on robot
Jones pours the gel into the vent on the robot's head. The robot flails around wildly and throws her from its back, then lets out a loud crackling sound and stops moving.
 _________      __                     _____                     
 __/ ____/___ _/ /___ __  ____  __     __/ /___  ____  ___  _____
 _/ / __/ __ `/ / __ `/ |/ / / / /____ _/ / __ \/ __ \/ _ \/ ___/
 / /_/ / /_/ / / /_/ />  </ /_/ / _/ /_/ / /_/ / / / /  __(__  ) 
 \____/\__,_/_/\__,_/_/|_|\__, /  _\____/\____/_/ /_/\___/____/  
 _____________________________/ 

[Your score has just gone up by one point.]

Galaxy Jones is in the elevator car. It's luxurious, with gold-plated walls and crystal lighting on the ceiling. The button panel is lacquered dark mahogany with what looks like real ivory buttons. The carpeting is soft and plush. A golden keyhole sits above the buttons.

The remains of the mauve guard robot are sprawled on the ground.

>e
Galaxy Jones is in the tenth floor elevator hall. The elevator car to the west stands open. There is a stairwell to the east. The hall runs north and south into a sumptuous corporate office.

* * *

>w
Galaxy Jones is in the elevator car. It's luxurious, with gold-plated walls and crystal lighting on the ceiling. The button panel is lacquered dark mahogany with what looks like real ivory buttons. The carpeting is soft and plush. A golden keyhole sits above the buttons.

The remains of the mauve guard robot are sprawled on the ground.

>put key in keyhole
Which do you mean, the golden key, the black cardkey, the elevator drop key, or the red cardkey?

>golden
Jones puts the key in the keyhold and turns. There is a pleasant chime, and some buttons light up.

Galaxy Jones is in the elevator car. It's luxurious, with gold-plated walls and crystal lighting on the ceiling. The button panel is lacquered dark mahogany with what looks like real ivory buttons. The carpeting is soft and plush. A golden key rests in a golden keyhole above the buttons. The buttons 1, 9, 10, and 100 are illuminated.

The remains of the mauve guard robot are sprawled on the ground.

Admiral Thallium's voice oozes from concealed speakers: "Yes, Jones, that is real ivory. I imported the elephant here myself for a hunt on my estate. You have no idea how much money it takes to simulate an African jungle on Mars. In retrospect I should have gotten an Indian elephant."

>press 100
Describe a fast elevator ride all the way to the top.
The doors open. You're on floor 100.

>e
Galaxy Jones is in the 100th floor elevator hall. The luxury is staggering.  The walls are made of polished black marble, and the floors are covered in plush black carpeting that muffles the sound of footsteps. The ceiling is high and adorned with a crystal chandelier. The elevator doors to the west are gold-plated. The roof stairs, themselves of gleaming white marble, are to the east. Sumptuous living quarters are visible to the north and south.

>n
Galaxy Jones is in the northern corner of the penthouse. This is Thallium's bedroom. Apart from the expansive round bed in the center of the room, notable features include the line of dummies displaying his various suits of clothes, a large vanity table, and the complete lack of mirrors on the ceiling, thankfully. One may leave the room to the southwest, south, and southeast.

>s
Galaxy Jones is in the 100th floor elevator hall. The luxury is staggering.  The walls are made of polished black marble, and the floors are covered in plush black carpeting that muffles the sound of footsteps. The ceiling is high and adorned with a crystal chandelier. The elevator doors to the west are gold-plated. The roof stairs, themselves of gleaming white marble, are to the east. Sumptuous living quarters are visible to the north and south.

>s
Thallium seems to speak from all around you. "You like diamonds, Jones? Of course you do -- they're a girl's best friend, after all."

Jones snorts, "Sure, Thallium."

>smash diamonds with hammer
Jones commences to smash all of the diamonds. After destroying several dozen fraudulent gems, she finds one that won't break. She takes the real diamond.

Thallium: "Wow, clever solution. Be careful you don't cut yourself."

Jones: "I appreciate your concern."

>w
Jones can't go that way. The obvious exits are north (to the 100th floor elevator hall), northeast and northwest.

>nw
Galaxy Jones is in the western corner of the penthouse. The purpose of this room is unclear. Instead of the black carpet that plagues the rest of the penthouse, the floor is fashioned from a striking polished red granite. Instead of windows, there are walls. Thallium's personal insignia, the nine planets in order overlaid with the motto "Planetas Vincam", is carved into the deep red wood outer wall, and inlaid with ebony. In the center of the room is a thin metal pillar ending in a claw, which looks like it's meant to hold something. Finally, there is something that looks like an electronic eye set into the inner wall. One may leave to the northeast or southeast.

>put gem in claw
As soon as insert the real diamond into the claw, laser beams spring from five emitters on the walls. They hit the diamond and join into a single more powerful beam that strikes the electronic eye on the wall. A sound like a sliding door comes from behind Jones, and she spins around to see the red wall slide down into the floor. It exposes a control panel of sorts, featuring a large red button labeled "Press Me".

* * *

>x panel
Jones discovers a secret panel, which when opened exposes a small black button.

>press button
Which do you mean, the small black button or the large red button?

>black
An audible click sounds from somewhere beyond this room.

>ne
Galaxy Jones is in the northern corner of the penthouse. This is Thallium's bedroom. Apart from the expansive round bed in the center of the room, notable features include the line of dummies displaying his various suits of clothes, a large vanity table, and the complete lack of mirrors on the ceiling, thankfully. One may leave the room to the southwest, south, and southeast.

>s
Galaxy Jones is in the 100th floor elevator hall. The luxury is staggering.  The walls are made of polished black marble, and the floors are covered in plush black carpeting that muffles the sound of footsteps. The ceiling is high and adorned with a crystal chandelier. The elevator doors to the west are gold-plated. The roof stairs, themselves of gleaming white marble, are to the east. Sumptuous living quarters are visible to the north and south.

>e
Galaxy Jones is on the roof stairs.

>u
(first opening the roof access door)
 _________      __                     _____                     
 __/ ____/___ _/ /___ __  ____  __     __/ /___  ____  ___  _____
 _/ / __/ __ `/ / __ `/ |/ / / / /____ _/ / __ \/ __ \/ _ \/ ___/
 / /_/ / /_/ / / /_/ />  </ /_/ / _/ /_/ / /_/ / / / /  __(__  ) 
 \____/\__,_/_/\__,_/_/|_|\__, /  _\____/\____/_/ /_/\___/____/  
 _____________________________/ 

[Your score has just gone up by one point.]

Jones opens the door and steps through onto the roof. The door crashes shut, and a lock audibly clicks.

Jones walks out onto the luxurious penthouse roof. Admiral Thallium turns from the railing to face her. He is dressed in an absurd elaboration of a Martian Admiral's uniform. He looks Jones up and down with a lecherous leer. "Ah, Galaxy Jones, as lovely as ever. If it weren't so unbearably cliché I'd ask you to join me in my rise to greatness. But alas, you are too habituated to the smug high of 'goodness'." He sighs dramatically. "We've trodden similar ground before; no need to discuss it further. Although I would challenge any of your various amoureux to conjugate 'tread' correctly.

"Anyway, I guess this is the time where you do something predictably undignified and violent. Before you do I feel I should inform you that your sidearm has been rendered quite ineffective by my personal security field. But do go ahead and try it."

Jones sneers. "I wouldn't give you the satisfaction," she says, looking around. "I see you don't have any of your robot pets up here. How are you going to stop me from rescuing Europa?"

"Oh please, while we're trying things, try that too. I wish you luck breaking the silnium bars of the cage."

"What's silnium?"

"A superstrong material invented here in my Martian Chemical laboratory. We had a press conference for it -- weren't you watching?"

"Couldn't be bothered."

"Oh for frotz sake, Jones, you're so frustrating!"

Thallium turns his back on Jones and stares out over the city.

Galaxy Jones is on the penthouse roof. It is an extravagant and opulent space, designed to showcase Thallium's wealth and power. Much of the rooftop is devoted to an outdoor lounge area, with comfortable seating and a fire pit, centered around a hot tub and flanked by a bar. All around is the city of New Reykjavik, and beyond that the red Martian landscape. Around the entirety of the roof is an electrostatic field designed to keep air in and particulates out. To the north is a large cage, and to the west is a landing pad. Jones can distantly see a woman lying on the floor of the cage. A green and black flyer sits on the landing pad.

Admiral Thallium is sulking.

>n
Galaxy Jones is next to the cage. The closely-set silnium bars seem to dash all hope of a rescue.

Europa Callisto is lying at the center of the cage, out of Jones's reach.

Jones tries the strength of the bars just in case. They don't budge.

South of the cage, Thallium crosses the roof to the flyer pad, where he boards the waiting flyer. The flyer lifts off and moves towards Jones.

>climb cage
Jones gets onto the cage.

Thallium's flyer hovers over the rooftop. "Jones!"  he bellows. "Play time is over. I grow weary of your intransigence. In a moment this roof will be swarmed by guard robots -- of many different colors -- so many robots you couldn't possibly vandalize them all.  Say your prayers, Jones, or whatever you do when you're about to die."

Jones rolls her eyes.

A little ways off, a small red flyer aims for the rooftop and accelerates.

>throw cable at flyer
Jones throws the cable up to the flyer where it hooks around the rail, and attaches the other end to the cage, then jumps off the cage to escape the aftermath. Seeing his flyer's predicament, Thallium jumps through the door and disappears below the edge of the roof. The flyer reaches the end of its tether and slingshots downwards, slamming into side of the building.

The cage has tilted to the side, one attachment torn loose from the rooftop. Jones crawls into the cage to see to Europa Callisto.

"Europa! Can you hear me? I need you to move to get out of this cage. I can't carry you through that small opening. Europa!"

Europa moans but doesn't show any signs of having understood Jones.

Galaxy Jones is in the cage. The whole structure is tilted, leaving a hole at the eastern end.

Jones is kneeling at Europa Callisto's side, trying to rouse her.

The red flyer, now recognizable as Galaxy's own, settles down onto the landing pad.

>give water to europa
Jones opens the water bottle and brings it to Europa's lips. Even with closed eyes she drinks, first slowly and then with renewed vigor, until her eyes open.

"Ga- Galaxy Jones?" she says.

Jones nods, but says "We'll have time for introductions later. We have to get out of here before the roof is full of killer robots. Can you crawl? If you can get through that hole I can carry you the rest of the way."

Europa nods. "I think so."

Galaxy Jones helps her through the hole in the cage, then gently picks her up and jogs toward the waiting flyer. Beck's familiar face appears at the door of the aircraft, urging her on.

Not so far away, Admiral Thallium crawls back over the edge of  the roof. As he pulls himself up, he aims a pistol at Jones's back...

...and she falls sprawling on the landing pad, Europa Callisto tumbling from her arms. Beck is by Callisto's side in a moment, lifting her and carrying her into the flyer.

And then the robots swarm the roof like a mechanical rainbow tide. By the time Beck returns to the door it is already too late. A group of robots surrounds Jones, while another robot carries Thallium triumphantly. Beck has no choice but to take off, leaving Jones behind, not knowing if she still lives...

    *** The End, For Now... ***

In that game you scored 7 out of a possible 0, in 122 turns.

Extensions by:
Standard Rules version 3/120430 by Graham Nelson
Deluxe Doors version 4 by Emily Short
Skeleton Keys by Emily Short
Epistemology version 9 by Eric Eve
Exit Lister version 11 by Eric Eve
Gender Options version 3/210331 by Nathanael Nerode

Story by Phil Riley.
Programming by Phil Riley.
Playtesting by Leo Lin and Oliver Matthias.
Invaluable inspiration from Laura Taalman.

The story, all names, characters, and incidents portrayed in this production are fictitious. No identification with actual persons (living or deceased), places, buildings, and products is intended or should be inferred.

Promotional consideration provided by Olympus Springs Inc.

...

<Black screen>

"Jones! Jones! Wake up! I'm trying to talk to you!"

<Cut to a shot of two closed eyes>

"C'mon, open those eyes."

<The shot widens to show Galaxy Jones, the Solar System's greatest hero, flat on the floor, seemingly unconscious>

"This is getting tiresome, Jones. Stop playing dead."

Her eyes flutter open, close again, then open. She winces and brings one hand up to shield her eyes. "Who's that?" she says, hoarsely.

Join Galaxy Jones next time in Galaxy Jones II: Existential Time Crisis!
 _________      __                     _____                     
 __/ ____/___ _/ /___ __  ____  __     __/ /___  ____  ___  _____
 _/ / __/ __ `/ / __ `/ |/ / / / /____ _/ / __ \/ __ \/ _ \/ ___/
 / /_/ / /_/ / / /_/ />  </ /_/ / _/ /_/ / /_/ / / / /  __(__  ) 
 \____/\__,_/_/\__,_/_/|_|\__, /  _\____/\____/_/ /_/\___/____/  
 _____________________________/ 

Would you like to RESTART, RESTORE a saved game, QUIT, or UNDO the last command?

* * *

>press 100
Describe a fast elevator ride all the way to the top.
The doors open. You're on floor 100.

>w
Jones can't go that way. The obvious exits are east (to the tenth floor elevator hall) and up (to the top of the elevator car).

>l
Galaxy Jones is in the elevator car. It's luxurious, with gold-plated walls and crystal lighting on the ceiling. The button panel is lacquered dark mahogany with what looks like real ivory buttons. The carpeting is soft and plush. A golden key rests in a golden keyhole above the buttons. The buttons 1, 9, 10, and 100 are illuminated.

The remains of the mauve guard robot are sprawled on the ground.

>e
Galaxy Jones is in the 100th floor elevator hall. The luxury is staggering.  The walls are made of polished black marble, and the floors are covered in plush black carpeting that muffles the sound of footsteps. The ceiling is high and adorned with a crystal chandelier. The elevator doors to the west are gold-plated. The roof stairs, themselves of gleaming white marble, are to the east. Sumptuous living quarters are visible to the north and south.

>w
Galaxy Jones is in the elevator car. It's luxurious, with gold-plated walls and crystal lighting on the ceiling. The button panel is lacquered dark mahogany with what looks like real ivory buttons. The carpeting is soft and plush. A golden key rests in a golden keyhole above the buttons. The buttons 1, 9, 10, and 100 are illuminated.

The remains of the mauve guard robot are sprawled on the ground.

>gonear ninth hall
Galaxy Jones is in the ninth floor elevator hall. The elevator is to the west, the stairwell is to the east, and a corridor leads north and south. There is a bottled water vending machine here.

>w
(first opening the ninth floor elevator door)
The elevator is not at this floor.

>gonear 100th
Galaxy Jones is in the 100th floor elevator hall. The luxury is staggering.  The walls are made of polished black marble, and the floors are covered in plush black carpeting that muffles the sound of footsteps. The ceiling is high and adorned with a crystal chandelier. The elevator doors to the west are gold-plated. The roof stairs, themselves of gleaming white marble, are to the east. Sumptuous living quarters are visible to the north and south.

>w
Galaxy Jones is in the elevator car. It's luxurious, with gold-plated walls and crystal lighting on the ceiling. The button panel is lacquered dark mahogany with what looks like real ivory buttons. The carpeting is soft and plush. A golden key rests in a golden keyhole above the buttons. The buttons 1, 9, 10, and 100 are illuminated.

The remains of the mauve guard robot are sprawled on the ground.

* * *

>x viking
The entryway is dominated by the towering façade of a Viking king, namesake of the building itself.

>n
Jones approaches the Viking Building entryway, the dramatic façade towering over her.

Galaxy Jones is at the entry doorway. A glass revolving door leads into a large open space north of here. The speeder dock is to the south.

Jones peers upwards at the 100 stories of glass and steel. "What do you want to bet Thallium's got Europa all the way at the top?"

Beck: "Oh, no doubt."

* * *

>e
Before Jones gets a chance to do anything, two robot guards, green and red, emerge from niches in the back wall! She dives behind the front desk and draws her disruptor pistol.

Jones shouts, "I'm under fire from two ugly robot things!"

Beck responds, "Monitoring your suit radar."

>l
Galaxy Jones is in the lobby. The ground floor of the Viking Building is breathtaking. Low-G architecture means more glass and thinner supports, and the building takes advantage of that. Four walls of glass surround a central pillar in which are set the utility rooms and elevators. In between is an expanse of plants, water installations, and stylish seating. Near the entryway is a front desk. A giant crystal sculpture floats above it, suspended on almost invisible cables. Jones may go east and west from here, north to the elevators, or south out of the building. There are two niches in the central wall from which the guard robots emerged.

Two guard robots prowl the lobby, trying to outflank her.

Beck: "Robot on your right!"

One robot tries to flank her, but a shot from her disruptor sends it scurrying back.

>i
Jones is carrying:
  a disruptor pistol

The two robots coordinate fire over the desk, narrowly missing her.

>fire at robot
Oops! Jones misses.

Zip! Disruptor fire scorches a nearby couch.

>fire at robot
A barrage of fire from the robots prevents Jones from firing.

The robots intone "Destroy Jones" in an eerie drone.

>fire at robot
Oof. Big miss.

Beck: "How's it going in there?"

"Jones: "You know -- like all art, it's hit or miss."

>shoot sculpture
Jones fires the disruptor into the sculpture's main support cable, snapping it. The huge crystal blob starts to sag, straining the other cables. In quick succession they break as well, and the whole installation plummets to the ground, right on top of the hapless guard robots.
 _________      __                     _____                     
 __/ ____/___ _/ /___ __  ____  __     __/ /___  ____  ___  _____
 _/ / __/ __ `/ / __ `/ |/ / / / /____ _/ / __ \/ __ \/ _ \/ ___/
 / /_/ / /_/ / / /_/ />  </ /_/ / _/ /_/ / /_/ / / / /  __(__  ) 
 \____/\__,_/_/\__,_/_/|_|\__, /  _\____/\____/_/ /_/\___/____/  
 _____________________________/ 

[Your score has just gone up by one point.]

Beck: "What was that crash? What's going on?"

Jones: "That, my friend, was what you'd call a work of art. Targets terminated."

>e
Jones crosses the floor carefully, disruptor pistol at the ready.

Galaxy Jones is at the southeast corner of the ground floor. The centerpiece of this area is the actual Viking 2 lander, which landed right here on Utopia Planitia. The glass walls look out onto the city. She can go north or west from here.

>x lander
The lander is such a big, ungainly object it's hard to imagine it was once a pinnacle of human achievement.

>w
Galaxy Jones is in the lobby. The ground floor of the Viking Building is breathtaking. Low-G architecture means more glass and thinner supports, and the building takes advantage of that. Four walls of glass surround a central pillar in which are set the utility rooms and elevators. In between is an expanse of plants, water installations, and stylish seating. Near the entryway is a front desk. Jones may go east and west from here, north to the elevators, or south out of the building. There are two niches in the central wall from which the guard robots emerged.

Spread across the floor in a tangled ruin are the remains of a giant crystal sculpture and two guard robots.

>x robots
Jones digs through the ruins and finds a cable with hooks at either end, which she takes.

>x cable
This is a strong but slender cable, presumably of carbon nanotubes. There are steel hooks at either end.

>w
Jones crosses the floor carefully, disruptor pistol at the ready.

Galaxy Jones is at the southwest corner of the ground floor. A lush waterfall here contrasts with the dusty red streets of New Reykjavik beyond the glass walls. The ground floor extends north and east.

* * *

>n
Galaxy Jones is on the west side of the ground floor. Semicircular couches open on either side of a central carpeted path leading north and south. Set in the central pillar of the building to the east is a utility door. The city looms beyond the glass wall to the west.

>x door
It's a white metal door, completely typical. It has a swipe card lock right above the handle.

>open door
(first unlocking the utility door)
Jones lacks a key that fits the utility door.

>x glass wall
Outside the building are the red-dusted streets of New Reykjavik.

>w
Jones can't go that way. The obvious exits are north, south (to the southwest corner of the ground floor) and east.

>n
Galaxy Jones is at the northwest corner of the ground floor. A large relief map of mars is mounted on the north wall here. One can leave here to the south or east.

>s
Galaxy Jones is on the west side of the ground floor. Semicircular couches open on either side of a central carpeted path leading north and south. Set in the central pillar of the building to the east is a utility door. The city looms beyond the glass wall to the west.

>w
Jones can't go that way. The obvious exits are north (to the northwest corner of the ground floor), south (to the southwest corner of the ground floor) and east.

>n
Galaxy Jones is at the northwest corner of the ground floor. A large relief map of mars is mounted on the north wall here. One can leave here to the south or east.

* * *

>x map
The map is crafted of bronze and sports a star at the site of New Reykjavik.

>take map
That's hardly portable.

>e
Galaxy Jones is on the north side of the ground floor. The area is dominated by a towering statue of Admiral Thallium against the north wall. The ground floor extends west and east from here. The elevator is to the south.

* * *

>x statue
His nauseating visage seems to leer at Jones, and she suppresses a shiver of disgust.

Jones groans. "Be glad you're not here, Beck. This is revolting."

Beck chuckles. "I won't ask."

>fire at statue
Shooting it would accomplish nothing.

>e
Galaxy Jones is at the northeast corner of the ground floor. The area is dedicated to celebrating the military career of Admiral Thallium. Uniforms, medals, ribbons, and other miscellanea are mounted on the wall or in showcases. All this despite the fact that no one has turned up any evidence that Thallium served in any navy of any country on any planet. One can escape to the west or south.

>take all
I'm not sure what you're referring to.

>open showcase
Jones yawns looking over the assortment of faux honors. They're all behind glass, but one of the display cases is partly open, leaving the rather garish medal inside unprotected.

>s
Galaxy Jones is on the east side of the ground floor. Apparently some kind of function was happening here before Admiral Thallium emptied the building, for there is an array of canapes on a catering table here. The floor stretches north and south, and there's a closet door to the west.

>eat canapes
Jones is not hungry.

>x table
The table is covered with a wide array of treats from the ridiculously expensive, such as shrimp tea sandwiches (where do you get shrimp on Mars?), to the just plain ridiculous, like poached ostrich eggs in jelly. A good number of forks are laid out to one side.

Jones: "Well, at least the Admiral treats his guests right. Except me. And Europa."

>take forks
Taken.

>take sandwiches
Taken.

>take treats
There's nothing like that nearby.

>take all
poached ostrich eggs in jelly: Don't even.

>i
Jones is carrying:
  a shrimp tea sandwich
  a fork
  a cable with hooks at either end
  a disruptor pistol

>s
Galaxy Jones is at the southeast corner of the ground floor. The centerpiece of this area is the actual Viking 2 lander, which landed right here on Utopia Planitia. The glass walls look out onto the city. Jones can go north or west from here.

>n
Galaxy Jones is on the east side of the ground floor. Apparently some kind of function was happening here before Admiral Thallium emptied the building, for there is an array of canapes on a catering table here. The floor stretches north and south, and there's a closet door to the west.

>open closet door
(first unlocking the closet door)
Jones will have to enter the correct code on the keypad.

Jones: "Door on the east side has a keypad lock."

>x keypad
An ordinary numerical keypad.

>s
Galaxy Jones is at the southeast corner of the ground floor. The centerpiece of this area is the actual Viking 2 lander, which landed right here on Utopia Planitia. The glass walls look out onto the city. Jones can go north or west from here.

* * *

>n
Galaxy Jones is in the ground floor elevator hall. This hallway between the north and south ends of the ground floor is home to the elevator to the west. To the east is the entrance to a stairwell.

>n
Galaxy Jones is on the north side of the ground floor. The area is dominated by a towering statue of Admiral Thallium against the north wall. The ground floor extends west and east from here. The elevator is to the south.

>s
Galaxy Jones is in the ground floor elevator hall. This hallway between the north and south ends of the ground floor is home to the elevator to the west. To the east is the entrance to a stairwell.

>s
Galaxy Jones is in the lobby. The ground floor of the Viking Building is breathtaking. Low-G architecture means more glass and thinner supports, and the building takes advantage of that. Four walls of glass surround a central pillar in which are set the utility rooms and elevators. In between is an expanse of plants, water installations, and stylish seating. Near the entryway is a front desk. Jones may go east and west from here, north to the elevators, or south out of the building. There are two niches in the central wall from which the guard robots emerged.

Spread across the floor in a tangled ruin are the remains of a giant crystal sculpture and two guard robots.

>e
Galaxy Jones is at the southeast corner of the ground floor. The centerpiece of this area is the actual Viking 2 lander, which landed right here on Utopia Planitia. The glass walls look out onto the city. Jones can go north or west from here.

>undo
Galaxy Jones is in the lobby.
[Previous turn undone.]

>undo
Galaxy Jones is in the ground floor elevator hall.
[Previous turn undone.]

>e
As soon as Jones enters the stairwell, a disruptor blast from above zings past her shoulder, and she beats a hasty retreat. She won't be going up the stairs until she can clear out the resistance, and she can't do that from here.

Galaxy Jones is in the ground floor elevator hall. This hallway between the north and south ends of the ground floor is home to the elevator to the west. To the east is the entrance to a stairwell.

* * *

>w
(first opening the elevator door)
Jones can't just open the elevator with her hands.

>x elevator
(the elevator door)
A gleaming gold elevator door. There is a hole near the top for inserting a drop key.

>showme
ground floor elevator hall - room
    Jones - person
        shrimp tea sandwich
        fork
        cable with hooks at either end
        disruptor pistol
    elevator door - closed door
        drop key hole (part of elevator door)
    elevator shaft
    call button

>l
Galaxy Jones is in the ground floor elevator hall. This hallway between the north and south ends of the ground floor is home to the elevator to the west. To the east is the entrance to a stairwell.

>n
Galaxy Jones is on the north side of the ground floor. The area is dominated by a towering statue of Admiral Thallium against the north wall. The ground floor extends west and east from here. The elevator is to the south.

* * *

>x desk
There's not much on the desk other than a note that says "0".

>e
Galaxy Jones is at the southeast corner of the ground floor. The centerpiece of this area is the actual Viking 2 lander, which landed right here on Utopia Planitia. The glass walls look out onto the city. Jones can go north or west from here.

* * *

>n
Galaxy Jones is on the east side of the ground floor. Apparently some kind of function was happening here before Admiral Thallium emptied the building, for there is an array of canapes on a catering table here. The floor stretches north and south, and there's a closet door to the west.

>type 0
(on the keypad)
An indicator light glows green.

Jones: "I've unlocked the east side utility door."

* * *

>w
(first opening the closet door)

Galaxy Jones is in the maintenance closet. 

There is an Atmo-Suit hanging from a hook here.

On the shelf is a red cardkey.

>x suit
The Atmo-Suit is a pressure suit ideal for outside work in thin atmospheres like that of Mars.

>take all
Atmo-Suit: Taken.
red cardkey: Taken.

* * *

>e
(first opening the utility door)
(first unlocking the utility door)
(with the red cardkey)

Galaxy Jones is in the elevator room. This is a utility room related to the operation of the elevator, on the other side of the east wall here. There is a control panel on the wall, and a door leading west.

Hanging from a hook here is an elevator drop key.

Lying discarded on a table here is a hammer.

>x panel
From the looks of it, elevator technology hasn't evolved much since it was first developed. This control panel is a primitive collection of wires, circuit boards, indicator lights, and other components. It also seems to be completely inactive -- none of the lights are on.

>take all
elevator drop key: Taken.
hammer: Taken.

>x it
An ordinary claw hammer

>w
Galaxy Jones is on the west side of the ground floor. Semicircular couches open on either side of a central carpeted path leading north and south. Set in the central pillar of the building to the east is a utility door. The city looms beyond the glass wall to the west.

* * *

>n
Galaxy Jones is in the ground floor elevator hall. This hallway between the north and south ends of the ground floor is home to the elevator to the west. To the east is the entrance to a stairwell.

>x elevator
(the elevator drop key)
A drop key is a special device used to open an elevator door from the outside. It consists of a thin shaft which is hinged at th-- oh just Google it.

>x elevator door
A gleaming gold elevator door. There is a hole near the top for inserting a drop key.

>put drop key in hole
(the elevator drop key in the drop key hole)
Jones inserts the elevator drop key into the drop key hole and turns it, disengaging the lock mechanism. Then she slides the door open.

>x elevator
(the elevator drop key)
A drop key is a special device used to open an elevator door from the outside. It consists of a thin shaft which is hinged at th-- oh just Google it.

* * *

>x elevator door
A gleaming gold elevator door. There is a hole near the top for inserting a drop key.

>l
Galaxy Jones is in the ground floor elevator hall. This hallway between the north and south ends of the ground floor is home to the elevator to the west. To the east is the entrance to a stairwell. The elevator door is open, revealing the bottom of the elevator shaft. Jones could climb into it, if she wished.

>w
Jones climbs into the elevator shaft

Galaxy Jones is in the ground floor elevator shaft. She is at the bottom of a dark well. Shining her suit light up, she can see that the elevator car is several floors up, unmoving. There is a ladder running up the wall next to the door.

* * *

>u
Galaxy Jones is in the fourth floor elevator shaft. The door here is closed.

>look up
The elevator car hovers several floors above Jones. She prays it doesn't start to descend.

>u
Galaxy Jones is in the fifth floor elevator shaft. The door here is closed.

>look down
Jones is afraid of heights.

>u
Galaxy Jones is in the sixth floor elevator shaft. The door here is closed.

* * *

>u
Galaxy Jones is in the ninth floor elevator shaft. The door here is closed.

>u
Jones can't go that way. The obvious exits are east and down (to the eighth floor elevator shaft).

>look up
The elevator car is just above Jones's head.

>d
Galaxy Jones is in the eighth floor elevator shaft. The door here is closed.

>u
Galaxy Jones is in the ninth floor elevator shaft. The door here is closed.

>jump down
You must name something more substantial.

>jump
Your sense of humor is very primitive, isn't it?

>open door
Jones opens the ninth floor elevator door.

>e
 _________      __                     _____                     
 __/ ____/___ _/ /___ __  ____  __     __/ /___  ____  ___  _____
 _/ / __/ __ `/ / __ `/ |/ / / / /____ _/ / __ \/ __ \/ _ \/ ___/
 / /_/ / /_/ / / /_/ />  </ /_/ / _/ /_/ / /_/ / / / /  __(__  ) 
 \____/\__,_/_/\__,_/_/|_|\__, /  _\____/\____/_/ /_/\___/____/  
 _____________________________/ 

[Your score has just gone up by one point.]

Jones: "Finally out of the shaft. That was quite a climb."

Beck: "This floor is just offices. Check the building management office to the west. It might have some useful stuff."

Galaxy Jones is in the ninth floor elevator hall. The elevator is to the west, the stairwell is to the east, and a corridor leads north and south. There is a bottled water vending machine here.

>x machine
There is one bottle left.

>open vending machine
It isn't something Jones can open.

>put coin in machine
There's nothing like that nearby.

>e
As soon as Jones enters the stairwell, a disruptor blast from above zings past her shoulder, and she beats a hasty retreat. She won't be going up the stairs until she can clear out the resistance, and she can't do that from here.

Galaxy Jones is in the ninth floor elevator hall. The elevator is to the west, the stairwell is to the east, and a corridor leads north and south. There is a bottled water vending machine here.

>s
Galaxy Jones is in the ninth floor south hallway. This anonymous corporate hallway ends here at the south end of the building. An open doorway leads west. To the east is a door labeled "Martian Chemical"

>e
(first opening the Martian Chemical door)
(first unlocking the Martian Chemical door)
Jones lacks a key that fits the Martian Chemical door.

>w
Galaxy Jones is at the south end of the building management office. The building management office is a bunch of desks and task boards. There is a filing cabinet against the east wall. The office exit is to the east, and the office continues to the north.

A screwdriver sits atop the filing cabinet.

>take screwdriver
Jones reaches for the screwdriver, but she fumbles it and it rolls off the back of the filing cabinet.

Jones: "Damn."

Beck: "What? What's going on?"

Jones: "Just being clumsy is all."

>move filing cabinet
It is fixed in place.

>look behind cabinet
(taking the screwdriver)
Jones reaches behind the cabinet to retrieve the screwdriver. A swipe and a hiss make her recoil.

Jones: "Holy --!"

Beck: "What now?"

Jones: "There's a cat here! Behind a filing cabinet. Gotta get behind there to get a screwdriver, so I need a way to drive off the cat."

>i
Jones is carrying:
  a hammer
  an elevator drop key
  a red cardkey
  an Atmo-Suit
  a shrimp tea sandwich
  a fork
  a cable with hooks at either end
  a disruptor pistol

>fire at cat
Shooting it would accomplish nothing.

>give sandwich to cat
Sensing food, the black cat pokes its head out, grabs the shrimp in its jaws, and races off.

 _________      __                     _____                     
 __/ ____/___ _/ /___ __  ____  __     __/ /___  ____  ___  _____
 _/ / __/ __ `/ / __ `/ |/ / / / /____ _/ / __ \/ __ \/ _ \/ ___/
 / /_/ / /_/ / / /_/ />  </ /_/ / _/ /_/ / /_/ / / / /  __(__  ) 
 \____/\__,_/_/\__,_/_/|_|\__, /  _\____/\____/_/ /_/\___/____/  
 _____________________________/ 

[Your score has just gone up by one point.]

Jones: "Aha! No creature is too fearsome for Galaxy Jones!"

Beck: "Congratulations on your victory."

>take screwdriver
Taken.

>open file cabinet
(first unlocking the filing cabinet)
Jones lacks a key that fits the filing cabinet.

>open filing cabinet
(first unlocking the filing cabinet)
Jones lacks a key that fits the filing cabinet.

>n
Galaxy Jones is at the north end of the building management office. The building management office is a bunch of desks and task boards. There is a particularly large desk against the west window. The office exit is to the east, and the office continues to the south.

>x desk
It's a pretty utilitarian desk of some plastic material. It has a single drawer with a lock.

>x task board
There's nothing like that nearby.

>look under desk
Jones finds nothing of interest.

>e
Galaxy Jones is in the ninth floor north hallway. This anonymous corporate hallway ends here at the north end of the building. An open doorway leads west. To the east is a door labeled "Cybernetica Inc."

>look east
Jones sees the Cybernetica door in that direction.

>e
(first opening the Cybernetica door)
(first unlocking the Cybernetica door)
Jones lacks a key that fits the Cybernetica door.

>i
Jones is carrying:
  a screwdriver
  a hammer
  an elevator drop key
  a red cardkey
  an Atmo-Suit
  a fork
  a cable with hooks at either end
  a disruptor pistol

>s
Galaxy Jones is in the ninth floor elevator hall. The elevator is to the west, the stairwell is to the east, and a corridor leads north and south. There is a bottled water vending machine here.

* * *

>e
(first opening the Martian Chemical door)
(first unlocking the Martian Chemical door)
Jones lacks a key that fits the Martian Chemical door.

>n
Galaxy Jones is in the ninth floor elevator hall. The elevator is to the west, the stairwell is to the east, and a corridor leads north and south. There is a bottled water vending machine here.

>w
(first opening the ninth floor elevator door)

Galaxy Jones is in the ninth floor elevator shaft. The door here is closed.

>u
Jones can't go that way. The obvious exits are east (to the ninth floor elevator hall) and down (to the eighth floor elevator shaft).

>e
(first opening the ninth floor elevator door)

Galaxy Jones is in the ninth floor elevator hall. The elevator is to the west, the stairwell is to the east, and a corridor leads north and south. There is a bottled water vending machine here.

>w
(first opening the ninth floor elevator door)

Galaxy Jones is in the ninth floor elevator shaft. The door here is closed.

>s
Jones can't go that way. The obvious exits are east (to the ninth floor elevator hall) and down (to the eighth floor elevator shaft).

>d
Galaxy Jones is in the eighth floor elevator shaft. The door here is closed.

>d
Galaxy Jones is in the seventh floor elevator shaft. The door here is closed.

>d
Galaxy Jones is in the sixth floor elevator shaft. The door here is closed.

>d
Galaxy Jones is in the fifth floor elevator shaft. The door here is closed.

>d
Galaxy Jones is in the fourth floor elevator shaft. The door here is closed.

>d
Galaxy Jones is in the third floor elevator shaft. The door here is closed.

>d
Galaxy Jones is in the second floor elevator shaft. The door here is closed.

>d
Galaxy Jones is in the ground floor elevator shaft. Jones is at the bottom of a dark well. Shining her suit light up, she can see that the elevator car is several floors up, unmoving. There is a ladder running up the wall next to the door.

>e
Galaxy Jones is in the ground floor elevator hall. This hallway between the north and south ends of the ground floor is home to the elevator to the west. To the east is the entrance to a stairwell. The elevator door is open, revealing the bottom of the elevator shaft. Jones could climb into it, if she wished.

>n
Galaxy Jones is on the north side of the ground floor. The area is dominated by a towering statue of Admiral Thallium against the north wall. The ground floor extends west and east from here. The elevator is to the south.

>w
Galaxy Jones is at the northwest corner of the ground floor. A large relief map of mars is mounted on the north wall here. One can leave here to the south or east.

>s
Galaxy Jones is on the west side of the ground floor. Semicircular couches open on either side of a central carpeted path leading north and south. Set in the central pillar of the building to the east is a utility door. The city looms beyond the glass wall to the west.

>x couch
Which do you mean, the east semicircular couch or the west semicircular couch?

* * *

>east
An inoffensive beige couch, shaped in a half-circle, opening towards the west.

>x west
(the west semicircular couch)
An inoffensive beige couch, shaped in a half-circle, opening towards the east.

>x carpet
There's nothing like that nearby.

>sit on couch
Which do you mean, the east semicircular couch or the west semicircular couch?

>east
Jones gets onto the east semicircular couch.

>sleep
Jones isn't feeling especially drowsy.

>s
(first getting off the east semicircular couch)

Galaxy Jones is at the southwest corner of the ground floor. A lush waterfall here contrasts with the dusty red streets of New Reykjavik beyond the glass walls. The ground floor extends north and east.

>x waterfall
The waterfall descends the length of an artificial rock formation fringed by wide-leaved Earth plants and ferns. The water collects in a basin at the bottom, where it begins its journey again. A single coin sits on the bottom of the basin.

>x water
The waterfall descends the length of an artificial rock formation fringed by wide-leaved Earth plants and ferns. The water collects in a basin at the bottom, where it begins its journey again. A single coin sits on the bottom of the basin.

>x fall
There's nothing like that nearby.

>x basin
The waterfall descends the length of an artificial rock formation fringed by wide-leaved Earth plants and ferns. The water collects in a basin at the bottom, where it begins its journey again. A single coin sits on the bottom of the basin.

>take coin
Taken.

* * *

>x plants
There's nothing like that nearby.

>x desk
There's not much on the desk other than a note that says "0".

>s
Jones leaves the building.

Galaxy Jones is at the entry doorway. A glass revolving door leads into a large open space north of here. The speeder dock is to the south.

* * *

>s
Jones slinks back to the speeder dock.

Galaxy Jones is in the speeder dock. A safe harbor from the periodic dust storms of Utopia Planitia, the dock features several dozen speeder bays. Only a few are filled right now. The building entryway is to the north, under a red stone façade carved into the likeness of a fearsome Viking.

Her speeder, Galaxy One, sits in one of the parking bays.

>x speeder bay
I only understood you as far as wanting to examine the speeder.

>x galaxy one
Galaxy One is a Dust Runner, a top-of-the-line model from Olympus Speedworks. It's deep crimson with tinted windows. Powerful turbines adorn vestigial wings that sweep back in severe rearward arcs.

>n
Galaxy Jones is at the entry doorway. A glass revolving door leads into a large open space north of here. The speeder dock is to the south.

>n
Galaxy Jones is in the lobby. The ground floor of the Viking Building is breathtaking. Low-G architecture means more glass and thinner supports, and the building takes advantage of that. Four walls of glass surround a central pillar in which are set the utility rooms and elevators. In between is an expanse of plants, water installations, and stylish seating. Near the entryway is a front desk. Jones may go east and west from here, north to the elevators, or south out of the building. There are two niches in the central wall from which the guard robots emerged.

Spread across the floor in a tangled ruin are the remains of a giant crystal sculpture and two guard robots.

>x robots
Jones searches some more, but nothing further turns up.

>x sculpture
Jones searches some more, but nothing further turns up.

>x desk
There's not much on the desk other than a note that says "0".

>x pillar
The central area where the elevators and utility rooms are.

>e
Galaxy Jones is at the southeast corner of the ground floor. The centerpiece of this area is the actual Viking 2 lander, which landed right here on Utopia Planitia. The glass walls look out onto the city. Jones can go north or west from here.

>x city
Outside the building are the red-dusted streets of New Reykjavik.

>n
Galaxy Jones is on the east side of the ground floor. Apparently some kind of function was happening here before Admiral Thallium emptied the building, for there is an array of canapes on a catering table here. The floor stretches north and south, and there's a closet door to the west.

>look under table
Jones finds nothing of interest.

>n
Galaxy Jones is at the northeast corner of the ground floor. The area is dedicated to celebrating the military career of Admiral Thallium. Uniforms, medals, ribbons, and other miscellanea are mounted on the wall or in showcases. All this despite the fact that no one has turned up any evidence that Thallium served in any navy of any country on any planet. One can escape to the west or south.

>x uniforms
Jones yawns looking over the assortment of faux honors. They're all behind glass, but one of the display cases is partly open, leaving the rather garish medal inside unprotected.

>take medal
(the garish medal)
Taken.

* * *

>x it
While the front looks authentic, the reverse is engraved with Thallium's personal motto "Planetas Vincam". The ribbon conceals a safety pin. It looks like it could be removed.

>s
Galaxy Jones is on the east side of the ground floor. Apparently some kind of function was happening here before Admiral Thallium emptied the building, for there is an array of canapes on a catering table here. The floor stretches north and south, and there's a closet door to the west.

* * *

>n
Galaxy Jones is in the ground floor elevator hall. This hallway between the north and south ends of the ground floor is home to the elevator to the west. To the east is the entrance to a stairwell. The elevator door is open, revealing the bottom of the elevator shaft. Jones could climb into it, if she wished.

>w
Galaxy Jones is in the ground floor elevator shaft. Jones is at the bottom of a dark well. Shining her suit light up, she can see that the elevator car is several floors up, unmoving. There is a ladder running up the wall next to the door.

>u
Galaxy Jones is in the second floor elevator shaft. The door here is closed.

* * *

>u
Galaxy Jones is in the ninth floor elevator shaft. The door here is closed.

>e
(first opening the ninth floor elevator door)

Galaxy Jones is in the ninth floor elevator hall. The elevator is to the west, the stairwell is to the east, and a corridor leads north and south. There is a bottled water vending machine here.

>put coin in machine
Jones inserts the coin in the machine and takes the bottle that appears a few seconds later.

>x bottle
A full bottle of Olympus Springs water.

>w
(first opening the ninth floor elevator door)

Galaxy Jones is in the ninth floor elevator shaft. The door here is closed.

>e
(first opening the ninth floor elevator door)

Galaxy Jones is in the ninth floor elevator hall. The elevator is to the west, the stairwell is to the east, and a corridor leads north and south. There is a bottled water vending machine here.

>s
Galaxy Jones is in the ninth floor south hallway. This anonymous corporate hallway ends here at the south end of the building. An open doorway leads west. To the east is a door labeled "Martian Chemical"

>w
Galaxy Jones is at the south end of the building management office. The building management office is a bunch of desks and task boards. There is a filing cabinet against the east wall. The office exit is to the east, and the office continues to the north.

>take pin
Taken.

>i
Jones is carrying:
  a safety pin
  a full water bottle
  a garish medal
  a screwdriver
  a hammer
  an elevator drop key
  a red cardkey
  an Atmo-Suit
  a fork
  a cable with hooks at either end
  a disruptor pistol

>pick lock with pin
What do you want Jones to pick?

>pick cabinet with pin
Jones gives it a shot, but the lock won't turn.

>drop drop key
Dropped.

>drop red
Dropped.

>i
Jones is carrying:
  a safety pin
  a full water bottle
  a garish medal
  a screwdriver
  a hammer
  an Atmo-Suit
  a fork
  a cable with hooks at either end
  a disruptor pistol

>open cabinet with fork
The fork does not fit the filing cabinet.

>open cabinet with pin
Jones gives it a shot, but the lock won't turn.

>e
Galaxy Jones is in the ninth floor south hallway. This anonymous corporate hallway ends here at the south end of the building. An open doorway leads west. To the east is a door labeled "Martian Chemical"

>e
(first opening the Martian Chemical door)
(first unlocking the Martian Chemical door)
Jones lacks a key that fits the Martian Chemical door.

>open door with pin
The lock doesn't take a regular key.

>w
Galaxy Jones is at the south end of the building management office. The building management office is a bunch of desks and task boards. There is a filing cabinet against the east wall. The office exit is to the east, and the office continues to the north.

Also here are a red cardkey and an elevator drop key.

>n
Galaxy Jones is at the north end of the building management office. The building management office is a bunch of desks and task boards. There is a particularly large desk against the west window. The office exit is to the east, and the office continues to the south.

>n
Jones can't go that way. The obvious exits are south (to the south end of the building management office) and east (to the ninth floor north hallway).

>e
Galaxy Jones is in the ninth floor north hallway. This anonymous corporate hallway ends here at the north end of the building. An open doorway leads west. To the east is a door labeled "Cybernetica Inc."

>open door with pin
The lock doesn't take a regular key.

>x door
This typical wooden office door displays the sign for Cybernetica Inc., a purveyor of game software.

>cybernetica
That's not a verb I recognise.

>w
Galaxy Jones is at the north end of the building management office. The building management office is a bunch of desks and task boards. There is a particularly large desk against the west window. The office exit is to the east, and the office continues to the south.

>open desk with pin
Jones pushes the pin into the keyhole and wiggles it around. After a few seconds of this the desk drawer pops open. It contains a black cardkey.

>take black key
Taken.

>e
Galaxy Jones is in the ninth floor north hallway. This anonymous corporate hallway ends here at the north end of the building. An open doorway leads west. To the east is a door labeled "Cybernetica Inc."

>e
(first opening the Cybernetica door)
(first unlocking the Cybernetica door)
(with the black cardkey)

Galaxy Jones is in the Cybernetica office. It's spacious and luxurious, designed to make developers forget how spent they are from months of overwork and abuse. Ergonomic desks and chairs fill space like a furniture fractal, before giving way to an open area, presumably for group activities. At the south end of the room is a door labeled "Inspiration Chamber".

As soon as Jones steps into the office, a shot zaps just past her nose. She dives to the ground, protected by the maze of desks and chairs. Peeking through the mesh back of one of the chairs, she takes notice of both the purple guard robot training its disruptor on the room, and the chair's fine construction and lumbar support.

Jones (whispering): "We've got another one! I'm out of sight for now, but it's going to be hard to get a shot off at this 'bot."

Beck: "What's the situation?"

Jones: "I'm on the floor with desks and chairs all around. The target is a few yards off, coming this way. I might get a shot in, but it might just absorb it anyway."

Beck: "Well, see if you can sneak up on it. Maybe close up you can find a way past its defenses."

>shoot robot
Jones raises her head and fires wide. The robot fires back. Jones ducks and crawls off among the labyrinth of desks.

Beck: "Are you still shooting at those things? Even if you hit "em it's not going to leave a scratch."

Jones (whispering): "So what do you propose?"

Beck: "Get closer. Keep your head down, but follow it until you can get a good shot in."

>follow it
Jones creeps a little ways toward the guard robot.

>follow robot
Slowly, slowly, Jones gets a little closer. Just a little more...

She must have poked up her shoulder or something, for the guard robot fires his disruptor. The shot takes out a window on the east side of the room. The electrostatic field around the building keeps the atmosphere from pouring out.

>undo
Galaxy Jones is in the Cybernetica office.
[Previous turn undone.]

>undo
Galaxy Jones is in the Cybernetica office.
[Previous turn undone.]

>shoot robot
Jones raises her head and fires wide. The robot fires back. Jones ducks and crawls off among the labyrinth of desks.

>undo
Galaxy Jones is in the Cybernetica office.
[Previous turn undone.]

>undo
Galaxy Jones is in the ninth floor north hallway.
[Previous turn undone.]

>e
(first opening the Cybernetica door)
(first unlocking the Cybernetica door)
(with the black cardkey)

Galaxy Jones is in the Cybernetica office. It's spacious and luxurious, designed to make developers forget how spent they are from months of overwork and abuse. Ergonomic desks and chairs fill space like a furniture fractal, before giving way to an open area, presumably for group activities. At the south end of the room is a door labeled "Inspiration Chamber".

As soon as Jones steps into the office, a shot zaps just past her nose. She dives to the ground, protected by the maze of desks and chairs. Peeking through the mesh back of one of the chairs, she takes notice of both the purple guard robot training its disruptor on the room, and the chair's fine construction and lumbar support.

Jones (whispering): "We've got another one! I'm out of sight for now, but it's going to be hard to get a shot off at this 'bot."

Beck: "What's the situation?"

Jones: "I'm on the floor with desks and chairs all around. The target is a few yards off, coming this way. I might get a shot in, but it might just absorb it anyway."

Beck: "Well, see if you can sneak up on it. Maybe close up you can find a way past its defenses."

* * *

>shoot robot
Jones raises her head and fires wide. The robot fires back. Jones ducks and crawls off among the labyrinth of desks.

Beck: "Are you still shooting at those things? Even if you hit "em it's not going to leave a scratch."

Jones (whispering): "So what do you propose?"

Beck: "Get closer. Keep your head down, but follow it until you can get a good shot in."

>pronouns
At the moment, "it" means the purple guard robot, "him" means the purple guard robot, "her" means Jones, and "them" means the purple guard robot.

>shoot it
Jones raises her head and fires wide. The robot fires back. Jones ducks and crawls off among the labyrinth of desks.

>follow it
Jones creeps a little ways toward the guard robot.

>follow it
Slowly, slowly, Jones gets a little closer. Just a little more...

She must have poked up her shoulder or something, for the guard robot fires his disruptor. The shot takes out a window on the east side of the room. The electrostatic field around the building keeps the atmosphere from pouring out.

>put on atmo-suit
Variable unavailable for this action, activity or rulebook: internal ID number 20007/1
Jones needs to be able to move around quickly. Better not wear the Atmo-Suit.

>throw bottle at robot
Jones lacks the nerve when it comes to the crucial moment.

>sneak up on robot
Jones is right up next to the robot, crouched beneath a desk. She'll never get a better shot.

>fire at robot
Jones aims the pistol upward under the robot's enhanced armor and fires. She flinches back when the robot's innards explode downward in a shower of sparks. It topples over, dead.

 _________      __                     _____                     
 __/ ____/___ _/ /___ __  ____  __     __/ /___  ____  ___  _____
 _/ / __/ __ `/ / __ `/ |/ / / / /____ _/ / __ \/ __ \/ _ \/ ___/
 / /_/ / /_/ / / /_/ />  </ /_/ / _/ /_/ / /_/ / / / /  __(__  ) 
 \____/\__,_/_/\__,_/_/|_|\__, /  _\____/\____/_/ /_/\___/____/  
 _____________________________/ 

[Your score has just gone up by one point.]

Jones: "Better than a video game. "

Beck: "Nice, but don't forget to credit your handler."

Jones: "Yes, yes, thanks for helping me not get killed."

Beck: "You're welcome."

>s
Galaxy Jones is in the Inspiration Chamber. One of the most unique features of the office is the "inspiration chamber," a specialized room designed to stimulate creativity and innovation. The room is filled with advanced technology, including AI-generated art, interactive displays, and sensory stimulation devices that can help employees think outside the box and come up with new ideas.

Jones: "We gotta get us some of this stuff."

Beck: "What's that?"

Jones: "Never mind."

>n
Galaxy Jones is in the Cybernetica office. It's spacious and luxurious, designed to make developers forget how spent they are from months of overwork and abuse. Ergonomic desks and chairs fill space like a furniture fractal, before giving way to an open area, presumably for group activities. At the south end of the room is a door labeled "Inspiration Chamber". One of the windows along the east side of the office is broken.

The remains of the purple guard robot are sprawled on the ground.

>x robot
There seems to be nothing special about it.

>x window
There's nothing like that nearby.

>e
Jones: "I'm going out the window to see if I can find a way to get up to the tenth floor."

Beck: "Whoa whoa whoa, Jones. You know you're not good with heights."

Jones: "Ask Thallium how how much that matters once I've kicked his ass. Watch me, I'll look down and not even flinch."

(first donning the Atmo-Suit)
Galaxy Jones is on a ledge. She's plastered up against the wall, trying not to look down.

>look around
There's nothing like that nearby.

>look
Galaxy Jones is on a ledge. She's plastered up against the wall, trying not to look down.

>look down
Jones is afraid of heights.

>look up
There's nothing in that direction.

>i
Jones is carrying:
  a black cardkey
  a safety pin
  a full water bottle
  a garish medal
  a screwdriver
  a hammer
  an Atmo-Suit (being worn)
  a fork
  a cable with hooks at either end
  a disruptor pistol

>drop fork
Bad idea.

>take fork
Jones already has that.

>jump
On a ledge? Are you crazy?

>throw cable up
I only understood you as far as wanting to throw the cable with hooks at either end.

>look down
Really, really afraid of heights.

* * *

>d
Jones drops off the ledge onto the scaffold. It rocks unnervingly for a moment.

Galaxy Jones is on a window washing scaffold. It's lined up with the eighth floor window. There doesn't seem to be any way to get into the building here. Mounted on the scaffold is a control panel with two buttons: one indicating up and one indicating down.

>jump
Jones jumps on the spot.

>press up
(the scaffold up button)
Jones presses the button, and the scaffold begins to rise.

Galaxy Jones is on a window washing scaffold. It's lined up with the ninth floor window. She could climb back into the building through the window here. Mounted on the scaffold is a control panel with two buttons: one indicating up and one indicating down.

Jones: "Beck?"

Beck: "Yes?"

Jones: "I hate it out here."

Beck: "Well, there's the open window right next to you."

* * *

>remove cover with screwdriver
Jones loosens the screws with the screwdriver and removes the grill from the vent.

>in
Jones climbs inside the vent, crawls along a short length of duct work, and emerges through another, hinged grill, into the air handling room.
 _________      __                     _____                     
 __/ ____/___ _/ /___ __  ____  __     __/ /___  ____  ___  _____
 _/ / __/ __ `/ / __ `/ |/ / / / /____ _/ / __ \/ __ \/ _ \/ ___/
 / /_/ / /_/ / / /_/ />  </ /_/ / _/ /_/ / /_/ / / / /  __(__  ) 
 \____/\__,_/_/\__,_/_/|_|\__, /  _\____/\____/_/ /_/\___/____/  
 _____________________________/ 

[Your score has just gone up by one point.]

Galaxy Jones is in the air handling room. There is a good amount of loud fans and other air handling machinery here. A small hinged vent opening leads into some ductwork, and from there to the outside. A door leads west.

She takes off the Atmo-Suit.

Jones: "Ha! I'm in!"

Beck: "Be careful, you're likely to run into more resistance here. The floor is all one open office, so any guard robots will have good line of sight."

Jones: "Got it."

Beck: "And Jones? Save your game."

>w
(first opening the air handling door)

Galaxy Jones is on the north side of the Consolidated Microthings office. This is the company cafeteria. The elevator is south, the air handling room is to the east, and the office continues to the west and southeast.

>undo
Galaxy Jones is in the air handling room.
[Previous turn undone.]

>in
(first donning the Atmo-Suit)
(first opening the vent access door)
Galaxy Jones is on a window washing scaffold. It's lined up with the tenth floor. Instead of a window, there's what appears to be an exhaust vent. If it's for forced air, though, the fan is currently not running. Mounted on the scaffold is a control panel with two buttons: one indicating up and one indicating down.

>inside
Jones climbs inside the vent, crawls along a short length of duct work, and emerges through another, hinged grill, into the air handling room.

Galaxy Jones is in the air handling room. There is a good amount of loud fans and other air handling machinery here. A small hinged vent opening leads into some ductwork, and from there to the outside. A door leads west.

She takes off the Atmo-Suit.

>go in
(first donning the Atmo-Suit)
Galaxy Jones is on a window washing scaffold. It's lined up with the tenth floor. Instead of a window, there's what appears to be an exhaust vent. If it's for forced air, though, the fan is currently not running. Mounted on the scaffold is a control panel with two buttons: one indicating up and one indicating down.

>enter vent
Jones climbs inside the vent, crawls along a short length of duct work, and emerges through another, hinged grill, into the air handling room.

Galaxy Jones is in the air handling room. There is a good amount of loud fans and other air handling machinery here. A small hinged vent opening leads into some ductwork, and from there to the outside. A door leads west.

She takes off the Atmo-Suit.

>undo
Galaxy Jones is on a window washing scaffold.
[Previous turn undone.]

>in
Jones climbs inside the vent, crawls along a short length of duct work, and emerges through another, hinged grill, into the air handling room.

Galaxy Jones is in the air handling room. There is a good amount of loud fans and other air handling machinery here. A small hinged vent opening leads into some ductwork, and from there to the outside. A door leads west.

She takes off the Atmo-Suit.

>out
But Jones isn't in anything at the moment.

>in
(first donning the Atmo-Suit)
Galaxy Jones is on a window washing scaffold. It's lined up with the tenth floor. Instead of a window, there's what appears to be an exhaust vent. If it's for forced air, though, the fan is currently not running. Mounted on the scaffold is a control panel with two buttons: one indicating up and one indicating down.

>undo
Galaxy Jones is in the air handling room.
[Previous turn undone.]

>l
Galaxy Jones is in the air handling room. There is a good amount of loud fans and other air handling machinery here. A small hinged vent opening leads into some ductwork, and from there to the outside. A door leads west.

>enter vent
(first donning the Atmo-Suit)

Galaxy Jones is on a window washing scaffold. It's lined up with the tenth floor. Instead of a window, there's what appears to be an exhaust vent. If it's for forced air, though, the fan is currently not running. Mounted on the scaffold is a control panel with two buttons: one indicating up and one indicating down.

>press down
(the scaffold down button)
Jones presses the button, and the scaffold begins to descend.

Galaxy Jones is on a window washing scaffold. It's lined up with the ninth floor window. She could climb back into the building through the window here. Mounted on the scaffold is a control panel with two buttons: one indicating up and one indicating down.

>gonear air
(the air handling room)
Galaxy Jones is in the air handling room. There is a good amount of loud fans and other air handling machinery here. A small hinged vent opening leads into some ductwork, and from there to the outside. A door leads west.

>enter vent
Galaxy Jones is on a window washing scaffold. It's lined up with the ninth floor window. Jones could climb back into the building through the window here. Mounted on the scaffold is a control panel with two buttons: one indicating up and one indicating down.

>undoi
That's not a verb I recognise.

>undo
Galaxy Jones is on a window washing scaffold.
[Previous turn undone.]

>rules
Rules tracing now switched on. Type "rules off" to switch it off again, or "rules all" to include even rules which do not apply.

[Rule "clear LPR rule" applies.]

>enter vent
[Rule "After deciding the scope of the player" applies.]
[Rule "After deciding the scope of the player" applies.]
[Rule "After deciding the scope of the player" applies.]
There's nothing like that nearby.
[Rule "clear LPR rule" applies.]

>undo
[Rule "standard naming rule" applies.]
Galaxy Jones is on a window washing scaffold.
[Previous turn undone.]

>undo
Galaxy Jones is on a window washing scaffold.
[Previous turn undone.]

>undo
Galaxy Jones is in the air handling room.
[Previous turn undone.]

>rules
Rules tracing now switched on. Type "rules off" to switch it off again, or "rules all" to include even rules which do not apply.

[Rule "clear LPR rule" applies.]

* * *

>e
Jones: "I'm going out the window to see if I can find a way to get up to the tenth floor."

Beck: "Whoa whoa whoa, Jones. You know you're not good with heights."

Jones: "Ask Thallium how how much that matters once I've kicked his ass. Watch me, I'll look down and not even flinch."

(first donning the Atmo-Suit)
Galaxy Jones is on a ledge. She's plastered up against the wall, trying not to look down.

>w
Galaxy Jones is in the Cybernetica office. It's spacious and luxurious, designed to make developers forget how spent they are from months of overwork and abuse. Ergonomic desks and chairs fill space like a furniture fractal, before giving way to an open area, presumably for group activities. At the south end of the room is a door labeled "Inspiration Chamber". One of the windows along the east side of the office is broken.

The remains of the purple guard robot are sprawled on the ground.

Jones doffs the Atmo-Suit.

>out
(first donning the Atmo-Suit)
Galaxy Jones is on a ledge. She's plastered up against the wall, trying not to look down.

>go out
Jones can't go that way. The obvious exits are south (to the inspiration chamber), east (to the ledge) and west (to the ninth floor north hallway).

* * *

>out
(first donning the Atmo-Suit)
Galaxy Jones is on a ledge. She's plastered up against the wall, trying not to look down.

>in
Galaxy Jones is in the Cybernetica office. It's spacious and luxurious, designed to make developers forget how spent they are from months of overwork and abuse. Ergonomic desks and chairs fill space like a furniture fractal, before giving way to an open area, presumably for group activities. At the south end of the room is a door labeled "Inspiration Chamber". One of the windows along the east side of the office is broken.

The remains of the purple guard robot are sprawled on the ground.

Jones doffs the Atmo-Suit.

>e
(first donning the Atmo-Suit)
Galaxy Jones is on a ledge. She's plastered up against the wall, trying not to look down.

>d
Jones can't go that way. The obvious exits are west (to the cybernetica office) and inside (to the cybernetica office).

>look down
Jones is afraid of heights.

* * *

>d
Jones drops off the ledge onto the scaffold. It rocks unnervingly for a moment.

Galaxy Jones is on a window washing scaffold. It's lined up with the eighth floor window. There doesn't seem to be any way to get into the building here. Mounted on the scaffold is a control panel with two buttons: one indicating up and one indicating down.

>w
Jones can't go that way. There are no obvious exits.

>e
Jones can't go that way. There are no obvious exits.

>press up
(the scaffold up button)
Jones presses the button, and the scaffold begins to rise.

Galaxy Jones is on a window washing scaffold. It's lined up with the ninth floor window. She could climb back into the building through the window here. Mounted on the scaffold is a control panel with two buttons: one indicating up and one indicating down.

Jones: "Beck?"

Beck: "Yes?"

Jones: "I hate it out here."

Beck: "Well, there's the open window right next to you."

>w
Jones can't go that way. There are no obvious exits.