The phone rings. Galaxy Jones, the solar system's greatest hero, rolls over in bed and presses the talk button.

"Yes?" she says in a voice thick with sleep.

"Hello, is this Galaxy Jones?" comes the voice from the speaker.

"Yes, this is she. To whom am I speaking?"

"Oh, hi, Ms Jones. This is Patty, I work for Admiral P. X. Thallium, CEO of Diversified Entanglements, LLC. He asked me to forward a message to you."

"He did, did he? Now what would the Admiral want to say to me?"

"Oh, it's not from the Admiral himself. It's from one Miss Europa Callisto. I must say, the Admiral was quite surprised when I said I didn't know who she is. Apparently she's famous."

"Yes, quite famous, but why would she send a message to me, and why on Mars would she send it through Thallium? But never mind, what's the message?"

Patty can be heard rustling paper. "Let's see... it's here somewhere. Oh yes, here it is. The message is 'Help.'"

Ten minutes later, Galaxy Jones, in her speeder Galaxy One, races across the desolate expanse of Utopia Planitia, Mars. Her nemesis, the thoroughly execrable Admiral Thallium, has taken the exquisite Europa Callisto, singer and actress renowned throughout a dozen solar systems, hostage. As Patty has quite helpfully explained, Miss Callisto is imprisoned at the top of the Viking Building in downtown New Reykjavik, guarded by an impressive number of killer robots and other diabolical instruments of Jones's no-doubt impending demise. The Admiral has invited Ms Jones most cordially to break into his building and attempt a rescue.

"Oh I will," Galaxy mutters to herself. This time, she vows silently, Thallium won't escape.

Plus she'll get to meet Europa Callisto. That'll be totally sweet.

 _________      __                     _____                     
 __/ ____/___ _/ /___ __  ____  __     __/ /___  ____  ___  _____
 _/ / __/ __ `/ / __ `/ |/_/ / / /  __ _/ / __ \/ __ \/ _ \/ ___/
 / /_/ / /_/ / / /_/ />  </ /_/ /  / /_/ / /_/ / / / /  __(__  ) 
 \____/\__,_/_/\__,_/_/|_|\__, /   \____/\____/_/ /_/\___/____/  
 _____________________________/ 

An Interactive Fiction by Philip Riley
Release 1 / Serial number 230221 / Inform 7 build 6M62 (I6/v6.34 lib 6/12N) SD

A sleek dark red speeder roars into the speeder dock of the Viking Building. A tall, strong, dark-brown-skinned woman in a battle-ready jumpsuit climbs out of it.

Galaxy Jones is in the speeder dock. A safe harbor from the periodic dust storms of Utopia Planitia, the dock features several dozen speeder bays. Only a few are filled right now. The building entryway is to the north, under a red stone façade carved into the likeness of a fearsome Viking.

Jones's speeder, Galaxy One, sits in one of the parking bays

>n
Jones approaches the Viking Building entryway, the dramatic façade towering over her.

Galaxy Jones is at the entry doorway. A glass revolving door leads into a large open space north of here. The speeder dock is to the south.

>n
Jones passes through the revolving door and into the lobby, alert to any defenses.

Galaxy Jones is in the lobby. The ground floor of the Viking Building is breathtaking. Low-G architecture means more glass and thinner supports, and the building takes advantage of that. Four walls of glass surround a central pillar in which are set the utility rooms and elevators. In between is an expanse of plants, water installations, and stylish seating. Near the entryway is a front desk. Above it floats, suspended on almost invisible cables, a giant crystal sculpture.

>n
Before Jones gets a chance to do anything, two robot guards emerge from niches in the back wall! She dives behind the front desk and draws her disruptor pistol.

>fire pistol at guard
Which do you mean, the green guard robot or the red guard robot?

>red
A barrage of fire from the robots prevents Jones from firing.

>fire pistol at guards
There's nothing like that nearby.

>fire pistol at robots
You can't use multiple objects with that verb.

* * *

>n
Before Jones gets a chance to do anything, two robot guards emerge from niches in the back wall! She dives behind the front desk and draws her disruptor pistol.

>sit on couch
As soon as Jones starts to act, an energy beam zips past her head, forcing her back down behind the desk.

The green robot fires a blistering shot into the front desk.

>take note
As soon as Jones starts to act, an energy beam zips past her head, forcing her back down behind the desk.

>x robot
Which do you mean, the green guard robot or the red guard robot?

>red
Definitely not a friendly humanoid. More of a spiny killer with a disruptor barrel mounted on its head.

The red robot fires a blistering shot into the front desk.

* * *

>n
Jones passes through the revolving door and into the lobby, alert to any defenses.

Galaxy Jones is in the lobby. The ground floor of the Viking Building is breathtaking. Low-G architecture means more glass and thinner supports, and the building takes advantage of that. Four walls of glass surround a central pillar in which are set the utility rooms and elevators. In between is an expanse of plants, water installations, and stylish seating. Near the entryway is a front desk. Above it floats, suspended on almost invisible cables, a giant crystal sculpture.

>x couch
Before Jones gets a chance to do anything, two robot guards emerge from niches in the back wall! She dives behind the front desk and draws her disruptor pistol.

>x couch
Quite tasteful for a homicidal madman, really.

>sit on couch
Jones gets onto the couch.

One of the robots fires directly above her head.

>get up
Jones gets off the couch.

Galaxy Jones is in the lobby. The ground floor of the Viking Building is breathtaking. Low-G architecture means more glass and thinner supports, and the building takes advantage of that. Four walls of glass surround a central pillar in which are set the utility rooms and elevators. In between is an expanse of plants, water installations, and stylish seating. Near the entryway is a front desk. Above it floats, suspended on almost invisible cables, a giant crystal sculpture.

The guard robots, red and green, have their head cannons trained on the front desk.

The red robot tries to flank her, but a shot from her disruptor sends it scurrying back.

>n
Trying to reach an exit would surely get Jones shot.

>x desk
There's not much on the desk other than a note that says "0".

One of the robots fires directly above Jones's head.

* * *

>n
Jones passes through the revolving door and into the lobby, alert to any defenses.

Galaxy Jones is in the lobby. The ground floor of the Viking Building is breathtaking. Low-G architecture means more glass and thinner supports, and the building takes advantage of that. Four walls of glass surround a central pillar in which are set the utility rooms and elevators. In between is an expanse of plants, water installations, and stylish seating. Near the entryway is a front desk. Above it floats, suspended on almost invisible cables, a giant crystal sculpture.

>z
Before Jones gets a chance to do anything, two robot guards emerge from niches in the back wall! She dives behind the front desk and draws her disruptor pistol.

>shoot guards
There's nothing like that nearby.

>showme guards
There seems to be no such object anywhere in the model world.

>showme guard
(the tangled ruin)
tangled ruin - pseudocontainer
    thingy
location: out of play
singular-named, improper-named; unlit, inedible, fixed in place, neuter; opaque, open, unopenable, unlocked; auto-take
list grouping key: none
printed name: "tangled ruin"
printed plural name: "pseudocontainers"
indefinite article: none
most recent reference: nominal
third singular pronoun: It-pronoun
description: "Jones searches some more, but nothing further turns up."
initial appearance: "Spread across the floor in a tangled ruin are the remains of a giant crystal sculpture and two guard robots."
third-plural-pronoun: They-pronoun
carrying capacity: 100
contents description: "She digs through the ruins and finds a thingy, which she takes."

>showme robot
(the tangled ruin)
tangled ruin - pseudocontainer
    thingy
location: out of play
singular-named, improper-named; unlit, inedible, fixed in place, neuter; opaque, open, unopenable, unlocked; auto-take
list grouping key: none
printed name: "tangled ruin"
printed plural name: "pseudocontainers"
indefinite article: none
most recent reference: nominal
third singular pronoun: It-pronoun
description: "Jones searches some more, but nothing further turns up."
initial appearance: "Spread across the floor in a tangled ruin are the remains of a giant crystal sculpture and two guard robots."
third-plural-pronoun: They-pronoun
carrying capacity: 100
contents description: "She digs through the ruins and finds a thingy, which she takes."

>showme robots
tangled ruin - pseudocontainer
    thingy
location: out of play
singular-named, improper-named; unlit, inedible, fixed in place, neuter; opaque, open, unopenable, unlocked; auto-take
list grouping key: none
printed name: "tangled ruin"
printed plural name: "pseudocontainers"
indefinite article: none
most recent reference: nominal
third singular pronoun: It-pronoun
description: "Jones searches some more, but nothing further turns up."
initial appearance: "Spread across the floor in a tangled ruin are the remains of a giant crystal sculpture and two guard robots."
third-plural-pronoun: They-pronoun
carrying capacity: 100
contents description: "She digs through the ruins and finds a thingy, which she takes."

>showme all robots
tangled ruin - pseudocontainer
    thingy
location: out of play
singular-named, improper-named; unlit, inedible, fixed in place, neuter; opaque, open, unopenable, unlocked; auto-take
list grouping key: none
printed name: "tangled ruin"
printed plural name: "pseudocontainers"
indefinite article: none
most recent reference: nominal
third singular pronoun: It-pronoun
description: "Jones searches some more, but nothing further turns up."
initial appearance: "Spread across the floor in a tangled ruin are the remains of a giant crystal sculpture and two guard robots."
third-plural-pronoun: They-pronoun
carrying capacity: 100
contents description: "She digs through the ruins and finds a thingy, which she takes."

>shoot art
(with the disruptor pistol)
Jones fires the disruptor into the sculpture's main support cable, snapping it. The huge crystal blob starts to sag, straining the other cables. In quick succession they break as well, and the whole installation plummets to the ground, right on top of the hapless guard robots.

 _________      __                     _____                     
 __/ ____/___ _/ /___ __  ____  __     __/ /___  ____  ___  _____
 _/ / __/ __ `/ / __ `/ |/_/ / / /  __ _/ / __ \/ __ \/ _ \/ ___/
 / /_/ / /_/ / / /_/ />  </ /_/ /  / /_/ / /_/ / / / /  __(__  ) 
 \____/\__,_/_/\__,_/_/|_|\__, /   \____/\____/_/ /_/\___/____/  
 _____________________________/ 

[Your score has just gone up by one point.]

>showme all robots
(the tangled ruin)
tangled ruin - pseudocontainer
    thingy
location: in the lobby
singular-named, improper-named; unlit, inedible, fixed in place, neuter; opaque, open, unopenable, unlocked; auto-take
list grouping key: none
printed name: "tangled ruin"
printed plural name: "pseudocontainers"
indefinite article: none
most recent reference: nominal
third singular pronoun: It-pronoun
description: "Jones searches some more, but nothing further turns up."
initial appearance: "Spread across the floor in a tangled ruin are the remains of a giant crystal sculpture and two guard robots."
third-plural-pronoun: They-pronoun
carrying capacity: 100
contents description: "She digs through the ruins and finds a thingy, which she takes."

>x art
Jones digs through the ruins and finds a thingy, which she takes.

>i
Jones is carrying:
  a thingy
  a disruptor pistol

>x desk
There's not much on the desk other than a note that says "0".

>e
Galaxy Jones is at the southeast corner of the ground floor.

>n
Galaxy Jones is on the east side of the ground floor. 

Also here is a closet door.

>type 0
(on the keypad)
An indicator light glows green.

>w
(first opening the closet door)

Galaxy Jones is in the maintenance closet. 

There is an Atmo-Suit hanging from a hook here.

On the shelf is a brass key.

Also here is a closet door.

>take all
Atmo-Suit: Taken.
brass key: Taken.

>e
Galaxy Jones is on the east side of the ground floor. 

Also here is a closet door.

>s
Galaxy Jones is at the southeast corner of the ground floor.

>w
Galaxy Jones is in the lobby. The ground floor of the Viking Building is breathtaking. Low-G architecture means more glass and thinner supports, and the building takes advantage of that. Four walls of glass surround a central pillar in which are set the utility rooms and elevators. In between is an expanse of plants, water installations, and stylish seating. Near the entryway is a front desk.

Spread across the floor in a tangled ruin are the remains of a giant crystal sculpture and two guard robots.

>w
Galaxy Jones is at the southwest corner of the ground floor. A lush waterfall here contrasts with the dusty red desolation of Mars beyond the window.

>n
Galaxy Jones is on the west side of the ground floor. 

Also here is an elevator room door.

>e
(first opening the elevator room door)
(first unlocking the elevator room door)
(with the brass key)

Galaxy Jones is in the elevator room. 

In one of the cubbies is a drop key.

Also here is an elevator room door.

>take key
(the drop key)
Taken.

>w
Galaxy Jones is on the west side of the ground floor. 

Also here is an elevator room door.

>s
Galaxy Jones is at the southwest corner of the ground floor. A lush waterfall here contrasts with the dusty red desolation of Mars beyond the window.

>e
Galaxy Jones is in the lobby. The ground floor of the Viking Building is breathtaking. Low-G architecture means more glass and thinner supports, and the building takes advantage of that. Four walls of glass surround a central pillar in which are set the utility rooms and elevators. In between is an expanse of plants, water installations, and stylish seating. Near the entryway is a front desk.

Spread across the floor in a tangled ruin are the remains of a giant crystal sculpture and two guard robots.

>n
Galaxy Jones is in the ground floor elevator hall. 

Also here is an elevator door.

>Leaw
That's not a verb I recognise.

>w
(first opening the elevator door)

Galaxy Jones is in the ground floor elevator shaft. 

Also here is an elevator door.

>n
Jones can't go that way.

>e
Galaxy Jones is in the ground floor elevator hall. 

Also here is an elevator door.

>e
Galaxy Jones is in the ground floor stairwell.

>e
Jones can't go that way.

>w
Galaxy Jones is in the ground floor elevator hall. 

Also here is an elevator door.

>gonear dock
Galaxy Jones is in the speeder dock. A safe harbor from the periodic dust storms of Utopia Planitia, the dock features several dozen speeder bays. Only a few are filled right now. The building entryway is to the north, under a red stone façade carved into the likeness of a fearsome Viking.

Jones's speeder, Galaxy One, sits in one of the parking bays.

>x speeder
Galaxy One is a Dust Runner, a top-of-the-line model from Olympus Speedworks. It's deep crimson with tinted windows. Powerful turbines adorn vestigial wings that sweep back in severe rearward arcs.

* * *

>n
Jones approaches the Viking Building entryway, the dramatic façade towering over her.

Galaxy Jones is at the entry doorway. A glass revolving door leads into a large open space north of here. The speeder dock is to the south.

>x door
A glass revolving door emblazoned with the symbol of a Viking kind astride the planet Mars.

>close entry door
That's already closed.

>n
(first opening the entry door)
Jones enters the lobby warily, alert to any defenses.

Galaxy Jones is in the lobby. The ground floor of the Viking Building is breathtaking. Low-G architecture means more glass and thinner supports, and the building takes advantage of that. Four walls of glass surround a central pillar in which are set the utility rooms and elevators. In between is an expanse of plants, water installations, and stylish seating. Near the entryway is a front desk. Above it floats, suspended on almost invisible cables, a giant crystal sculpture.

* * *

>pronouns
At the moment, "it" means the speeder, "him" is unset, "her" means Jones, and "them" is unset.

>x her
Galaxy

Foo

* * *

>pronouns
At the moment, "it" means the speeder, "him" is unset, "her" means Jones, and "them" is unset.

>x it
Galaxy One is a Dust Runner, a top-of-the-line model from Olympus Speedworks. It's deep crimson with tinted windows. Powerful turbines adorn vestigial wings that sweep back in severe rearward arcs.

>pronouns
At the moment, "it" means the speeder, "him" is unset, "her" is unset, and "them" is unset.

>x jones
Galaxy

>pronouns
At the moment, "it" means the speeder, "him" is unset, "her" is unset, and "them" is unset.

* * *

>shoot me
(with the disruptor pistol)
Jones, or the narrator (that's the one who's talking right now), are unable to interact with you in any way, other than via keyboard and text, that is.

>x me
You? I don't know who you are and I don't really care. If you need to know what you look like, just look at yourself, for heaven's sake.

>x jones
Galaxy

>shoot jones
(with the disruptor pistol)
Shooting that would accomplish nothing.

* * *

>x galaxy
(the speeder)
Galaxy One is a Dust Runner, a top-of-the-line model from Olympus Speedworks. It's deep crimson with tinted windows. Powerful turbines adorn vestigial wings that sweep back in severe rearward arcs.

>x galaxy jones
As good-looking as ever.

* * *

>x her
Galaxy Jones stands at the ready.

>x galaxy
(the speeder)
Galaxy One is a Dust Runner, a top-of-the-line model from Olympus Speedworks. It's deep crimson with tinted windows. Powerful turbines adorn vestigial wings that sweep back in severe rearward arcs.

* * *

>x it
Galaxy One is a Dust Runner, a top-of-the-line model from Olympus Speedworks. It's deep crimson with tinted windows. Powerful turbines adorn vestigial wings that sweep back in severe rearward arcs.

>x pistol
A compact instrument of death, with only one setting: kill.

* * *

>x jones
Galaxy

Foo

>pronouns
At the moment, "it" means the speeder, "him" is unset, "her" means Jones, and "them" is unset.

>n
Jones approaches the Viking Building entryway, the dramatic façade towering over her.

Galaxy Jones is at the entry doorway.

* * *

>pronouns
At the moment, "it" means the speeder, "him" is unset, "her" means Jones, and "them" is unset.

>showme yourself
Jones - person
    disruptor pistol
location: in the speeder dock
singular-named, proper-named; unlit, inedible, portable, female, nomale
list grouping key: none
printed name: "yourself"
printed plural name: "people"
indefinite article: none
most recent reference: nominal
third singular pronoun: She-pronoun
description: "Galaxy"
initial appearance: none
third-plural-pronoun: They-pronoun
carrying capacity: 100
first-singular-pronoun: I-pronoun
first-plural-pronoun: We-pronoun
second-singular-pronoun: Singular-you-pronoun
second-plural-pronoun: Plural-you-pronoun

* * *

>pronouns
At the moment, "it" means the speeder, "him" is unset, "her" means Jones, and "them" is unset.

>take jones
Jones is always self-possessed.

>x bays
Most of the parking bays are unfilled.

>pronouns
At the moment, "it" means the speeder, "him" is unset, "her" is unset, and "them" means the parking bays.

* * *

>x her
Galaxy

Foo

>restart
Are you sure you want to restart?

>y
The phone rings. Galaxy Jones, the solar system's greatest hero, rolls over in bed and presses the talk button.

"Yes?" she says in a voice thick with sleep.

"Hello, is this Galaxy Jones?" comes the voice from the speaker.

"Yes, this is she. To whom am I speaking?"

"Oh, hi, Ms Jones. This is Patty, I work for Admiral P. X. Thallium, CEO of Diversified Entanglements, LLC. He asked me to forward a message to you."

"He did, did he? Now what would the Admiral want to say to me?"

"Oh, it's not from the Admiral himself. It's from one Miss Europa Callisto. I must say, the Admiral was quite surprised when I said I didn't know who she is. Apparently she's famous."

"Yes, quite famous, but why would she send a message to me, and why on Mars would she send it through Thallium? But never mind, what's the message?"

Patty can be heard rustling paper. "Let's see... it's here somewhere. Oh yes, here it is. The message is 'Help.'"

Ten minutes later, Galaxy Jones, in her speeder Galaxy One, races across the desolate expanse of Utopia Planitia, Mars. Her nemesis, the thoroughly execrable Admiral Thallium, has taken the exquisite Europa Callisto, singer and actress renowned throughout a dozen solar systems, hostage. As Patty has quite helpfully explained, Miss Callisto is imprisoned at the top of the Viking Building in downtown New Reykjavik, guarded by an impressive number of killer robots and other diabolical instruments of Jones's no-doubt impending demise. The Admiral has invited Ms Jones most cordially to break into his building and attempt a rescue.

"Oh I will," Galaxy mutters to herself. This time, she vows silently, Thallium won't escape.

Plus she'll get to meet Europa Callisto. That'll be totally sweet.

 _________      __                     _____                     
 __/ ____/___ _/ /___ __  ____  __     __/ /___  ____  ___  _____
 _/ / __/ __ `/ / __ `/ |/_/ / / /  __ _/ / __ \/ __ \/ _ \/ ___/
 / /_/ / /_/ / / /_/ />  </ /_/ /  / /_/ / /_/ / / / /  __(__  ) 
 \____/\__,_/_/\__,_/_/|_|\__, /   \____/\____/_/ /_/\___/____/  
 _____________________________/ 

An Interactive Fiction by Philip Riley
Release 1 / Serial number 230221 / Inform 7 build 6M62 (I6/v6.34 lib 6/12N) SD

A sleek dark red speeder roars into the speeder dock of the Viking Building. A tall, strong, dark-brown-skinned woman in a battle-ready jumpsuit climbs out of it.

Galaxy Jones is in the speeder dock. A safe harbor from the periodic dust storms of Utopia Planitia, the dock features several dozen speeder bays. Only a few are filled right now. The building entryway is to the north, under a red stone façade carved into the likeness of a fearsome Viking.

Jones's speeder, Galaxy One, sits in one of the parking bays.

>pronouns
At the moment, "it" means the speeder, "him" is unset, "her" is unset, and "them" is unset.

* * *

>pronouns
At the moment, "it" means the speeder, "him" is unset, "her" means Jones, and "them" is unset.

>x me
You? I don't know who you are and I don't really care. If you need to know what you look like, just look at yourself, for heaven's sake.

>x her
I'm not sure what 'her' refers to.

* * *

>x jones
Galaxy

Foo

>x her
I'm not sure what 'her' refers to.

>pronouns
At the moment, "it" means the speeder, "him" is unset, "her" is unset, and "them" is unset.

>showme player
Jones - person
    disruptor pistol
location: in the speeder dock
singular-named, proper-named; unlit, inedible, portable, female
list grouping key: none
printed name: "yourself"
printed plural name: "people"
indefinite article: none
most recent reference: nominal
third singular pronoun: She-pronoun
description: "Galaxy"
initial appearance: none
third-plural-pronoun: They-pronoun
carrying capacity: 100
first-singular-pronoun: I-pronoun
first-plural-pronoun: We-pronoun
second-singular-pronoun: Singular-you-pronoun
second-plural-pronoun: Plural-you-pronoun

* * *

>x me
You? I don't know who you are and I don't really care. If you need to know what you look like, just look at yourself, for heaven's sake.

>actions
Actions listing on.

>x me
[examining Jones]
Galaxy

[examining Jones - succeeded]

* * *

>x me
You? I don't know who you are and I don't really care. If you need to know what you look like, just look at yourself, for heaven's sake.

>pronouns
At the moment, "it" means the speeder, "him" is unset, "her" means Jones, and "them" is unset.

>x it
You? I don't know who you are and I don't really care. If you need to know what you look like, just look at yourself, for heaven's sake.

>shoot it
(with the disruptor pistol)
Jones, or the narrator (that's the one who's talking right now), are unable to interact with you in any way, other than via keyboard and text, that is.

>i
Jones is carrying:
  a disruptor pistol

>pronouns
At the moment, "it" means you, the player, "him" is unset, "her" means Jones, and "them" is unset.

>l
Galaxy Jones is in the speeder dock. A safe harbor from the periodic dust storms of Utopia Planitia, the dock features several dozen speeder bays. Only a few are filled right now. The building entryway is to the north, under a red stone façade carved into the likeness of a fearsome Viking.

Jones's speeder, Galaxy One, sits in one of the parking bays

>pronouns
At the moment, "it" means the speeder, "him" is unset, "her" means Jones, and "them" is unset.

>x jones
Galaxy

>pronouns
At the moment, "it" means the speeder, "him" is unset, "her" means Jones, and "them" is unset.

>x her
Galaxy

>x it
Galaxy One is a Dust Runner, a top-of-the-line model from Olympus Speedworks. It's deep crimson with tinted windows. Powerful turbines adorn vestigial wings that sweep back in severe rearward arcs.

* * *

>x me
You? I don't know who you are and I don't really care. If you need to know what you look like, just look at yourself, for heaven's sake.

>shoot me
(with the disruptor pistol)
Jones can't reach into the room of stuff.

* * *

>x me
You? I don't know who you are and I don't really care. If you need to know what you look like, just look at yourself, for heaven's sake.

>x i
There's nothing like that nearby.

>x myself
(You, the player)
You? I don't know who you are and I don't really care. If you need to know what you look like, just look, for heaven's sake.

>x jones
Galaxy

* * *

>x me
You? I don't know who you are and I don't really care. If you need to know what you look like, just look at yourself, for heaven's sake.

>x jones
Galaxy

Foo

>pronoun
That's not a verb I recognise.

>pronouns
At the moment, "it" means you, the player, "him" is unset, "her" is unset, and "them" is unset.

* * *

>x jones
Galaxy

Foo

>x you
There's nothing like that nearby.

>x her
I'm not sure what 'her' refers to.

>pronouns
At the moment, "it" means you, the player, "him" is unset, "her" is unset, and "them" is unset.

>x jones
Galaxy

>pronouns
At the moment, "it" means you, the player, "him" is unset, "her" is unset, and "them" is unset.

* * *

>x red stone
The entryway is dominated by the towering façade of a Viking king, namesake of the building itself.

>x viking
The entryway is dominated by the towering façade of a Viking king, namesake of the building itself.

>x bays
Most of the parking bays are unfilled.

>x speeder
Galaxy One is a Dust Runner, a top-of-the-line model from Olympus Speedworks. It's deep crimson with tinted windows. Powerful turbines adorn vestigial wings that sweep back in severe rearward arcs.

>get in speeder
Jones has a job to do here.

>n
Jones approaches the Viking Building entryway, the dramatic façade towering over her.

Galaxy Jones is at the entry doorway. A glass revolving door leads into a large open space north of here. The speeder dock is to the south.

>x
(the disruptor pistol)
A compact instrument of death, with only one setting: kill.

>s
Galaxy Jones is in the speeder dock. A safe harbor from the periodic dust storms of Utopia Planitia, the dock features several dozen speeder bays. Only a few are filled right now. The building entryway is to the north, under a red stone façade carved into the likeness of a fearsome Viking.

Jones's speeder, Galaxy One, sits in one of the parking bays

>n
Galaxy Jones is at the entry doorway. A glass revolving door leads into a large open space north of here. The speeder dock is to the south.

>e
Jones can't go that way.

* * *

>w
Jones can't go that way.

>n
Jones passes through the revolving door and into the lobby, alert to any defenses.

Galaxy Jones is in the lobby. The ground floor of the Viking Building is breathtaking. Low-G architecture means more glass and thinner supports, and the building takes advantage of that. Four walls of glass surround a central pillar in which are set the utility rooms and elevators. In between is an expanse of plants, water installations, and stylish seating. Near the entryway is a front desk. Above it floats, suspended on almost invisible cables, a giant crystal sculpture.

>x desk
Before Jones gets a chance to do anything, two robot guards emerge from niches in the back wall! She dives behind the front desk and draws her disruptor pistol.

>fire pistol
What should Jones fire the disruptor pistol at?

>guards
There's nothing like that nearby.

>robots
That's not a verb I recognise.

>fire pistol at robots
You can't use multiple objects with that verb.

>fire pistol at robot
Which do you mean, the green guard robot or the red guard robot?

>green
Jones sticks her head out from behind the desk and squeezes off a shot at the green guard robot. In her haste it goes wide of the target.

The robots intone "Destroy Jones" in an eerie drone.

>fire pistol at green robot
Oof. Big miss.

>fire pistol at green robot
A perfect shot! Yet, somehow, the robot is unscathed.

>fire pistol at red robot
A barrage of fire from the robots prevents Jones from firing.

The red robot fires a blistering shot into the front desk.

>throw pistol at robot
Which do you mean, the green guard robot or the red guard robot?

>green
Jones thinks twice and decides not to throw it after all.

The robots intone "Destroy Jones" in an eerie drone.

>robot, help
You can't talk to the green guard robot.

>x
(the disruptor pistol)
A compact instrument of death, with only one setting: kill.

The two robots coordinate fire over the desk, narrowly missing Jones.

>n
Trying to reach an exit would surely get Jones shot.

Zip! Disruptor fire scorches a nearby couch.

>x couch
There's nothing like that nearby.

>look
Galaxy Jones is in the lobby. The ground floor of the Viking Building is breathtaking. Low-G architecture means more glass and thinner supports, and the building takes advantage of that. Four walls of glass surround a central pillar in which are set the utility rooms and elevators. In between is an expanse of plants, water installations, and stylish seating. Near the entryway is a front desk. Above it floats, suspended on almost invisible cables, a giant crystal sculpture.

Red and green guard robots criss-cross the lobby, stalking Jones.

The green robot fires a blistering shot into the front desk.

>x desk
There's not much on the desk other than a note that says "0".

The red robot fires a blistering shot into the front desk.

>x sculpture
It's a huge crystal abstraction, provocative in its arrogance but evocative of nothing. A typical public installation by the artist Rambutan. It's held up by metal cables.

>hide behind sculpture
That's not a verb I recognise.

>jump onto sculpture
I only understood you as far as wanting to jump.

>attack robot
Which do you mean, the green guard robot or the red guard robot?

>red
You'll need to specify how Jones should attack the red guard robot. For instance, you might say "shoot the red guard robot with the disruptor pistol".

Zip! Disruptor fire scorches a nearby couch.

>i
Jones is carrying:
  a disruptor pistol

The green robot tries to flank her, but a shot from her disruptor sends it scurrying back.

>fire pistol at sculpture
Jones fires the disruptor into the sculpture's main support cable, snapping it. The huge crystal blob starts to sag, straining the other cables. In quick succession they break as well, and the whole installation plummets to the ground, right on top of the hapless guard robots.

 _________      __                     _____                     
 __/ ____/___ _/ /___ __  ____  __     __/ /___  ____  ___  _____
 _/ / __/ __ `/ / __ `/ |/_/ / / /  __ _/ / __ \/ __ \/ _ \/ ___/
 / /_/ / /_/ / / /_/ />  </ /_/ /  / /_/ / /_/ / / / /  __(__  ) 
 \____/\__,_/_/\__,_/_/|_|\__, /   \____/\____/_/ /_/\___/____/  
 _____________________________/ 

[Your score has just gone up by one point.]

* * *

>red
You'll need to specify how Jones should attack the red guard robot. For instance, you might say "shoot the red guard robot with the disruptor pistol".

Zip! Disruptor fire scorches a nearby couch.

>take
(the note)
Taken.

>take
What should Jones take?

>red robot
An interesting idea.

One of the robots fires directly above her head.

>take red robot
An interesting idea.

>take red robot
An interesting idea.

>take red robot
An interesting idea.

The red robot fires a blistering shot into the front desk.

>take red robot
An interesting idea.

>take red robot
An interesting idea.

The green robot fires a blistering shot into the front desk.

>take red robot
An interesting idea.

The red robot fires a blistering shot into the front desk.

>take red robot
An interesting idea.

The red robot fires a blistering shot into the front desk.

* * *

>take red robot
An interesting idea.

>take red robot
An interesting idea.

The green robot tries to flank Jones, but a shot from her disruptor sends it scurrying back.

>take red robot
An interesting idea.

>take red robot
An interesting idea.

The robots intone "Destroy Jones" in an eerie drone.

>take red robot
An interesting idea.

* * *

>take red robot
An interesting idea.

The green robot fires a blistering shot into the front desk.

>take red robot
An interesting idea.

One of the robots fires directly above Jones's head.

>take red robot
An interesting idea.

The green robot fires a blistering shot into the front desk.

>take red robot
An interesting idea.

Zip! Disruptor fire scorches a nearby couch.

>take red robot
An interesting idea.

The green robot fires a blistering shot into the front desk.